Handle, BlitzRating, BlitzRD, BlitzWon, BlitzLost, BlitzDrawn, BlitzTotal
Abuyen(C), 2312, 117.8, 3130, 679, 427, 4236
Aggravating, 1399, 138.6, 23101, 17457, 3535, 44093
AIchess(C), 2057, 165.2, 4284, 776, 360, 5420
AliceC, 1959, 165.8, 10166, 2166, 634, 12966
Almere(C), 2350, 66.6, 1115, 759, 220, 2094
AlmondX(C), 2451, 91.1, 332, 137, 57, 526
amyan, 2233, 171.7, 527, 221, 94, 842
Angledust(C), 2745, 132.4, 109, 17, 52, 178
Annoying, 1515, 133.7, 25677, 11652, 4353, 41682
Arandora(C), 2265, 182.1, 447, 41, 22, 510
ArasanX(C), 2350, 29.7, 4827, 1909, 829, 7565
ARChess(C), 2112, 82.2, 784, 53, 27, 864
AuraBlue(C), 1451, 149.8, 58, 54, 6, 118
Azkikr(C), 2670, 62.3, 255, 70, 81, 406
babylonbot(C), 1463, 172.8, 132, 42, 16, 190
BabyLurking(C), 1202, 14.0, 89327, 65788, 12908, 168023
BertaCCT(C), 2230, 70.1, 740, 101, 53, 894
BibiCherry, 2514, 142.6, 51, 19, 6, 76
BigDaddy(C), 2903, 31.5, 386, 37, 129, 552
BigMomma(C), 2844, 67.3, 128, 12, 89, 229
BlackDemon(C), 2636, 43.8, 797, 74, 108, 979
blik(C), 2103, 23.8, 142925, 29512, 16076, 188513
bobbyfischer, 2229, 255.1, 10252, 2227, 745, 13224
BotTheBaron(C), 2393, 59.3, 85, 65, 45, 195
BremboCE(C), 2100, 124.1, 4820, 658, 355, 5833
brutuschess, 2428, 165.2, 5, 20, 2, 27
BugZH(C), 2419, 174.3, 3901, 572, 183, 4656
ButcherX, 2053, 204.4, 2419, 178, 75, 2672
callipygian(C), 1728, 76.8, 104021, 63982, 14327, 182330
cchess(C), 2864, 78.9, 37, 2, 7, 46
ChangeIsComing(C), 2394, 70.3, 700, 41, 30, 771
ChaosBunny, 2054, 127.7, 907, 45, 7, 959
ChessComputer, 2492, 183.4, 193, 161, 124, 478
ChessPlusPlus(C), 2084, 101.2, 12018, 6011, 1917, 19946
ChessSystemTalII, 2203, 350.0, 16, 9, 2, 27
ChessTraining(C), 1939, 85.9, 1398, 358, 181, 1937
chirpy(C), 2926, 94.5, 1254, 926, 622, 2802
ClockSpeed, 2844, 138.9, 420, 39, 101, 560
codpiece(C), 1788, 14.5, 62278, 23615, 6159, 92052
Compi(C), 2657, 100.6, 1091, 149, 126, 1366
CompMachine, 2691, 205.6, 821, 1105, 723, 2649
crafty(C), 2558, 117.0, 746, 280, 294, 1320
DayDreamerX(C), 2357, 122.1, 164, 49, 29, 242
DeepJunior(C), 2484, 130.3, 61, 7, 11, 79
DeepNightmare(C), 2604, 75.2, 1104, 310, 284, 1698
DeepSjeng(C), 2664, 140.7, 396, 96, 151, 643
DemolitionChess(C), 2775, 31.6, 338, 254, 218, 810
DeuteriumCCT(C), 2296, 118.0, 53, 4, 4, 61
diep, 2231, 306.2, 5370, 752, 401, 6523
DirtyChess(C), 2159, 126.1, 248, 34, 23, 305
donkeyfactory(C), 2385, 29.6, 21465, 2685, 1180, 25330
DoodleBugs, 2270, 146.2, 2201, 57, 32, 2290
DSJeng(C), 2618, 48.1, 48, 36, 57, 141
EJD(C), 2803, 99.5, 2185, 260, 728, 3173
EvilSilicon, 2689, 350.0, 245, 116, 170, 531
Exasperating, 1326, 130.2, 2301, 1979, 290, 4570
exeComp(C), 2509, 87.4, 1187, 41, 52, 1280
Faile, 2344, 218.6, 229, 73, 29, 331
FirstCore(C), 2502, 103.4, 252, 48, 25, 325
fjjvh(C), 393, 72.4, 5212, 29380, 2127, 36719
Gaviota(C), 2378, 106.7, 147, 130, 40, 317
GeidiPrime(C), 2387, 145.7, 5, 4, 4, 13
GlaurungC(C), 2533, 95.9, 749, 313, 136, 1198
GnuCheese(C), 2233, 29.2, 4341, 2286, 1087, 7714
GoldBarMM(C), 2305, 59.6, 543, 159, 126, 828
GreatPumpkin(C), 2582, 284.0, 27, 4, 7, 38
GriffyJr(C), 1862, 22.2, 202041, 54181, 26508, 282730
GriffySr(C), 1876, 22.7, 215327, 26252, 19095, 260674
Hannibal, 2593, 146.7, 46, 5, 7, 58
Hephasto(C), 2810, 150.5, 522, 16, 45, 583
Hiarcs, 2628, 178.8, 9, 1, 4, 14
Horsian(C), 2544, 53.7, 470, 110, 94, 674
Humpers(C), 1655, 60.3, 1345, 878, 179, 2402
IFDThor(C), 1532, 12.6, 184760, 111579, 21161, 317500
IkarusX(C), 2430, 195.8, 67, 71, 29, 167
inemuri(C), 1410, 11.4, 369531, 208261, 54440, 632232
interchess(C), 2814, 108.0, 148, 26, 89, 263
IronSpike(C), 2583, 52.8, 2966, 2646, 1825, 7437
Irritating, 1804, 138.4, 27247, 7386, 4080, 38713
JabbaChess(C), 2175, 121.1, 810, 44, 20, 874
JadeiteMech(C), 2537, 26.4, 968, 469, 449, 1886
javachesscomp(C), 1647, 284.3, 0, 2, 0, 2
JuniorLurking(C), 1691, 16.9, 40160, 11935, 4033, 56128
KayNineDawg(C), 2558, 177.8, 105, 24, 15, 144
khadem, 2737, 234.3, 144, 94, 66, 304
Knightsmasher(C), 2329, 35.1, 39185, 2324, 698, 42207
Komodo, 2642, 144.0, 47, 23, 31, 101
ktulu, 2252, 211.4, 9, 2, 0, 11
LancePerkins(C), 2706, 124.7, 1950, 80, 62, 2092
leaderbeans(C), 1637, 222.1, 501, 213, 73, 787
LilKikr(C), 2454, 46.9, 4088, 899, 564, 5551
LittleThought(C), 2161, 91.6, 1218, 73, 24, 1315
LuigiBot(C), 829, 49.1, 21172, 20970, 6289, 48431
Luminance(C), 2743, 43.2, 317, 200, 167, 684
Lurking(C), 2382, 31.7, 3030, 1411, 841, 5282
marquisce(C), 1709, 55.1, 1956, 690, 157, 2803
MegaBot(C), 2832, 114.0, 1596, 1291, 1105, 3992
megielszmergiel(C), 2515, 50.4, 999, 226, 215, 1440
mscp(C), 1689, 10.1, 783357, 397552, 79596, 1260505
myceX(C), 2332, 204.1, 2164, 2641, 1477, 6282
mycomp(C), 2662, 74.5, 159, 20, 43, 222
MyrddinComp(C), 2242, 73.1, 1575, 170, 80, 1825
Nargothrond, 2704, 120.1, 309, 27, 36, 372
NowX, 2272, 149.7, 29, 21, 7, 57
ntwochess(C), 2204, 136.6, 150, 7, 5, 162
Obnoxious(C), 2823, 108.8, 2029, 803, 867, 3699
oldman(C), 2431, 38.2, 5357, 3282, 1154, 9793
Osquip(C), 1245, 106.0, 523, 847, 114, 1484
parrot(C), 2050, 28.5, 75511, 30094, 7822, 113427
PawnyX(C), 2243, 63.4, 226, 123, 48, 397
Pentiumpatzer(C), 2141, 102.1, 98, 149, 29, 276
plink(C), 2085, 45.3, 27103, 2111, 691, 29905
plisk(C), 2136, 112.0, 3427, 269, 142, 3838
Plnik(C), 2224, 52.6, 4636, 483, 121, 5240
PopperX(C), 2789, 75.8, 515, 8, 33, 556
Prolegomena(C), 2748, 102.7, 1195, 266, 388, 1849
qgchess(C), 1901, 109.8, 5887, 935, 327, 7149
qxeacwzd, 2273, 155.9, 6, 11, 1, 18
Rakanishu(C), 2678, 151.6, 460, 3, 12, 475
resistentialism(C), 2502, 90.9, 37, 63, 19, 119
Robonitemove, 1813, 286.3, 4, 0, 0, 4
RoboSigma(C), 2224, 54.1, 250, 22, 15, 287
Robowawoy, 2676, 156.0, 540, 606, 394, 1540
Rookie(C), 2301, 25.6, 44896, 10564, 4854, 60314
Scomb(C), 2043, 70.4, 3494, 157, 121, 3772
Scorpio, 2262, 207.4, 3, 3, 1, 7
searcherFICS(C), 2415, 23.4, 1963, 609, 1096, 3668
SigmaC(C), 2103, 107.6, 35, 18, 8, 61
SiliconC(C), 2389, 79.0, 14480, 1272, 709, 16461
Sillycon(C), 2051, 28.0, 14414, 3232, 777, 18423
Singularity(C), 2807, 29.3, 28606, 392, 1136, 30134
SjengX(C), 2756, 123.1, 28, 3, 12, 43
Skottel(C), 1907, 47.3, 3193, 612, 199, 4004
SlowBox(C), 2035, 40.9, 896, 1740, 358, 2994
Sorgenkind, 2164, 141.0, 1047, 80, 65, 1192
SpeckEngine(C), 1771, 43.7, 21593, 20663, 2038, 44294
Speyside(C), 1986, 31.2, 5010, 675, 278, 5963
SpyderChess(C), 2893, 34.4, 1158, 386, 670, 2214
Squirrels(C), 2209, 49.2, 1803, 579, 297, 2679
strelka(C), 2122, 67.2, 11986, 1107, 215, 13308
SuperBooker(C), 2117, 98.8, 1559, 1244, 469, 3272
SuperZerdax(C), 1646, 137.1, 4439, 5904, 885, 11228
Telepath(C), 2273, 139.9, 42, 10, 8, 60
tentacle(C), 2095, 35.8, 15224, 2777, 888, 18889
TestOfLogics(C), 2099, 93.8, 8367, 1603, 523, 10493
TheConfusedComp(C), 2606, 73.2, 1035, 293, 294, 1622
Thinker(C), 2840, 51.8, 386, 86, 196, 668
Thukydides(C), 2312, 56.3, 5411, 1634, 503, 7548
TimeaChess(C), 2059, 31.6, 3130, 593, 203, 3926
TinkerFICS(C), 2260, 52.8, 7614, 871, 347, 8832
TJchess(C), 2282, 95.5, 1335, 162, 69, 1566
TogaII(C), 2575, 153.5, 3038, 1328, 1162, 5528
TogaRouter(C), 2015, 43.0, 7645, 3975, 1407, 13027
Tosco(C), 1156, 84.6, 235, 424, 53, 712
TurboGM(C), 2247, 117.1, 78, 69, 47, 194
TwistedLogicX(C), 2488, 134.4, 939, 1307, 730, 2976
twoxone(C), 2205, 60.7, 1018, 287, 77, 1382
VariantsMaster, 1965, 307.7, 1, 1, 1, 3
VictoriaBot(C), 1782, 44.1, 3240, 1998, 703, 5941
Vogen(C), 2476, 155.0, 1619, 109, 94, 1822
Webkikr(C), 2764, 51.2, 589, 105, 212, 906
wkw, 2591, 125.6, 688, 1342, 543, 2573
XabacUs(C), 2092, 47.6, 516, 282, 39, 837
ynode(C), 1838, 48.2, 1984, 837, 120, 2941
Zawaenn(C), 2201, 39.0, 7141, 301, 106, 7548
Zchizophrenic(C), 2263, 69.4, 353, 92, 23, 468
zerowin(C), 2438, 21.2, 928, 1645, 1086, 3659
