Handle, BlitzRating, BlitzRD, BlitzWon, BlitzLost, BlitzDrawn, BlitzTotal
Abatwa, 1023, 24.1, 1207, 2030, 59, 3296
abdragan, 1215, 37.2, 5938, 5514, 250, 11702
abrik, 1587, 32.1, 9954, 6599, 464, 17017
Accugroove, 869, 46.8, 27, 69, 2, 98
achtpuntzes, 1142, 28.7, 2636, 1559, 71, 4266
adakeep, 1432, 31.3, 1899, 1870, 157, 3926
adder, 1513, 28.3, 16399, 15822, 2248, 34469
addictinsane, 1549, 32.1, 6828, 4787, 319, 11934
adelaty, 871, 67.1, 9, 68, 1, 78
Adlet, 1733, 29.0, 815, 920, 81, 1816
adv, 1729, 61.2, 3485, 2804, 303, 6592
AFalcon, 1141, 62.1, 4213, 6583, 348, 11144
AFCERGY, 1461, 18.6, 14128, 9964, 1933, 26025
afeemomo, 1313, 28.2, 634, 1132, 46, 1812
afraj, 1130, 35.9, 1217, 1489, 84, 2790
Aggresivation, 1100, 53.0, 112, 169, 6, 287
agoraphobia, 1921, 22.0, 3496, 4097, 467, 8060
agrraja, 733, 41.8, 38, 152, 2, 192
AGtrader, 1837, 24.9, 798, 771, 71, 1640
ahattar, 1182, 26.9, 8183, 7905, 518, 16606
AhmedFayz, 1560, 18.9, 5148, 5811, 394, 11353
ahphong, 1565, 31.0, 3569, 1622, 129, 5320
aigren, 1528, 19.1, 2767, 4447, 345, 7559
ajedrezazteca, 1272, 54.7, 390, 490, 39, 919
akalamkam, 1601, 24.9, 1376, 1470, 114, 2960
AKIKO, 1456, 24.9, 758, 531, 42, 1331
akots, 1823, 25.1, 7337, 8041, 1314, 16692
Akujit, 1376, 34.1, 5453, 5129, 413, 10995
akuo, 1399, 70.5, 4596, 4634, 277, 9507
alank, 1436, 34.7, 11258, 7610, 1151, 20019
albag, 1326, 36.6, 441, 236, 25, 702
albertking, 1238, 61.7, 155, 199, 12, 366
albertokeizer, 1192, 34.2, 95, 97, 10, 202
alcam, 1837, 51.8, 1165, 1365, 85, 2615
Alcantrix, 1623, 42.5, 751, 361, 49, 1161
alechinfanous, 1505, 56.0, 80, 72, 15, 167
Alecs, 1838, 27.3, 8593, 10178, 1007, 19778
alekhinecapablanc, 1587, 42.4, 1598, 2546, 172, 4316
AlekhineDeepSix, 1292, 28.5, 388, 916, 25, 1329
aleksv, 1147, 48.3, 416, 860, 9, 1285
aleshakkk, 1430, 22.6, 11081, 21300, 1618, 33999
AlexanderQ, 1066, 42.9, 409, 704, 17, 1130
AlexBaban, 1641, 50.9, 6713, 8395, 362, 15470
alexe, 1359, 24.2, 9147, 7422, 424, 16993
alexradulescu, 1291, 32.5, 2040, 2898, 320, 5258
alfredisimo, 1283, 21.9, 6961, 5595, 471, 13027
alho, 1371, 28.7, 3394, 2960, 148, 6502
AlienFever, 1009, 31.7, 1267, 1128, 43, 2438
AlienKing, 1443, 37.0, 1111, 858, 104, 2073
alipax, 1213, 51.0, 1236, 1124, 62, 2422
alja, 1268, 29.6, 5215, 5780, 263, 11258
allallright, 1639, 32.6, 237, 255, 23, 515
allencox, 1116, 34.3, 466, 583, 41, 1090
Allenko, 1219, 17.5, 650, 1226, 41, 1917
alligner, 1354, 27.6, 729, 657, 50, 1436
almcr, 1207, 46.8, 2389, 2054, 292, 4735
alokdk, 1304, 39.3, 3186, 5450, 291, 8927
alonm, 1996, 29.4, 12591, 9618, 1377, 23586
Alquinte, 1117, 26.7, 2469, 2666, 121, 5256
Alvenko, 1872, 36.7, 404, 300, 63, 767
Alvruocnar, 1654, 26.0, 4779, 4450, 840, 10069
Alwis, 1293, 50.2, 310, 304, 27, 641
alxsb, 1615, 22.3, 9951, 11655, 1317, 22923
Amauta, 1520, 53.2, 436, 177, 31, 644
AMAVABEL, 1636, 23.5, 2325, 2590, 261, 5176
Amazon, 1307, 32.5, 5467, 5767, 419, 11653
AmpedAl, 987, 52.1, 481, 1270, 41, 1792
ampiong, 1426, 44.8, 65, 20, 2, 87
amrahmed, 1255, 38.7, 132, 120, 9, 261
anachronism, 1598, 29.0, 1437, 1267, 187, 2891
analytic, 1812, 44.0, 13888, 3414, 542, 17844
AndresElPez, 1090, 26.4, 242, 380, 18, 640
andrewparis, 1281, 24.5, 2276, 2592, 193, 5061
AndyTheAnt, 1100, 44.9, 308, 434, 16, 758
animaru, 1546, 34.3, 1330, 1102, 108, 2540
anishm, 1376, 38.2, 3274, 2849, 294, 6417
ankhra, 1064, 33.9, 713, 1287, 166, 2166
AnnieMc, 1268, 25.1, 1666, 1400, 133, 3199
Anselmus, 1224, 33.2, 6932, 5527, 297, 12756
Antar, 1419, 36.5, 1548, 1980, 55, 3583
APe, 1682, 38.2, 2638, 1393, 233, 4264
APickedHandle, 1356, 32.5, 6087, 6568, 386, 13041
apil, 1160, 25.9, 1512, 1961, 78, 3551
aplchess, 1128, 29.7, 470, 269, 12, 751
appolon, 1463, 25.1, 657, 350, 16, 1023
aqeel, 1108, 68.6, 242, 487, 15, 744
aravindkr, 924, 50.3, 49, 180, 5, 234
arconova, 929, 37.2, 243, 804, 25, 1072
arellaneso, 1255, 49.0, 618, 655, 49, 1322
arinov, 821, 34.3, 58, 154, 1, 213
ArisP, 1193, 94.4, 8, 13, 1, 22
Arispap, 1332, 27.3, 3325, 3973, 281, 7579
AristoChess, 1474, 28.1, 183, 193, 18, 394
ARival, 852, 110.1, 1, 13, 0, 14
arkmaster, 1422, 37.3, 767, 582, 30, 1379
Armatang, 1965, 37.7, 1261, 990, 124, 2375
artground, 1294, 28.2, 1536, 1552, 166, 3254
ArthurArthur, 908, 32.6, 60, 112, 4, 176
arturoeanton, 1199, 60.5, 212, 262, 17, 491
Arut, 1396, 43.3, 4058, 4776, 535, 9369
Ashatz, 1034, 63.8, 16, 17, 1, 34
ashewo, 1349, 32.6, 3892, 3587, 159, 7638
Ashy, 1544, 27.6, 4844, 5592, 508, 10944
aslaa, 1570, 25.1, 1569, 767, 125, 2461
assasincreed, 1662, 21.5, 554, 432, 58, 1044
asxetos, 1497, 28.5, 17789, 11435, 1008, 30232
ATAXERXES, 1312, 35.0, 120, 335, 12, 467
Athonian, 1415, 28.2, 885, 783, 63, 1731
Atlantamaster, 1162, 49.2, 75, 76, 2, 153
Attic, 1222, 46.2, 403, 570, 32, 1005
atulmukerji, 1283, 54.6, 1871, 2615, 235, 4721
aussenschnapp, 1575, 22.8, 527, 361, 36, 924
austinjord, 1631, 33.4, 2942, 2821, 235, 5998
autocadpower, 990, 55.1, 47, 170, 2, 219
avargasg, 1399, 31.6, 2255, 2276, 251, 4782
awadsageralroba, 773, 37.0, 84, 385, 6, 475
AXLJOSH, 1486, 51.4, 1957, 1733, 254, 3944
ayi, 1335, 26.1, 14437, 16211, 1025, 31673
bachio, 1491, 22.3, 22492, 28116, 1429, 52037
BaDbOyHeRe, 1316, 23.7, 506, 459, 31, 996
balassa, 1316, 25.1, 7132, 11478, 553, 19163
ballenero, 1212, 28.3, 1431, 2189, 98, 3718, 1179, 41.5, 2157, 2293, 173, 4623
barbos, 1152, 30.7, 1026, 1292, 69, 2387
barbraid, 1041, 30.8, 659, 999, 30, 1688
barcellos, 1288, 27.2, 1817, 3260, 248, 5325
BarnesEBB, 1473, 22.2, 4494, 4147, 250, 8891
barnetme, 943, 68.5, 13, 25, 0, 38
barriosgeb, 1340, 25.8, 134, 170, 6, 310
Barrone, 1164, 22.7, 299, 514, 12, 825
barrywelsh, 1297, 32.2, 1832, 1800, 86, 3718
Barta, 1252, 31.7, 3840, 3377, 374, 7591
Barva, 1472, 31.2, 719, 832, 51, 1602
basketjerk, 899, 42.3, 184, 246, 10, 440
bassale, 1250, 36.9, 3682, 2216, 184, 6082
basvdieren, 1087, 30.5, 1559, 1213, 156, 2928
Batmankp, 1099, 38.2, 2302, 2253, 77, 4632
Bbeelllee, 1367, 23.3, 327, 257, 24, 608
bbphisher, 1295, 34.2, 320, 295, 31, 646
BChannell, 1160, 51.9, 680, 679, 41, 1400
bddcdj, 1174, 34.6, 7264, 5345, 200, 12809
bdiller, 1825, 24.1, 26069, 32667, 2080, 60816
beaney, 1445, 29.1, 8594, 6918, 813, 16325
bearwulf, 1435, 40.7, 497, 316, 25, 838
BeatRider, 1136, 42.3, 102, 212, 2, 316
BeauBella, 1507, 27.7, 1457, 1239, 75, 2771
Begemot, 1984, 61.3, 1746, 780, 150, 2676
Begoner, 1838, 29.0, 14702, 5096, 883, 20681
begunner, 1363, 18.1, 676, 620, 23, 1319
Belamont, 1409, 56.2, 383, 559, 32, 974
Belarion, 762, 84.0, 5, 17, 0, 22
beline, 1293, 45.8, 3460, 4023, 483, 7966
bentway, 1257, 42.3, 755, 564, 55, 1374
bergsteiger, 1262, 23.3, 34557, 33511, 5013, 73081
Bernardbovy, 1502, 32.7, 1364, 1445, 187, 2996
bernardtan, 1581, 36.7, 2633, 2892, 501, 6026
bernhilz, 1297, 41.2, 2690, 4305, 297, 7292
BETOMEX, 1127, 41.7, 396, 358, 31, 785
Beyatch, 1710, 23.2, 2840, 3111, 615, 6566
beyondillusion, 992, 31.8, 517, 1359, 47, 1923
bfris, 974, 36.9, 1746, 1963, 174, 3883
BFskinr, 1447, 43.8, 1120, 1578, 104, 2802
bharathumasankar, 1419, 28.8, 2754, 3431, 188, 6373
Bicchi, 1370, 36.1, 8713, 6095, 477, 15285
Bielefeld, 1096, 37.3, 2082, 2173, 123, 4378
bigazian, 848, 99.1, 4, 16, 0, 20
BigDixon, 978, 75.0, 26, 41, 4, 71
BigDrew, 1454, 163.2, 40, 59, 0, 99
Bigerb, 1369, 40.7, 346, 248, 24, 618
Bigforce, 1254, 46.2, 312, 541, 17, 870
Biliu, 1291, 38.3, 1063, 1162, 71, 2296
billig, 1507, 35.7, 11312, 8594, 555, 20461
billllbo, 1312, 29.4, 1171, 1094, 126, 2391
billychess, 1142, 36.5, 1012, 1016, 44, 2072
bimasakti, 1731, 29.8, 579, 764, 52, 1395
bingopm, 1018, 36.6, 3661, 4011, 536, 8208
biotdi, 1455, 33.6, 3302, 2723, 123, 6148
bipsman, 1432, 46.3, 3727, 3382, 321, 7430
birkus, 1466, 31.6, 4692, 7651, 974, 13317
bishaftu, 1657, 31.0, 3170, 2288, 119, 5577
BishopbyTrade, 1504, 29.5, 12774, 11046, 1038, 24858
bishopjones, 1332, 32.3, 5283, 5058, 176, 10517
bishopplay, 1056, 59.3, 479, 760, 24, 1263
bishoptakesknight, 1361, 37.7, 93, 137, 5, 235
BJCAS, 1295, 34.6, 1575, 1125, 36, 2736
bkaiser, 1120, 37.3, 3678, 3059, 311, 7048
bkvt, 1484, 43.3, 387, 536, 43, 966
BlackLingo, 1202, 60.9, 1313, 1264, 91, 2668
blackmale, 1002, 42.8, 36, 59, 0, 95
BlacKnights, 1381, 35.2, 817, 1518, 78, 2413
Blacksburg, 1271, 34.0, 317, 434, 14, 765
BlackSpy, 1118, 28.0, 263, 466, 16, 745
Blakhorse, 1841, 23.0, 8519, 12558, 867, 21944
blcrcktt, 1197, 54.6, 1202, 637, 32, 1871
blitzmonster, 1352, 29.7, 2781, 2321, 335, 5437
BlkSabb, 1546, 28.3, 3271, 3560, 359, 7190
Blogjam, 1100, 53.0, 1229, 1150, 111, 2490
blore, 1661, 24.4, 30839, 17689, 3301, 51829
blubbel, 1113, 29.5, 284, 542, 25, 851
blueandrew, 1155, 25.7, 571, 829, 34, 1434
BlueBishop, 1347, 33.5, 6244, 5910, 477, 12631
BobbyFischerTwo, 1350, 23.4, 1948, 2797, 123, 4868
bobbythegreatest, 1472, 27.2, 1340, 484, 192, 2016
bobclay, 1826, 27.6, 3423, 3861, 542, 7826
bobrog, 1470, 36.1, 2711, 1266, 266, 4243
BOGGLE, 1320, 40.7, 8230, 5529, 392, 14151
Bohan, 1565, 47.0, 2274, 1970, 217, 4461
boiler, 1772, 29.2, 14888, 17152, 2874, 34914
boitshepo, 1209, 29.1, 420, 721, 19, 1160
bonapart, 1628, 32.3, 8404, 9146, 879, 18429
bondu, 1226, 48.0, 1039, 2100, 44, 3183
BONH, 1005, 21.1, 34598, 53354, 3800, 91752
Boogiepawn, 1519, 20.5, 1760, 1682, 198, 3640
borkfork, 988, 69.9, 9, 24, 1, 34
Bosvell, 1765, 34.9, 220, 122, 35, 377
bracalov, 1717, 32.1, 8373, 3247, 614, 12234
Brajeshwar, 1109, 32.9, 1504, 1220, 44, 2768
BrakeOff, 1288, 26.8, 3185, 4560, 419, 8164
Brakey, 1249, 37.2, 1589, 2058, 118, 3765
brancoliticus, 1185, 38.9, 338, 339, 30, 707
Brandesian, 1258, 41.1, 2135, 1759, 212, 4106
brazorf, 1590, 34.2, 4236, 2649, 243, 7128
brazucanl, 1221, 24.9, 2440, 2692, 34, 5166
Brezeltiger, 1149, 29.1, 1472, 1194, 72, 2738
bricriu, 1473, 26.0, 236, 207, 26, 469
Brieuc, 1388, 35.9, 173, 57, 4, 234
Bringarov, 1823, 35.8, 2958, 1695, 210, 4863
brokenclock, 1822, 25.1, 4702, 4565, 538, 9805
BrokenNeck, 1763, 31.9, 1851, 1680, 178, 3709
broncobakhos, 1430, 22.0, 402, 636, 36, 1074
BronsteinTheBest, 1539, 32.7, 1000, 987, 97, 2084
brontozaur, 1538, 41.5, 1158, 505, 68, 1731
Brony, 1391, 35.3, 4605, 4952, 337, 9894
brumpfschmlog, 1348, 31.3, 3900, 5049, 275, 9224
brunftbert, 1443, 26.6, 11834, 7987, 927, 20748
bsenanayake, 1319, 26.4, 274, 428, 39, 741
bsiSCENEisSAFE, 976, 190.9, 1, 4, 0, 5
Bubbageddon, 959, 99.3, 19, 32, 0, 51
BuddahBelly, 1131, 106.3, 5, 9, 0, 14
BudFive, 1354, 37.8, 1185, 1330, 68, 2583
Budweiser, 1355, 34.2, 2735, 1538, 207, 4480
bugisbest, 1547, 217.6, 1, 1, 0, 2
bullbuffalo, 1313, 39.4, 780, 1528, 34, 2342
Bumhova, 1646, 42.4, 3543, 3351, 190, 7084
bunicul, 1328, 24.5, 1645, 1933, 220, 3798
Buninyong, 1424, 33.7, 2751, 1361, 187, 4299
bushytail, 1340, 23.7, 7476, 7859, 757, 16092
buskingswami, 1250, 44.1, 1065, 856, 83, 2004
Bvantage, 1154, 23.8, 2493, 2759, 99, 5351
bwoody, 949, 31.0, 347, 647, 18, 1012, 1392, 34.2, 1965, 1493, 110, 3568
CAdaddy, 1964, 40.9, 2864, 1479, 412, 4755
Caecielien, 1636, 26.8, 7121, 3920, 288, 11329
calcomar, 1338, 44.7, 38, 58, 6, 102
Calebboy, 1457, 24.1, 4115, 3115, 183, 7413
Californio, 1373, 21.7, 7443, 8223, 417, 16083
campechess, 1199, 27.1, 453, 494, 24, 971
Camray, 1520, 23.7, 4351, 4684, 326, 9361
canaBiss, 1337, 39.7, 106, 100, 6, 212
canariaptm, 1330, 34.7, 885, 693, 65, 1643
CandyFloss, 1055, 33.4, 3868, 9124, 178, 13170
canio, 1338, 18.1, 42649, 41793, 3099, 87541
CanRus, 1458, 21.5, 1900, 2049, 230, 4179
cantbe, 2011, 36.8, 552, 363, 109, 1024
Carl, 1491, 23.0, 31145, 22062, 1068, 54275
carlisland, 1118, 70.6, 224, 374, 11, 609
carlosfgarciac, 1430, 30.0, 1056, 544, 54, 1654
CarmenS, 1165, 32.1, 719, 1006, 73, 1798
carpentaria, 1102, 25.1, 2620, 2595, 286, 5501
Carville, 1341, 40.7, 3733, 2607, 223, 6563
CaryPaul, 1595, 20.5, 7272, 10059, 1146, 18477
Casimiero, 1153, 37.9, 56, 56, 6, 118
cassiodms, 1305, 30.3, 216, 282, 15, 513
catriac, 1338, 37.4, 2038, 2307, 112, 4457
cavebird, 1627, 39.8, 3475, 2197, 636, 6308
Cavil, 1062, 41.7, 3965, 6494, 311, 10770
cbu, 1876, 35.7, 4920, 3319, 479, 8718
cbzy, 1489, 37.2, 224, 591, 40, 855
ccievoice, 1097, 27.7, 2365, 2575, 126, 5066
ccrawford, 1251, 23.1, 609, 872, 22, 1503
CDay, 1659, 45.1, 5686, 3786, 389, 9861
cdot, 1459, 27.0, 5558, 6744, 542, 12844
cedarchopper, 1346, 25.4, 6713, 8945, 554, 16212
CeruleanCaelum, 1372, 46.2, 53, 34, 3, 90
Cgrunner, 1023, 27.4, 505, 571, 39, 1115
chacaleitor, 1073, 58.2, 20, 21, 2, 43
Chadsassou, 1526, 25.9, 4769, 3392, 318, 8479
changchaos, 1648, 25.0, 3956, 4169, 380, 8505
Chaplain, 1586, 34.6, 7217, 4303, 603, 12123
CharlieMR, 1280, 58.5, 116, 189, 13, 318
chbw, 1066, 108.1, 10, 19, 1, 30
checkoff, 1264, 33.4, 6436, 7220, 334, 13990
Checkovian, 1931, 26.5, 5599, 4374, 623, 10596
cheechee, 1187, 25.3, 832, 866, 47, 1745
cheesebored, 803, 37.3, 81, 212, 2, 295
Cheessus, 1305, 29.5, 3757, 2591, 214, 6562
chekmeifucan, 1141, 48.7, 1383, 1547, 111, 3041
Chessanytime, 1529, 40.4, 48, 57, 3, 108
chessaxe, 1511, 33.0, 2017, 1979, 248, 4244
ChessBook, 1659, 45.2, 3247, 3539, 521, 7307
chessgeneis, 1217, 245.8, 1, 1, 0, 2
chessgrm, 1269, 30.4, 4706, 6128, 334, 11168
chessindia, 1325, 29.2, 2390, 2218, 169, 4777
chesskeen, 1539, 19.9, 13929, 20902, 1123, 35954
chessmastergod, 1689, 64.5, 34, 19, 0, 53
ChessMeister, 1470, 41.8, 5195, 5317, 706, 11218
chessnerds, 1503, 57.3, 969, 794, 117, 1880
chessnyc, 1301, 23.2, 2856, 2983, 252, 6091
chesspirit, 1319, 32.3, 5232, 6282, 302, 11816
ChessSailor, 1061, 32.6, 1013, 1689, 62, 2764
chesstical, 1516, 20.7, 375, 207, 31, 613
ChessUtoo, 1679, 27.1, 4361, 4538, 375, 9274
chesterfeild, 1133, 42.2, 803, 1017, 55, 1875
CHETSIFU, 1100, 58.5, 650, 786, 54, 1490
chiappablanca, 1559, 31.8, 1322, 844, 95, 2261
chicagobob, 1369, 26.4, 8741, 6234, 720, 15695
chicagoguy, 967, 22.5, 157, 229, 7, 393
chickenking, 1189, 38.9, 175, 221, 13, 409
chicochess, 983, 84.9, 5, 22, 0, 27
chimurenga, 1547, 33.9, 11554, 11861, 1255, 24670
ChinaMike, 1230, 33.2, 3120, 3480, 269, 6869
chintar, 1389, 25.6, 4082, 6143, 229, 10454
ChipmunkMan, 1193, 29.1, 3473, 3967, 130, 7570
Chogasbord, 1181, 36.5, 570, 454, 14, 1038
Chompion, 1457, 20.6, 5045, 3375, 168, 8588
CHootBAAL, 1687, 29.3, 8385, 4625, 614, 13624
chopinscherzo, 1187, 42.6, 379, 360, 28, 767
choutagahar, 1453, 38.2, 1933, 2441, 134, 4508
chriscrosss, 1088, 31.0, 219, 419, 23, 661
CHRISfromMISS, 1436, 36.2, 1700, 2268, 197, 4165
Chrisie, 1486, 18.8, 4517, 3706, 179, 8402
Christian, 1790, 30.1, 5292, 3349, 398, 9039
christoforo, 1133, 33.3, 126, 602, 6, 734
ChrisVinall, 1302, 45.3, 712, 549, 25, 1286
ChuchoElRoto, 1304, 32.0, 367, 429, 15, 811
churningpigskin, 1176, 26.6, 17019, 13714, 1087, 31820
chuzuk, 1562, 32.7, 479, 452, 58, 989
ciberkon, 1211, 31.1, 747, 784, 54, 1585
cincyfan, 1314, 47.7, 959, 630, 61, 1650
cistic, 1656, 32.5, 10907, 6605, 407, 17919
Citrux, 1523, 27.0, 243, 383, 24, 650
Clarkyballs, 752, 84.5, 8, 25, 1, 34
classAvenger, 1367, 36.0, 10039, 6663, 835, 17537
claudioadinho, 1378, 28.5, 3641, 3948, 321, 7910
Clavier, 1226, 77.5, 37, 129, 10, 176
cleannumberone, 1089, 27.8, 793, 1037, 56, 1886
cleduc, 1375, 32.9, 12952, 7541, 929, 21422
CleversonCordova, 1608, 29.7, 546, 355, 48, 949
clifford, 1315, 30.8, 10851, 11824, 1006, 23681
clipster, 1329, 30.3, 5857, 4935, 803, 11595
cloorem, 1097, 36.7, 145, 234, 10, 389
CMargol, 1098, 30.0, 1756, 2886, 47, 4689
cmcj, 974, 36.3, 1251, 1787, 130, 3168
cmurrieta, 1300, 30.2, 1626, 1162, 58, 2846
Cockoo, 1319, 52.8, 6651, 6137, 298, 13086
CocktailNation, 1238, 26.9, 603, 730, 82, 1415
cocodrilo, 1663, 46.6, 2012, 825, 143, 2980
Cokein, 957, 86.8, 11, 26, 1, 38
complete, 2007, 23.6, 25322, 16472, 3184, 44978
connectpeople, 1402, 31.0, 113, 95, 9, 217
Conscientiousness, 1661, 24.3, 1059, 620, 64, 1743
consdandin, 1121, 65.3, 38, 169, 2, 209
contak, 1113, 39.0, 1361, 1298, 68, 2727
coolb, 1257, 51.6, 32, 38, 5, 75
coolexpert, 1923, 49.4, 128, 134, 9, 271
coopnomaks, 1525, 28.5, 4978, 3051, 267, 8296
CoorsB, 1195, 44.6, 1115, 1672, 71, 2858
coprobo, 1276, 36.1, 372, 477, 46, 895
Coriolanus, 1344, 46.9, 33, 32, 4, 69
CosmicM, 1540, 32.6, 7388, 6013, 739, 14140
CPK, 974, 71.6, 52, 84, 5, 141
CrapsMaster, 1633, 24.0, 666, 737, 8, 1411
crashandburn, 1274, 49.7, 3851, 4512, 100, 8463
crazyblue, 1733, 57.4, 2552, 1673, 344, 4569
crazycro, 1211, 31.5, 796, 788, 96, 1680
cristianh, 1455, 32.7, 6557, 6753, 1742, 15052
Crocdile, 934, 38.5, 232, 580, 20, 832
crocomule, 1439, 39.3, 3646, 15331, 808, 19785
Crown, 1459, 42.2, 5109, 4099, 299, 9507
crownking, 1244, 31.8, 1171, 1524, 140, 2835
Cruin, 1330, 27.1, 7151, 5235, 501, 12887
CrushCity, 1011, 43.6, 39, 118, 2, 159
cseverin, 1246, 57.7, 2914, 4228, 208, 7350
cstarx, 1671, 22.6, 3931, 4001, 447, 8379
cstevep, 1000, 31.9, 432, 666, 25, 1123
ctenitchi, 1030, 44.2, 361, 568, 38, 967
cubs, 1627, 32.8, 15771, 3925, 629, 20325
cuchor, 1862, 20.6, 9488, 10157, 1600, 21245
Cuddly, 1265, 50.1, 374, 393, 20, 787
cybernie, 1177, 29.4, 3387, 4585, 217, 8189
Cyclones, 1439, 28.2, 6050, 3905, 415, 10370
Cynthus, 1558, 36.9, 5538, 3277, 336, 9151
dadek, 1533, 24.1, 10328, 15404, 998, 26730
dadop, 1180, 24.9, 531, 1032, 66, 1629
Daffyy, 1076, 38.3, 212, 272, 19, 503
dahai, 921, 43.9, 40, 82, 5, 127
Dalcin, 1052, 83.9, 4, 13, 2, 19
damchess, 1002, 28.6, 120, 142, 3, 265
dameyune, 1036, 22.8, 1568, 2314, 68, 3950
DamienBlack, 1290, 28.9, 1633, 2074, 159, 3866
damilasa, 1203, 29.5, 7986, 12217, 1029, 21232
DAMNATIOH, 991, 23.5, 1241, 1119, 8, 2368
DamonM, 1445, 23.4, 12830, 12694, 1076, 26600
damouno, 1921, 27.0, 2242, 1735, 296, 4273
danaildonev, 1507, 43.9, 375, 375, 49, 799
Dancing, 1304, 28.6, 22855, 5347, 685, 28887
dancor, 1187, 38.9, 251, 346, 33, 630
DanTilkin, 1611, 43.0, 4687, 3736, 659, 9082
daradija, 991, 38.7, 60, 114, 1, 175
DarkGauntlet, 1770, 16.6, 1715, 1851, 200, 3766
Darkknightre, 1098, 34.6, 1898, 4234, 103, 6235
darqknight, 1192, 29.3, 3743, 2486, 386, 6615
DarthDroshen, 1462, 33.0, 98, 98, 6, 202
Darya, 1222, 25.5, 3471, 4366, 210, 8047
DaveMGrant, 1451, 32.1, 6893, 7653, 786, 15332
Daver, 1503, 24.9, 18105, 21363, 1280, 40748
DavidWalter, 1606, 31.6, 1073, 479, 81, 1633
davorin, 1480, 25.7, 12611, 8199, 713, 21523
DawnParker, 1166, 31.5, 860, 672, 95, 1627
Dayffd, 1397, 30.9, 2198, 1722, 169, 4089
dbasta, 1382, 42.1, 1427, 1277, 102, 2806
dbos, 744, 33.4, 64, 269, 3, 336
dcastles, 1453, 30.9, 1707, 1443, 244, 3394
dcp, 1154, 31.2, 3211, 4150, 219, 7580
dddhgg, 1454, 23.8, 5259, 6791, 831, 12881
ddunjic, 1140, 29.5, 341, 311, 11, 663
DeanBeans, 1069, 44.1, 1114, 2211, 112, 3437
deathflower, 1716, 29.0, 182, 318, 25, 525
degoss, 1091, 37.6, 284, 400, 43, 727
DelhiBoy, 1653, 22.2, 2231, 2844, 179, 5254
DeliveryBoy, 1449, 27.0, 5035, 5382, 538, 10955
Deltavelorum, 1317, 33.6, 1875, 1392, 132, 3399
Delteam, 1175, 47.2, 736, 835, 33, 1604
denonym, 1649, 28.0, 926, 500, 66, 1492
depresija, 1233, 25.8, 8448, 15076, 840, 24364
Deryan, 808, 23.7, 1079, 1505, 195, 2779
desertfish, 1873, 29.4, 1004, 436, 93, 1533
DetroitMike, 1009, 30.8, 74, 152, 6, 232
dexs, 1476, 152.1, 2, 4, 0, 6
deynonicus, 1632, 34.2, 3497, 4461, 343, 8301
dfgordon, 1892, 39.9, 3598, 1444, 449, 5491
DhirenVS, 1528, 25.3, 5347, 6664, 281, 12292
dhmayer, 1664, 33.8, 3991, 4339, 550, 8880
dic, 1648, 37.0, 934, 822, 70, 1826
diegar, 1235, 29.0, 1009, 1390, 94, 2493
DiegoAbbas, 1324, 45.4, 119, 123, 20, 262
diegobertucco, 1629, 23.0, 6560, 4443, 357, 11360
Dimaeasy, 972, 42.7, 31, 125, 7, 163
dimaperes, 1622, 47.6, 46, 36, 10, 92
Dimo, 1460, 41.1, 12433, 6048, 1424, 19905
dingman, 1415, 22.8, 1016, 1081, 97, 2194
diogenisd, 1460, 38.0, 795, 180, 80, 1055
disakh, 1552, 22.6, 2085, 1890, 159, 4134
djangp, 1420, 16.5, 3493, 2946, 213, 6652
DjinnKahn, 1338, 37.6, 2779, 4395, 85, 7259
DJJDev, 1175, 24.2, 2329, 4159, 307, 6795
DjMochaFrapp, 1024, 35.1, 238, 562, 21, 821
Djsai, 843, 86.6, 5, 30, 0, 35
DLeviathan, 1280, 38.2, 1693, 1635, 124, 3452
DLGuest, 1347, 24.9, 1522, 1463, 50, 3035
DMasters, 1655, 23.6, 1016, 892, 74, 1982
DocBrock, 1225, 31.3, 6662, 7728, 415, 14805
Dogfodder, 1677, 41.4, 676, 630, 42, 1348
doggone, 1486, 38.0, 4970, 2292, 366, 7628
Dogyou, 973, 38.6, 489, 1882, 41, 2412
Dombivali, 1135, 36.8, 50, 66, 5, 121
donbarracuda, 1577, 32.3, 414, 493, 40, 947
DONCASTI, 1666, 65.2, 388, 554, 84, 1026
DonConchi, 1531, 23.7, 375, 261, 15, 651
donehung, 1494, 36.0, 387, 363, 28, 778
DonPato, 783, 49.1, 17, 79, 0, 96
donshakespeare, 1022, 34.6, 206, 237, 38, 481
dont, 1488, 37.7, 6745, 7286, 466, 14497
doroodgar, 1275, 45.4, 55, 49, 9, 113
doxa, 1225, 30.9, 5213, 11413, 504, 17130
dpopovi, 1845, 34.6, 5367, 1841, 433, 7641
draganj, 1654, 35.2, 2495, 3429, 458, 6382
dragans, 1153, 39.2, 1359, 1186, 57, 2602
DragonAce, 1744, 25.3, 7151, 6060, 762, 13973
Dragunflite, 1212, 34.5, 399, 569, 11, 979
dragunflyorig, 1088, 32.0, 3532, 4591, 116, 8239
Draqnur, 1462, 28.4, 5906, 4753, 350, 11009
DreamBasher, 1094, 68.9, 308, 374, 24, 706
dreamermeth, 2014, 44.8, 368, 132, 14, 514
Drewskidog, 1107, 27.9, 5398, 13244, 491, 19133
drinkingwater, 1345, 27.2, 2561, 2441, 233, 5235
Drivenbyfate, 1135, 158.8, 0, 6, 0, 6
DropVolley, 1511, 26.6, 13443, 18730, 2239, 34412
drpesic, 1293, 32.3, 1623, 869, 56, 2548
DrRoscoe, 1469, 45.5, 468, 328, 69, 865
DrStupp, 1239, 24.3, 6607, 6861, 462, 13930
drumme, 1262, 27.8, 4638, 4091, 147, 8876
drummerforlife, 1242, 39.5, 34, 84, 4, 122
drumset, 1107, 40.9, 1073, 686, 66, 1825
DrYnti, 1383, 31.0, 1946, 2183, 241, 4370
DSLtec, 1479, 50.4, 1788, 749, 244, 2781
Dtchess, 1526, 24.7, 599, 1230, 106, 1935
Duckbill, 1906, 28.4, 2347, 1850, 356, 4553
duhme, 1428, 24.3, 6814, 5948, 806, 13568
DukeCity, 1437, 26.1, 648, 480, 37, 1165
DusanzD, 1804, 25.0, 3226, 1704, 232, 5162
dushesatchess, 1582, 24.1, 390, 322, 37, 749
dustey, 1147, 44.2, 3120, 3802, 308, 7230
DutchChessHustler, 1590, 35.8, 49, 56, 9, 114
dvayntrub, 1866, 35.7, 6476, 3707, 722, 10905
EarlthePearl, 1500, 32.3, 9218, 11384, 1174, 21776
Easybeat, 1575, 91.6, 679, 530, 38, 1247
Eattheapple, 1294, 29.5, 489, 741, 14, 1244
eburger, 1237, 29.4, 4665, 5700, 142, 10507
ecochallenge, 1113, 58.5, 18, 24, 4, 46
eddyfactor, 933, 23.7, 1914, 2169, 188, 4271
EdEagle, 1403, 39.8, 60, 56, 6, 122
edeserr, 1678, 28.0, 2486, 2243, 239, 4968
EdHoculi, 1638, 20.9, 3050, 4932, 852, 8834
edikm, 1529, 22.3, 13193, 25295, 2295, 40783
Edjaups, 984, 35.4, 128, 198, 11, 337
egembl, 945, 46.1, 29, 65, 1, 95
Egyptology, 1605, 27.1, 6783, 7306, 522, 14611
eikku, 1671, 27.5, 2389, 3388, 523, 6300
Einzelganger, 1716, 23.2, 1986, 2816, 271, 5073
EKA, 1522, 21.4, 11963, 13865, 696, 26524
ekg, 1296, 25.5, 2483, 3424, 145, 6052
ElBasstardo, 1180, 33.7, 1554, 2292, 143, 3989
ElDorado, 1552, 27.0, 9339, 8337, 424, 18100
eleanorrigby, 1257, 26.4, 2415, 2499, 277, 5191
electroJ, 1070, 23.8, 302, 440, 36, 778
elgrande, 1259, 36.8, 12713, 19483, 1061, 33257
elgrandepatzer, 1426, 32.1, 1360, 1143, 51, 2554
ElJunio, 1464, 21.3, 6388, 5829, 534, 12751
ellababy, 1473, 36.9, 2835, 1187, 106, 4128
Elmerson, 1542, 22.8, 40216, 37398, 4120, 81734
elrodtherocker, 1408, 33.4, 3175, 2160, 268, 5603
emce, 889, 181.6, 0, 6, 0, 6
emmanuelaugustus, 1471, 28.1, 1466, 1399, 133, 2998
emmasam, 1459, 36.2, 18862, 12466, 1644, 32972
engineart, 1311, 24.0, 9010, 14344, 638, 23992
Englishteacher, 1325, 32.2, 3304, 4047, 367, 7718
Enochian, 1904, 24.8, 14830, 16030, 1609, 32469
ensomulven, 1464, 29.1, 2002, 1100, 174, 3276
EOSantonio, 1525, 16.2, 11164, 8174, 711, 20049
episodeninetynine, 1079, 38.7, 2050, 3887, 103, 6040
erdem, 886, 31.4, 110, 518, 4, 632
ergashev, 1336, 45.0, 38, 40, 4, 82
ergs, 1442, 49.2, 1451, 2154, 101, 3706
erniecapwell, 1098, 74.2, 31, 46, 0, 77
escapade, 1218, 44.8, 97, 82, 5, 184
ethicalRascal, 1609, 23.3, 17467, 16538, 1141, 35146
etor, 1674, 33.9, 13382, 13127, 1739, 28248
ettan, 1736, 28.5, 10029, 3705, 791, 14525
EtueShuni, 1287, 35.1, 264, 359, 33, 656
EVONEO, 1234, 59.9, 18, 22, 1, 41
Evsiukov, 1616, 21.1, 7786, 10507, 882, 19175
examichal, 1236, 63.9, 31, 25, 1, 57
eXistenZ, 1610, 33.1, 3888, 7168, 366, 11422
eyalszafran, 1382, 41.0, 1214, 806, 84, 2104
Eyechess, 1303, 26.0, 4074, 4189, 382, 8645
FabricioF, 974, 26.3, 722, 1448, 50, 2220
fadelio, 1010, 37.5, 145, 327, 22, 494
Faiavuds, 1190, 39.8, 220, 489, 18, 727
failer, 587, 89.0, 0, 25, 1, 26
falak, 1356, 58.0, 6392, 6990, 822, 14204
fallenaune, 1154, 55.2, 349, 356, 28, 733
fanachess, 1514, 28.8, 12896, 16876, 1489, 31261
Farlif, 1244, 29.4, 2751, 3951, 147, 6849
Farsyd, 1571, 29.4, 5302, 3112, 348, 8762
fastbilly, 1135, 31.7, 300, 347, 25, 672
fastglass, 1090, 33.5, 820, 1702, 41, 2563
Fateh, 1450, 41.4, 5293, 7174, 305, 12772
fatimus, 1346, 30.5, 2660, 2830, 284, 5774
fatjodos, 1100, 24.1, 1320, 1086, 88, 2494
fatserg, 1451, 30.9, 2995, 3924, 110, 7029
fawltytowers, 1211, 27.9, 148, 287, 19, 454
Faydogg, 1226, 27.6, 3453, 6631, 549, 10633
FBGHooper, 1361, 28.4, 3696, 3953, 636, 8285
fbust, 946, 39.4, 261, 336, 9, 606
fedore, 1009, 40.5, 2042, 4043, 112, 6197
felicx, 1723, 32.1, 118, 153, 17, 288
ferdig, 1730, 25.4, 6189, 8648, 730, 15567
fernanevyn, 1348, 35.0, 2149, 2007, 88, 4244
Ferron, 1107, 32.4, 7318, 6952, 407, 14677
FerStu, 638, 105.7, 1, 17, 0, 18
ferupe, 1379, 19.9, 10783, 18952, 1238, 30973
feryl, 1808, 34.4, 3762, 1262, 258, 5282
fianchettosstorm, 1289, 26.2, 1887, 5371, 226, 7484
Fibonaccie, 1495, 22.6, 2711, 3032, 325, 6068
fidellCastrol, 897, 106.1, 123, 212, 5, 340
fidodog, 1329, 30.2, 1167, 615, 68, 1850
fifthavenue, 1349, 21.3, 7735, 8185, 548, 16468
FIHTies, 1203, 37.1, 4633, 6996, 283, 11912
Filosofter, 990, 40.1, 576, 799, 28, 1403
finalprodigy, 1219, 31.8, 317, 394, 22, 733
finewine, 1127, 40.8, 1386, 1476, 92, 2954
fingerslip, 1367, 61.6, 1089, 742, 88, 1919, 1256, 38.5, 285, 306, 25, 616
firerico, 1356, 32.6, 1869, 2167, 114, 4150
FirstOboe, 1065, 24.8, 2120, 3399, 188, 5707
fischerson, 1635, 24.0, 23648, 11561, 2926, 38135
fishermania, 1395, 24.4, 1932, 1584, 147, 3663
fishflakes, 1739, 22.7, 5998, 6312, 428, 12738
FishWhistler, 1559, 50.0, 312, 140, 24, 476
fizzmaster, 1158, 44.9, 834, 310, 30, 1174
Flameraider, 1160, 34.8, 296, 669, 30, 995
flavo, 1371, 27.5, 6465, 8601, 373, 15439
Flicflac, 1903, 20.8, 1993, 2295, 232, 4520
flortje, 1769, 26.6, 1115, 1066, 135, 2316
fluters, 1596, 23.9, 25539, 33773, 1811, 61123
flyingfeats, 1031, 25.3, 888, 773, 71, 1732
fmarius, 980, 37.1, 1291, 3686, 30, 5007
fofate, 1586, 23.5, 3499, 4893, 545, 8937
footsoldier, 1068, 43.7, 2767, 5126, 218, 8111
foreverblackman, 967, 54.8, 412, 608, 16, 1036
forqueray, 1294, 27.0, 9081, 13387, 491, 22959
Foucault, 1187, 43.3, 759, 1189, 61, 2009
Foupoilu, 1632, 21.6, 6918, 8775, 604, 16297
FourBishops, 1242, 55.7, 188, 330, 20, 538
fourElements, 1357, 31.8, 1326, 1324, 124, 2774
Fozzy, 1966, 24.9, 10652, 8725, 951, 20328
frakinyov, 1308, 23.6, 4819, 5254, 272, 10345
francoso, 1544, 38.1, 3263, 7493, 299, 11055
Franiz, 1131, 43.7, 719, 984, 51, 1754
franktheblue, 1238, 46.0, 309, 232, 12, 553
FrankTheFirst, 1469, 29.9, 3082, 2608, 199, 5889
FreddyStevens, 1171, 30.3, 482, 665, 29, 1176
freefal, 992, 62.7, 26, 53, 2, 81
Freejackgold, 1549, 50.1, 142, 155, 13, 310
FreeLogic, 1249, 25.8, 468, 627, 21, 1116
frekhike, 1336, 27.0, 5831, 5714, 371, 11916
frengel, 1785, 23.9, 13957, 13442, 1890, 29289
frenk, 1688, 21.4, 14285, 12004, 2307, 28596
FreoDockers, 1127, 32.1, 6378, 7174, 631, 14183
FreshGreens, 1762, 20.3, 756, 913, 93, 1762
fridayknights, 1135, 27.0, 4778, 8477, 528, 13783
FrierTuck, 1795, 27.3, 1357, 1470, 42, 2869
fritzilgatto, 1174, 43.6, 1025, 611, 58, 1694
fritzjf, 1290, 23.9, 5506, 6413, 564, 12483
FrumPilot, 1363, 38.8, 2333, 2531, 125, 4989
fryerdl, 1427, 45.4, 283, 251, 20, 554
fsanyi, 1349, 28.4, 2737, 3047, 280, 6064
ftdavies, 1322, 29.6, 1114, 4476, 178, 5768
ftuteleers, 1434, 30.2, 1829, 2524, 140, 4493
Ftvkun, 1271, 50.8, 1191, 1671, 83, 2945
Fudpucker, 1713, 17.7, 1462, 1284, 85, 2831
FuFish, 1925, 74.5, 47, 13, 2, 62
funinthemorgue, 1318, 35.3, 749, 476, 34, 1259
funker, 1554, 27.7, 953, 427, 74, 1454
funseeker, 1729, 64.2, 149, 99, 16, 264
GabrielH, 1118, 30.2, 3766, 3257, 211, 7234
Gabrielrw, 1586, 26.2, 6453, 4320, 633, 11406
GairahGila, 1210, 29.1, 318, 420, 15, 753
GAlam, 1129, 42.1, 974, 947, 116, 2037
gallileo, 1442, 27.2, 16095, 16524, 804, 33423
gambord, 896, 34.9, 705, 1783, 25, 2513
gamefowl, 1705, 24.9, 2776, 4676, 329, 7781
gandalfmp, 1138, 33.6, 1456, 1697, 68, 3221
ganzgut, 1320, 26.3, 3818, 5050, 769, 9637
GarbageHead, 1403, 29.3, 2417, 1878, 296, 4591
Gards, 1086, 48.8, 264, 357, 43, 664
gatortaxguy, 1267, 33.3, 55, 72, 3, 130
GautamaBuddha, 1180, 80.0, 494, 920, 43, 1457
Gebix, 1199, 72.7, 61, 66, 6, 133
geezerly, 1245, 43.8, 3695, 1553, 162, 5410
geilebeer, 1298, 31.8, 9876, 12320, 632, 22828
gelgel, 1073, 24.5, 1219, 2390, 78, 3687
GeneralPickett, 1500, 55.7, 251, 128, 27, 406
georgethegiant, 1349, 36.6, 3223, 3554, 154, 6931
GeorgeV, 1521, 26.6, 8412, 3625, 185, 12222
geosah, 1430, 24.9, 8108, 7951, 1063, 17122
gerarddesuresnes, 1810, 26.3, 528, 307, 48, 883
gerardo, 1599, 25.0, 10087, 10344, 1178, 21609
Gerona, 1595, 39.1, 3149, 2182, 175, 5506
getfunky, 1124, 38.5, 137, 187, 7, 331
GFrege, 1429, 31.2, 1676, 1132, 99, 2907
Ghastly, 1335, 23.8, 14827, 12521, 901, 28249
ghita, 1466, 39.3, 5914, 2155, 436, 8505
gianti, 1721, 18.7, 35950, 62077, 4183, 102210
gibzeez, 1536, 81.5, 2133, 1867, 237, 4237
gilmarglover, 916, 29.7, 786, 867, 50, 1703
gima, 1464, 29.4, 1966, 1714, 398, 4078
gimnazijalac, 1559, 37.5, 830, 1102, 62, 1994
giupacc, 963, 47.3, 581, 695, 23, 1299
givemeabreak, 1371, 21.4, 5297, 2986, 366, 8649
gjtlsdnr, 1011, 67.9, 221, 277, 12, 510
glira, 1462, 36.3, 2463, 2650, 279, 5392
Globen, 1517, 27.4, 3305, 2099, 331, 5735
glupsk, 1555, 24.4, 5262, 2893, 218, 8373
gmartinp, 1253, 42.1, 2194, 2266, 188, 4648
GMKENYAN, 1235, 90.3, 776, 439, 64, 1279
GmRey, 870, 58.2, 14, 31, 0, 45
gobluebv, 1288, 36.5, 487, 476, 55, 1018
gojets, 1440, 27.4, 10774, 10467, 912, 22153
golfsailor, 1687, 27.8, 8805, 8871, 693, 18369
GoodBadandUgly, 1380, 72.5, 416, 211, 23, 650
Gorogoro, 1305, 75.2, 67, 60, 4, 131
gorrasmydog, 1262, 68.3, 99, 109, 7, 215
GotThatFire, 939, 30.5, 363, 484, 21, 868
GoUp, 1372, 42.0, 3153, 1702, 286, 5141
graceland, 1101, 54.2, 2912, 5131, 149, 8192
GrandmasterTako, 1502, 28.9, 3072, 2895, 513, 6480
GrassFarmer, 1179, 59.1, 771, 1050, 70, 1891
greatatothergames, 1498, 18.5, 1827, 2705, 274, 4806
greatchessfight, 1826, 43.2, 1246, 1743, 132, 3121
greatfighter, 1503, 29.1, 5882, 5551, 778, 12211
greekwizard, 1852, 29.5, 10200, 8905, 1637, 20742
GreenhoodyMd, 1421, 205.1, 2, 3, 0, 5
GregJohnstone, 1264, 35.7, 2912, 3620, 187, 6719
GregOakPark, 1195, 35.5, 3444, 3323, 230, 6997
gregsboard, 1668, 27.4, 5925, 2626, 749, 9300
Gregwilliams, 1127, 121.4, 1, 8, 0, 9
Greystoke, 1318, 33.1, 11866, 14410, 927, 27203
griegman, 1108, 39.1, 287, 568, 5, 860
grocko, 1232, 33.0, 5645, 6306, 286, 12237
grognard, 1097, 78.3, 47, 57, 5, 109
GroundhogDay, 1777, 21.7, 10852, 9976, 1253, 22081
grzdyl, 1211, 26.0, 5872, 5454, 341, 11667
gsis, 1899, 45.4, 180, 386, 37, 603
guapomedyobastos, 1689, 41.0, 561, 559, 94, 1214
guarionex, 1370, 57.1, 92, 65, 6, 163
guessbetter, 2033, 163.8, 6, 1, 0, 7
guiga, 1434, 18.1, 21529, 17439, 1756, 40724
Guillochess, 1320, 38.0, 515, 485, 9, 1009
Guimasbec, 1860, 35.5, 10158, 932, 142, 11232
Guiscard, 1489, 28.7, 2295, 2325, 328, 4948
guisepp, 1703, 24.7, 2448, 1161, 149, 3758
gullim, 2284, 61.1, 26, 12, 4, 42
guntheriks, 1318, 36.8, 754, 1211, 68, 2033
Guster, 1336, 27.2, 6039, 5914, 466, 12419
Guther, 784, 48.6, 148, 791, 10, 949
haberdashery, 1502, 38.6, 5650, 4384, 289, 10323
Haderlump, 1877, 24.5, 11892, 7070, 1141, 20103
haksula, 1220, 43.3, 1254, 1442, 58, 2754
halam, 1278, 38.2, 410, 447, 23, 880
HalChessDude, 1283, 39.4, 217, 213, 21, 451
halette, 1570, 26.5, 3347, 3162, 260, 6769
halfevil, 1346, 29.5, 152, 234, 11, 397
halheinrich, 1579, 33.3, 8141, 4919, 1150, 14210
Hamarin, 1725, 30.0, 1637, 1666, 177, 3480
hamasaki, 1378, 26.9, 3140, 1612, 141, 4893
HangedMan, 1758, 32.1, 8091, 3186, 470, 11747
hangook, 1510, 57.9, 30, 21, 3, 54
Hangtime, 1587, 22.7, 2425, 2071, 211, 4707
hansk, 1203, 26.4, 5794, 4069, 260, 10123
HappyChessLife, 1393, 85.0, 308, 240, 39, 587
happymonkey, 1037, 41.4, 1983, 2435, 104, 4522
HARIMENON, 928, 139.9, 2, 9, 0, 11
HarryTikos, 1328, 38.3, 1096, 1500, 102, 2698
Hattusil, 2066, 40.0, 1882, 1172, 186, 3240
Havre, 967, 43.1, 50, 37, 2, 89
Hayata, 1152, 30.4, 119, 228, 9, 356
hcuque, 1438, 33.7, 1656, 2114, 95, 3865
heckifiknow, 1414, 19.9, 540, 440, 34, 1014
Hefaracci, 1002, 38.8, 178, 259, 8, 445
Heffay, 1388, 21.0, 2654, 2506, 186, 5346
hehehpro, 1360, 25.1, 1525, 1782, 172, 3479
HeldRichthofen, 1408, 34.5, 559, 907, 72, 1538
hellostupid, 1171, 30.5, 1818, 3510, 253, 5581
helpless, 1733, 47.2, 4344, 5046, 521, 9911
hendocmk, 1103, 30.0, 678, 579, 39, 1296
henkdedenktenk, 1320, 22.0, 813, 911, 56, 1780
HenryTurbo, 1483, 40.6, 3211, 4568, 402, 8181
Hepi, 1470, 31.3, 8126, 11722, 497, 20345
Heraklit, 1523, 24.4, 4852, 4389, 363, 9604
Herbtea, 1471, 44.6, 677, 1062, 86, 1825
heurung, 1986, 55.6, 2441, 839, 92, 3372
Hexatetra, 1622, 26.8, 8019, 7171, 610, 15800
HighAspirations, 1491, 28.5, 2487, 1529, 140, 4156
Himalaya, 1856, 24.9, 8963, 9824, 1131, 19918
Hizakigp, 1101, 29.7, 425, 235, 18, 678
hman, 1202, 31.8, 10016, 6868, 488, 17372
hnikkl, 1461, 34.9, 4974, 3918, 305, 9197
hogoapen, 1391, 22.2, 10656, 11486, 1102, 23244
HolzSchieber, 1274, 38.7, 1322, 1433, 14, 2769
HoracioHH, 1476, 33.4, 1439, 2179, 160, 3778
HorseBadorties, 1604, 38.2, 2022, 1455, 243, 3720
HotCaldron, 1067, 27.1, 6917, 18501, 694, 26112
hottboy, 1124, 26.5, 508, 1169, 28, 1705
Hottybumbalottie, 1239, 23.9, 2840, 5099, 165, 8104
HPdrifter, 1134, 44.9, 2380, 3582, 224, 6186
hperalta, 990, 33.6, 464, 670, 38, 1172
Hreinn, 1111, 26.6, 4008, 5887, 279, 10174
Hunchie, 1246, 42.6, 697, 614, 53, 1364
Hvergang, 1316, 41.8, 1292, 1200, 376, 2868
hvutrong, 1428, 29.4, 1136, 1358, 96, 2590
HyperGalaxy, 909, 91.2, 6, 24, 0, 30
hzandras, 1404, 26.7, 10956, 9856, 1357, 22169
IagainstI, 1402, 37.8, 10080, 13488, 994, 24562
iameatingmyself, 1571, 29.1, 864, 629, 65, 1558
iamredeemed, 1226, 33.6, 277, 462, 32, 771
iamsas, 1596, 24.4, 546, 600, 48, 1194
IanW, 1285, 33.9, 3305, 1681, 143, 5129
ibowlin, 1185, 29.4, 256, 404, 23, 683
icanchess, 1573, 97.1, 14, 5, 0, 19
Ichessonpad, 1033, 122.3, 3, 7, 0, 10
idareyou, 1390, 41.0, 246, 243, 16, 505
idontthink, 1679, 28.9, 565, 459, 61, 1085
idvoiris, 1224, 26.9, 2103, 3502, 136, 5741
Idylapple, 1599, 27.1, 4448, 4042, 370, 8860
iezavel, 1766, 37.6, 1774, 1228, 199, 3201
ifconfig, 1478, 23.0, 1931, 2078, 149, 4158
igor, 1562, 27.2, 11927, 16322, 1743, 29992
IGotJediKnightsYo, 886, 32.7, 190, 548, 32, 770
ihgeo, 1199, 36.1, 1473, 2742, 114, 4329
ikab, 1428, 31.2, 2215, 2812, 215, 5242
ilankuni, 1766, 27.7, 7067, 6798, 916, 14781
IlllllllllllllllI, 1768, 27.9, 4846, 5400, 526, 10772
Illorum, 842, 69.3, 5, 42, 3, 50
imnotthewalrus, 1176, 44.7, 393, 359, 8, 760
impe, 1297, 57.5, 6854, 6552, 500, 13906
ImProbablyLost, 1442, 28.7, 2814, 3306, 214, 6334
IMV, 1172, 129.8, 3, 5, 0, 8
InControl, 1406, 40.3, 5659, 7537, 605, 13801
Indianpoint, 1263, 28.9, 3045, 4295, 331, 7671
IndianReaper, 1566, 33.3, 1678, 1966, 151, 3795
indrianto, 1030, 76.9, 64, 219, 2, 285
indyknight, 1357, 49.8, 64, 59, 5, 128
injustice, 1399, 36.9, 516, 1141, 21, 1678
inomneparatus, 1276, 34.8, 1056, 1743, 50, 2849
InsaneManiac, 1856, 42.9, 4808, 2083, 427, 7318
insertcoin, 1905, 54.9, 1454, 1510, 152, 3116
invocative, 2057, 22.6, 5344, 3925, 798, 10067
ira, 1667, 25.8, 7718, 4169, 719, 12606
IronJaw, 1156, 27.2, 1637, 1836, 96, 3569
ironpillar, 1393, 36.5, 2558, 2080, 92, 4730
ironwutang, 1138, 33.6, 204, 158, 11, 373
ISeeTheRain, 1007, 35.7, 46, 67, 3, 116
Isegrim, 1505, 37.1, 21193, 18083, 938, 40214
isochronus, 1690, 50.8, 1213, 674, 104, 1991
isom, 1867, 28.6, 10838, 8315, 1106, 20259
isopropyl, 1406, 23.2, 1767, 2641, 95, 4503
istarob, 1774, 22.2, 30847, 30816, 3514, 65177
Ithilien, 1852, 24.1, 4738, 3888, 397, 9023
itisfun, 1589, 39.0, 2520, 2825, 197, 5542
IvanOnys, 1050, 53.6, 21, 34, 0, 55
jaandestiny, 854, 26.6, 77, 190, 4, 271
jaanji, 973, 37.2, 104, 431, 5, 540
jabeda, 1274, 29.5, 841, 1393, 82, 2316
JaBurdon, 1478, 31.6, 4337, 2021, 282, 6640
jabustyerman, 1212, 33.1, 624, 727, 17, 1368
JackInBox, 1643, 30.3, 527, 721, 79, 1327
jackkniphe, 1131, 35.3, 82, 152, 6, 240
jackshrack, 938, 36.8, 210, 296, 16, 522
JahnTeig, 1754, 23.1, 11129, 12271, 1140, 24540
JaiMan, 1627, 22.9, 23801, 34138, 3092, 61031
Jajce, 1643, 23.3, 8615, 12935, 1405, 22955
jajogluck, 1507, 22.7, 5931, 3752, 389, 10072
jakor, 2053, 27.7, 5085, 6368, 939, 12392
jaliscience, 1327, 34.8, 287, 327, 20, 634
JamesRing, 1482, 37.2, 3207, 3904, 348, 7459
JamesSchuyler, 2047, 38.8, 5361, 1048, 258, 6667
jankowce, 1697, 28.5, 14958, 12220, 1284, 28462
Jaque, 1827, 40.6, 4737, 4717, 501, 9955
JaredStarTrek, 1301, 34.6, 733, 470, 55, 1258
jasonbales, 1273, 35.5, 8817, 9165, 677, 18659
jasonbryan, 1623, 27.5, 4203, 3564, 425, 8192
JAVRR, 1565, 35.7, 3043, 3438, 213, 6694
JayDoubleyou, 942, 34.1, 128, 167, 15, 310
jayeshbi, 1143, 35.9, 3467, 3488, 201, 7156
jaygrayone, 1368, 30.2, 1536, 695, 63, 2294
jaypurwarrior, 1135, 70.9, 18, 17, 1, 36
Jayseki, 1235, 42.3, 2529, 3253, 156, 5938
JazzyRick, 1260, 45.8, 2827, 3255, 219, 6301
jbackes, 1432, 40.5, 2665, 3539, 205, 6409
jcarnley, 1199, 34.0, 3328, 3783, 288, 7399
jcmcobra, 1368, 25.9, 5632, 9554, 638, 15824
JCombs, 1445, 74.7, 202, 136, 21, 359
jdokl, 1303, 27.5, 6550, 5974, 540, 13064
jdwyn, 1198, 55.5, 1508, 2293, 389, 4190
jeaok, 2169, 32.2, 291, 79, 17, 387
jedadiah, 1416, 26.4, 3585, 4132, 367, 8084
jedtoo, 968, 43.1, 2671, 5100, 143, 7914
jefftxelp, 1344, 29.8, 3560, 5086, 397, 9043
JellyRoll, 1700, 35.7, 2327, 1543, 167, 4037
jelser, 1304, 48.1, 113, 518, 25, 656
Jenlu, 1283, 296.0, 0, 1, 0, 1
Jeopar, 1518, 22.3, 2057, 1948, 96, 4101
jesses, 1214, 55.1, 55, 63, 3, 121
Jestrab, 1354, 32.7, 2274, 2537, 95, 4906
jestsahist, 1363, 32.5, 8814, 10933, 972, 20719
JesusChesser, 1044, 67.1, 16, 21, 1, 38
Jetblast, 730, 53.3, 22, 92, 0, 114
Jeterook, 1039, 34.2, 491, 534, 11, 1036
jewbagel, 678, 88.9, 4, 39, 0, 43
jibwoo, 1502, 29.8, 305, 279, 42, 626
jihadpawn, 1262, 35.5, 2679, 1401, 154, 4234
JimmyDaGrunt, 1391, 23.9, 8025, 11902, 962, 20889
jJackFlash, 1191, 36.8, 5224, 6618, 310, 12152
jjdoit, 1132, 32.3, 3237, 7897, 205, 11339
JJJA, 1223, 25.6, 2077, 3000, 305, 5382
jkell, 1485, 30.2, 2998, 2204, 348, 5550
JKheidegg, 1668, 30.0, 3840, 2066, 279, 6185
jkpasanen, 1242, 36.3, 2729, 2394, 178, 5301
JLGimeno, 1033, 88.0, 9, 14, 2, 25
jmag, 1500, 37.8, 1797, 1235, 175, 3207
jmaximel, 1078, 30.4, 136, 163, 9, 308
Jobby, 1328, 33.0, 2022, 3424, 182, 5628
joeloe, 1147, 28.2, 3470, 6854, 189, 10513
JoeO, 1361, 34.2, 3791, 3561, 161, 7513
joevick, 1478, 43.3, 270, 419, 28, 717
johanness, 1238, 35.0, 124, 194, 7, 325
johanpnza, 1298, 43.0, 376, 263, 50, 689
JohnBr, 1170, 29.3, 1343, 1294, 138, 2775
Johndeconqueroot, 1020, 29.3, 741, 871, 19, 1631
johnlivelong, 1756, 23.8, 5338, 5543, 508, 11389
johnmar, 1365, 31.3, 1849, 1637, 240, 3726
JohnnyPlaymaker, 817, 73.3, 3, 42, 0, 45
JohnxMorgan, 1261, 32.4, 586, 657, 28, 1271
JollyRogar, 1402, 38.3, 956, 748, 137, 1841
Joltan, 1699, 39.1, 6274, 8277, 787, 15338
JONAHTAN, 1645, 39.4, 463, 303, 23, 789
jonaurther, 1493, 42.8, 73, 48, 2, 123
jonce, 1448, 24.2, 7072, 10503, 905, 18480
JonChisum, 1357, 45.6, 1223, 805, 58, 2086
Jongers, 1637, 52.4, 523, 310, 33, 866
jonmccon, 1190, 32.0, 679, 718, 48, 1445
jonyfin, 1427, 22.6, 4492, 5103, 433, 10028
joole, 1198, 20.3, 867, 973, 28, 1868, 2308, 30.3, 1114, 343, 86, 1543
josephandrew, 1381, 33.4, 11664, 3626, 249, 15539
joshbandyface, 1156, 161.9, 421, 455, 30, 906
JOSHUAFERRARI, 1055, 120.1, 20, 34, 1, 55
Josleo, 1589, 22.8, 1590, 1807, 92, 3489
jova, 1769, 35.0, 5798, 9783, 1109, 16690
jqc, 1243, 32.6, 321, 403, 7, 731
JRAvatar, 1209, 40.6, 117, 208, 7, 332
Jromeromex, 1421, 28.2, 349, 320, 35, 704
Jschmid, 1258, 37.4, 300, 190, 14, 504
jsswaheguru, 1322, 58.8, 776, 690, 75, 1541
jtags, 1257, 32.2, 496, 451, 44, 991
jtcfmb, 1654, 21.3, 4610, 2254, 336, 7200
jthurman, 1209, 39.5, 1249, 1318, 90, 2657
jtonio, 1463, 38.4, 30, 59, 10, 99
Juanidrobo, 1302, 35.9, 650, 889, 51, 1590
juanjperez, 873, 32.2, 115, 494, 8, 617
juanpajimenez, 806, 133.8, 3, 7, 0, 10
juhi, 1016, 31.5, 837, 712, 11, 1560
Jumox, 809, 44.4, 33, 132, 1, 166
justfriend, 1369, 29.1, 1127, 1074, 90, 2291
JusticeforHungary, 1508, 44.5, 985, 1185, 103, 2273
JustMicgo, 1268, 26.1, 6653, 6014, 780, 13447
JustResign, 1361, 33.0, 1667, 1071, 83, 2821
jwgoes, 1645, 27.3, 6960, 4760, 480, 12200
kaelejessica, 1598, 46.1, 48, 34, 2, 84
kafagway, 1588, 24.6, 184, 272, 11, 467
Kafta, 1272, 40.2, 4180, 5042, 221, 9443
kaho, 1550, 27.0, 12650, 12088, 745, 25483
Kaisersoeze, 1624, 25.4, 3284, 2142, 132, 5558
Kajameski, 1493, 30.2, 883, 641, 74, 1598
kakuliisbest, 1206, 59.5, 100, 179, 4, 283
kalbuneh, 1446, 23.1, 9621, 11145, 590, 21356
kalmahhalifax, 1456, 37.9, 51, 91, 9, 151
kalounardo, 2117, 30.9, 14730, 11318, 1432, 27480
KarlMarx, 1544, 25.7, 6651, 2364, 299, 9314
kasak, 1575, 37.9, 7460, 7314, 999, 15773
KasparovsDog, 1224, 22.9, 8042, 7968, 250, 16260
katdog, 1508, 41.2, 2452, 1294, 72, 3818
kathmanuel, 1788, 24.4, 2716, 4990, 265, 7971
katschi, 1443, 41.4, 1367, 1055, 81, 2503
katyad, 1537, 38.9, 801, 740, 57, 1598
KawiRider, 883, 40.7, 423, 678, 18, 1119
KayKatz, 1355, 27.1, 9264, 14692, 1173, 25129
kayumi, 1874, 28.3, 4556, 2170, 276, 7002
kbourne, 1121, 22.0, 36283, 22004, 1757, 60044
kclemens, 1324, 38.8, 1421, 1919, 212, 3552
KCOLD, 1049, 34.1, 358, 1013, 16, 1387
KELLVJ, 1757, 314.0, 1, 0, 0, 1
kennos, 1153, 37.7, 708, 1499, 51, 2258
kenom, 1298, 36.0, 1435, 1881, 122, 3438
kenro, 1391, 42.9, 1764, 1184, 168, 3116
kevinsmithstudio, 1321, 46.1, 438, 393, 51, 882
kevvy, 1457, 30.0, 12937, 16609, 1100, 30646
kgo, 1473, 24.5, 460, 426, 32, 918
khanlost, 1454, 29.5, 141, 205, 16, 362
khans, 1385, 30.2, 763, 376, 60, 1199
khemosabi, 1107, 26.0, 1050, 1580, 44, 2674
Khombex, 715, 94.8, 3, 42, 1, 46
KIAUA, 1283, 26.0, 4635, 6860, 366, 11861
Kiera, 1300, 59.7, 2431, 2940, 240, 5611
KiingDavid, 781, 69.6, 16, 42, 1, 59
kijuh, 1436, 26.4, 7428, 5233, 311, 12972
kimberlie, 1244, 23.3, 3944, 3990, 132, 8066
Kimbobmik, 1511, 34.5, 628, 560, 77, 1265
KingBeeForThee, 1435, 63.4, 998, 670, 58, 1726
KingMiha, 1001, 63.5, 182, 260, 21, 463
kingmorf, 1270, 37.1, 631, 1278, 73, 1982
KingsIndianWins, 1714, 33.6, 6091, 6505, 937, 13533
kinshuk, 1403, 58.1, 395, 478, 51, 924
KipChess, 1506, 24.3, 1573, 1303, 133, 3009
Kirschsaft, 1472, 28.2, 2423, 2963, 135, 5521
KisRoman, 1188, 30.4, 437, 944, 25, 1406
kisseysmiles, 1108, 51.3, 709, 1367, 119, 2195
kitangkita, 1490, 38.5, 451, 549, 65, 1065
kjhamster, 1792, 24.4, 1868, 2005, 169, 4042
Kleppi, 1189, 37.8, 708, 926, 54, 1688
klevdav, 1351, 28.9, 3840, 5322, 203, 9365
klinxit, 1184, 35.3, 1782, 2240, 77, 4099
knaaky, 1354, 25.6, 1872, 1370, 90, 3332
Knet, 1661, 33.2, 8388, 3651, 484, 12523
KnightDisaster, 1606, 39.7, 80, 37, 2, 119
Knighteutonic, 1282, 50.4, 173, 185, 11, 369
knightmareblitz, 1312, 30.1, 4597, 5481, 569, 10647
knightmassey, 1514, 38.1, 3336, 2606, 380, 6322
KnightMaster, 1587, 24.9, 1631, 1475, 141, 3247
Knightpusher, 1332, 41.7, 1006, 488, 68, 1562
knightstooge, 1473, 21.4, 10650, 7225, 1145, 19020
knightt, 1450, 28.2, 170, 85, 6, 261
kod, 1807, 33.3, 8260, 4192, 336, 12788
kokchetav, 1118, 32.0, 1087, 2031, 58, 3176
kongoman, 1965, 18.3, 18363, 13807, 2185, 34355
konijn, 1834, 27.3, 7389, 9425, 1863, 18677
KONTOL, 1099, 83.7, 1, 44, 0, 45
kosten, 1270, 26.6, 2904, 3492, 267, 6663
kotaskotaskotas, 1083, 38.2, 1288, 2188, 139, 3615
kotbegemot, 1633, 39.6, 985, 859, 75, 1919
kotedvali, 1228, 24.5, 2085, 4434, 159, 6678
Koureles, 1036, 25.1, 669, 918, 50, 1637
Koyanistazi, 1456, 85.9, 5561, 7048, 463, 13072
krakmin, 1255, 22.0, 1589, 3113, 164, 4866
KRARAMSES, 1879, 32.7, 4687, 2490, 349, 7526
Krischi, 1705, 34.0, 1328, 1356, 219, 2903
KSRICHARANK, 1450, 34.9, 5772, 7334, 775, 13881
kukkakeppi, 1526, 26.8, 1708, 1504, 141, 3353
kungenbonde, 1088, 59.1, 246, 351, 9, 606
kvsankaran, 1201, 31.8, 3105, 4014, 348, 7467
ladardude, 1359, 47.9, 916, 935, 47, 1898
lafc, 1653, 23.1, 7021, 6041, 916, 13978
LajosDr, 1419, 24.6, 10759, 12210, 1281, 24250
lanandt, 1782, 23.3, 19767, 14720, 1983, 36470
LanternaViridis, 1330, 25.0, 222, 524, 20, 766
lapham, 1882, 23.5, 19300, 14356, 1993, 35649
Largadon, 1164, 33.2, 201, 188, 22, 411
LarryJ, 1117, 34.9, 1388, 1558, 79, 3025
LarsenB, 1594, 39.1, 5212, 3191, 440, 8843
laserknight, 1144, 30.1, 1632, 2008, 124, 3764
LastKingStanding, 1492, 25.7, 5757, 7499, 918, 14174
lawinee, 1571, 37.6, 3876, 3746, 285, 7907
lawrencegern, 866, 30.5, 128, 301, 5, 434
lazipawn, 1308, 39.5, 406, 308, 39, 753
leachy, 1650, 22.2, 588, 685, 67, 1340
LeadFinger, 1352, 26.4, 5368, 5110, 488, 10966
leangleang, 1311, 21.4, 708, 498, 35, 1241
lec, 1177, 36.8, 1899, 2741, 287, 4927
LeeRoth, 1529, 173.3, 5, 2, 0, 7
LeffeM, 1482, 22.3, 1104, 508, 79, 1691
LegalBeagle, 1665, 24.8, 15296, 4660, 841, 20797
legato, 1344, 41.6, 2308, 2131, 180, 4619
LegendBPG, 974, 24.4, 153, 282, 10, 445
legendyo, 997, 58.8, 174, 328, 24, 526
lemiiiii, 1368, 39.1, 6648, 5135, 378, 12161
lemurcgt, 1499, 23.3, 1614, 1744, 126, 3484
Lemurian, 1649, 29.6, 5609, 4882, 950, 11441
lensonp, 758, 51.1, 60, 161, 4, 225
leomahler, 1170, 27.9, 607, 848, 78, 1533
leonking, 1223, 38.3, 4107, 5528, 451, 10086
LeoTR, 1229, 37.7, 228, 251, 22, 501
Lepsoe, 1284, 55.7, 640, 505, 37, 1182
lerap, 1064, 55.2, 1026, 1265, 74, 2365
letekro, 1883, 29.4, 632, 513, 44, 1189
lethalLoy, 1499, 19.5, 229, 327, 26, 582
Lexmo, 1743, 15.4, 5850, 5291, 414, 11555
lexspec, 1012, 28.1, 641, 1083, 66, 1790
LiborK, 1250, 32.9, 1227, 1241, 81, 2549
Lictewitz, 1561, 30.1, 10727, 10777, 560, 22064
Lightguard, 980, 39.0, 268, 473, 23, 764
ligmo, 1549, 23.0, 4267, 4744, 365, 9376
Lije, 1584, 30.1, 6620, 5960, 710, 13290
Limmen, 1167, 25.8, 928, 742, 66, 1736
limun, 1193, 39.6, 636, 660, 41, 1337
LinuxGuy, 1365, 46.9, 409, 496, 48, 953
linuxinside, 1517, 33.5, 6784, 4088, 591, 11463
liquidjelly, 1382, 37.7, 1327, 1528, 97, 2952
Lither, 1801, 23.1, 2098, 2597, 307, 5002
LittleTrouble, 1833, 21.4, 1764, 1142, 173, 3079
lizardofoz, 1402, 43.2, 36, 38, 5, 79
LJNights, 1084, 39.6, 46, 83, 2, 131
LLIAMAH, 1700, 26.3, 6210, 5318, 502, 12030
lnhanj, 971, 57.4, 52, 93, 2, 147
Lojz, 1834, 23.1, 14564, 6914, 741, 22219
Longandsons, 1076, 46.7, 238, 415, 14, 667
LordCurzon, 1459, 28.6, 4349, 5030, 321, 9700
LordofthePieces, 1146, 22.9, 1528, 2485, 200, 4213
LordTyraad, 1148, 32.9, 1452, 2400, 109, 3961
lorenzoBBB, 1282, 19.4, 12618, 14359, 1311, 28288
Lostbishop, 1216, 23.3, 5184, 7400, 344, 12928
LOVERBOYS, 1168, 18.8, 17568, 29392, 4427, 51387
lowmiles, 1552, 22.1, 6640, 8711, 316, 15667
lowroller, 1419, 33.7, 4550, 3803, 410, 8763
lowther, 1108, 32.7, 108, 126, 9, 243
LPacheco, 1082, 32.4, 501, 1045, 41, 1587
LtPoultry, 1021, 61.3, 61, 126, 5, 192
Luckyfellow, 965, 36.1, 440, 348, 20, 808
lucytoo, 1488, 23.8, 3665, 4526, 330, 8521
Lugosi, 1412, 28.6, 9853, 9844, 541, 20238
LuigiJerk, 1132, 32.7, 257, 342, 23, 622
luizlandim, 1663, 29.7, 10110, 10157, 653, 20920
luprch, 1249, 50.2, 4142, 5966, 778, 10886
Lustang, 1277, 49.1, 305, 381, 27, 713
LuvDino, 1444, 42.4, 4269, 2532, 170, 6971
lxmoya, 981, 68.1, 278, 1002, 26, 1306
lyapunov, 1504, 25.3, 10806, 11815, 403, 23024
macgregorchess, 1347, 30.7, 6233, 5312, 364, 11909
MacGyverChess, 744, 138.9, 10, 47, 1, 58
macreez, 1245, 38.1, 2922, 3707, 188, 6817
MacroMike, 1444, 33.7, 9076, 7397, 474, 16947
macstevet, 1257, 26.6, 1677, 1574, 104, 3355
madhumita, 1261, 35.4, 875, 888, 55, 1818
madmayjohn, 1293, 41.1, 1844, 712, 85, 2641
Madscitwo, 1347, 56.3, 25, 19, 2, 46
mafimoya, 1080, 26.5, 880, 1001, 15, 1896
MagWyr, 1837, 28.8, 559, 488, 86, 1133
mahabonu, 1395, 41.5, 301, 210, 24, 535
Mahipat, 1169, 137.9, 2, 10, 0, 12
Majorhavok, 1583, 44.0, 203, 214, 22, 439
makitooop, 1701, 28.7, 1051, 406, 49, 1506
malcolmreynolds, 1547, 34.9, 784, 685, 100, 1569
Malekine, 1575, 20.8, 8798, 7471, 682, 16951
malpica, 1450, 21.8, 6939, 11592, 347, 18878
Manamongkings, 1324, 40.3, 49, 44, 6, 99
mando, 1666, 32.9, 7822, 9048, 878, 17748
Manhammer, 1219, 28.6, 176, 197, 2, 375
manoguru, 1503, 30.3, 3175, 3684, 278, 7137
manriper, 1290, 31.5, 2227, 3448, 225, 5900
Mansperger, 980, 30.0, 523, 441, 35, 999
ManTunTun, 861, 31.7, 66, 210, 2, 278
manueljaca, 1228, 23.8, 401, 530, 34, 965
manurpatria, 1267, 22.2, 5282, 6516, 186, 11984
Marcelo, 1498, 41.6, 1330, 1373, 161, 2864
Marcin, 1562, 45.9, 1801, 985, 66, 2852
Marenle, 1519, 18.7, 2668, 3151, 238, 6057
MARKLA, 1978, 77.2, 5856, 3655, 550, 10061
marklla, 1196, 29.1, 5209, 5655, 214, 11078
markmcgregor, 1736, 24.9, 1016, 1109, 166, 2291
marro, 945, 38.2, 782, 1944, 59, 2785
Marsel, 1333, 28.9, 8769, 9093, 920, 18782
martingambit, 1455, 30.4, 519, 489, 27, 1035
MartinyHerreraFa, 1861, 26.6, 227, 90, 10, 327
martip, 1381, 28.3, 658, 571, 40, 1269
MartyStokes, 1582, 27.3, 4583, 5113, 498, 10194
marxell, 1492, 49.0, 2319, 2980, 262, 5561
MARYROLL, 1225, 29.6, 1813, 2696, 194, 4703
masayem, 835, 55.7, 4, 61, 0, 65
MasterOfFishes, 1848, 45.7, 8767, 3400, 595, 12762
mastervvv, 1222, 42.4, 445, 761, 80, 1286
mateinsixtyone, 1392, 40.8, 804, 487, 94, 1385
mater, 1958, 29.1, 28140, 10458, 2404, 41002
MathewSimon, 1351, 27.9, 2652, 2697, 167, 5516
MatrixKruel, 1175, 25.7, 7489, 7205, 357, 15051
matthewdavid, 1354, 30.4, 2881, 3907, 264, 7052
MattHorwitz, 1620, 40.1, 164, 70, 14, 248
Mattrad, 1224, 26.6, 223, 222, 12, 457
mauldropper, 1062, 24.3, 624, 758, 32, 1414
Maurits, 1563, 29.6, 10363, 8852, 978, 20193
maxblackmax, 1053, 54.7, 17, 49, 1, 67
MaxFriis, 1335, 30.9, 3410, 1919, 290, 5619
maximusgladus, 1271, 27.7, 3669, 5922, 123, 9714
McCrea, 1296, 22.3, 9217, 11371, 553, 21141
mcginnfourtyfour, 989, 71.0, 33, 54, 1, 88
mchedester, 1283, 44.3, 908, 985, 140, 2033
mcoimbra, 1351, 25.2, 4967, 7095, 815, 12877
mdanseven, 1230, 34.4, 2238, 2804, 224, 5266
medvedko, 1196, 30.5, 5045, 3692, 392, 9129
Mefly, 1609, 190.7, 3, 2, 0, 5
Meijk, 1841, 35.1, 552, 512, 34, 1098
melito, 1379, 34.8, 3882, 6129, 319, 10330
memplex, 1652, 27.2, 14303, 20216, 1741, 36260
mentalGIANT, 1254, 63.6, 412, 486, 16, 914
mermentau, 1263, 34.4, 1499, 1488, 186, 3173
Meshu, 1432, 26.3, 984, 860, 62, 1906
metateck, 1189, 78.6, 1246, 1384, 126, 2756
metri, 1479, 32.5, 99, 91, 6, 196
mexsig, 1789, 82.2, 8164, 4489, 686, 13339
mexverrus, 1262, 27.7, 1554, 1913, 108, 3575
mgchappy, 1230, 30.8, 8633, 7904, 546, 17083
mhelshou, 1383, 26.2, 3933, 4957, 170, 9060
mhmm, 1270, 23.1, 1518, 1576, 128, 3222
micaiiah, 1429, 24.1, 1872, 1966, 178, 4016
MichaelYates, 857, 45.0, 22, 77, 2, 101
michkli, 1757, 39.8, 2115, 1189, 423, 3727
Miggidy, 1001, 40.1, 90, 101, 8, 199
mightyua, 1076, 38.6, 197, 321, 14, 532
miguelkarranza, 1296, 25.6, 10180, 12439, 1083, 23702
migut, 1719, 37.7, 2190, 1921, 82, 4193
Miha, 1835, 35.0, 11044, 13492, 2236, 26772
mihck, 1462, 19.9, 1193, 1366, 135, 2694
MikeDnyc, 902, 50.8, 88, 206, 3, 297
mikesbeat, 1210, 310.4, 0, 1, 0, 1
mikezc, 1209, 27.4, 4927, 8788, 755, 14470
millettes, 1443, 22.3, 2246, 2454, 558, 5258
milonguero, 1263, 21.4, 4092, 4550, 261, 8903
Milorad, 1778, 24.1, 15795, 17797, 2930, 36522
milpat, 1470, 23.6, 7854, 6576, 424, 14854
Miltie, 1946, 142.1, 10, 3, 0, 13
mindfreak, 1014, 37.5, 3474, 6124, 354, 9952
mindman, 1253, 35.9, 25647, 21199, 2333, 49179
miomatteo, 1308, 29.6, 653, 1039, 53, 1745
MIQDAD, 1301, 56.1, 622, 662, 24, 1308
MiroslavKomar, 1595, 34.0, 3015, 2212, 223, 5450
mirroor, 963, 39.2, 43, 79, 2, 124
mishmish, 1458, 23.4, 9532, 7611, 899, 18042
MisterSheik, 1292, 34.3, 617, 640, 19, 1276
MithrasHH, 950, 33.9, 143, 628, 3, 774
mjmonday, 1077, 35.7, 6583, 6109, 556, 13248
mkaeppler, 1003, 40.9, 108, 150, 10, 268
MKrump, 1140, 55.6, 275, 354, 19, 648
mmalchow, 1069, 29.0, 743, 1383, 21, 2147
mmodine, 1082, 35.3, 456, 627, 34, 1117
mnktl, 703, 100.9, 1, 21, 1, 23
modepasse, 1224, 109.6, 985, 887, 29, 1901
Mofish, 1538, 26.8, 1748, 1475, 70, 3293
Mogget, 1724, 26.5, 4156, 2631, 266, 7053
mohab, 1497, 37.1, 108, 92, 9, 209
mohala, 1145, 37.7, 987, 1729, 57, 2773
moisesito, 1153, 23.8, 2386, 3906, 189, 6481
moitarzan, 1467, 56.1, 1056, 1175, 77, 2308
mokrton, 1617, 22.0, 649, 485, 52, 1186
monacan, 1651, 20.4, 44336, 40930, 2978, 88244
MoonVine, 1317, 22.7, 2146, 3106, 128, 5380
moorthy, 1484, 213.6, 0, 4, 0, 4, 1580, 27.9, 12184, 7763, 1215, 21162
mopenaru, 1515, 27.6, 1482, 1651, 180, 3313
moros, 1206, 137.1, 42, 73, 4, 119
Morphie, 1425, 29.5, 4867, 5237, 532, 10636
Morphyer, 1233, 25.0, 651, 994, 53, 1698
MorphySwede, 1462, 40.2, 2802, 2655, 181, 5638
Mortalnut, 1270, 23.7, 167, 338, 33, 538
Morteza, 1876, 30.2, 6958, 6670, 654, 14282
Morvan, 1180, 31.8, 4417, 8249, 508, 13174
Moscarda, 1439, 22.3, 389, 389, 17, 795
moshest, 1103, 24.7, 3209, 6418, 221, 9848
mosinnagant, 1287, 45.8, 221, 260, 14, 495
mpam, 759, 47.5, 33, 65, 0, 98
mpluspoint, 1051, 92.4, 6, 12, 0, 18
mpython, 1209, 28.3, 281, 265, 31, 577
MrBravo, 938, 34.2, 190, 728, 20, 938
MrBuzzino, 1708, 20.0, 8233, 9615, 787, 18635
MrGoon, 1872, 31.5, 2694, 2337, 416, 5447
mrhamid, 1136, 32.1, 737, 1737, 105, 2579
mrlmrl, 1742, 24.0, 10638, 15971, 1163, 27772
mroche, 1140, 19.0, 2973, 3619, 276, 6868
MrProphylactic, 1798, 65.1, 17, 16, 2, 35
MrQue, 1902, 18.5, 1096, 584, 48, 1728
MrSchneider, 1399, 32.9, 927, 803, 45, 1775
MrTimm, 1022, 33.1, 782, 845, 54, 1681
mrtrulz, 1276, 37.5, 164, 194, 36, 394
MRZWISCHENZUG, 1464, 25.5, 8286, 9916, 637, 18839
msheaf, 1802, 52.9, 5251, 4111, 637, 9999
MtTabor, 1536, 43.9, 1905, 1079, 115, 3099
mugger, 1323, 23.8, 8891, 8859, 1010, 18760
mukeshgame, 826, 40.1, 21, 87, 1, 109
multilis, 1381, 23.8, 1447, 1408, 127, 2982
munalukko, 1523, 25.9, 1155, 1159, 161, 2475
Murx, 1368, 41.6, 661, 534, 27, 1222
musya, 1382, 30.9, 874, 572, 15, 1461
muwwatalli, 1802, 28.6, 1896, 3163, 256, 5315
MUYAK, 1456, 34.1, 617, 456, 55, 1128
mxjusc, 1242, 49.3, 1267, 1517, 118, 2902
MXracer, 1212, 47.1, 621, 350, 27, 998
myaso, 1114, 61.0, 748, 1680, 79, 2507
Mylo, 1351, 22.8, 294, 460, 23, 777
mynet, 1277, 22.6, 8668, 10425, 462, 19555
nahuel, 1326, 45.4, 2055, 2440, 122, 4617
Najdorff, 1250, 28.4, 1862, 2228, 180, 4270
najman, 1638, 36.1, 911, 862, 90, 1863
naleon, 897, 52.1, 62, 279, 2, 343
nameloek, 1493, 23.0, 39388, 30241, 2497, 72126
Namocich, 1078, 47.2, 1785, 3409, 127, 5321
nanee, 1547, 30.9, 101, 165, 11, 277
NapaDoc, 1272, 34.9, 505, 991, 72, 1568
nattylight, 1495, 24.6, 1035, 1172, 80, 2287
nbvcx, 1550, 27.8, 146, 149, 7, 302
ndachess, 1383, 31.1, 2461, 3789, 241, 6491
nebben, 1218, 38.7, 1339, 2243, 140, 3722
nedpatrick, 1277, 193.4, 1, 3, 0, 4
neixfle, 1891, 51.6, 858, 1078, 157, 2093
nelar, 1771, 31.9, 70, 71, 4, 145
nepekeover, 1447, 34.0, 2457, 2501, 170, 5128
nepossiver, 1547, 20.7, 9380, 8293, 866, 18539
Nerazat, 1188, 20.0, 1485, 1589, 80, 3154
netoz, 1285, 30.3, 5224, 9116, 345, 14685
Neuronius, 1182, 31.9, 1622, 2584, 54, 4260
newellsoldboys, 1429, 30.3, 264, 746, 40, 1050
newmove, 1558, 23.9, 6779, 7611, 593, 14983
nexuver, 1071, 32.0, 359, 541, 19, 919
nfazli, 1227, 35.6, 1096, 990, 76, 2162
NforksQ, 1195, 37.1, 58, 55, 2, 115
ngptmat, 1223, 28.1, 4054, 5657, 277, 9988
nhman, 1019, 42.8, 411, 454, 15, 880
Niak, 1690, 30.6, 4162, 2478, 266, 6906
nicktc, 1249, 28.9, 741, 796, 79, 1616
NightFury, 1730, 32.5, 522, 518, 51, 1091
Nikachu, 1851, 58.2, 1075, 531, 39, 1645
Nikilady, 1415, 26.1, 5715, 2918, 386, 9019
NikoIaj, 921, 70.5, 10, 23, 1, 34
NilMik, 841, 35.2, 79, 162, 3, 244
nimmersatt, 1261, 28.5, 3728, 6241, 312, 10281
NimzoKnight, 1476, 23.3, 8385, 11503, 758, 20646
NiteHawke, 1186, 81.8, 13, 11, 1, 25
nkb, 1347, 23.0, 13767, 22133, 1153, 37053
Nniimmzzoo, 1682, 33.0, 2121, 3037, 234, 5392
nnsanh, 1222, 37.3, 4765, 7817, 423, 13005
nodras, 1387, 34.2, 423, 698, 55, 1176
nolemotion, 1199, 27.4, 14616, 13470, 486, 28572
NoLogik, 802, 59.6, 15, 100, 2, 117
noloveexpected, 1302, 28.0, 9379, 9156, 1495, 20030
nomnom, 1053, 49.1, 183, 261, 9, 453
Nopawn, 1792, 23.7, 20631, 15656, 3101, 39388
normano, 1132, 26.0, 2010, 2890, 317, 5217
northsider, 1113, 33.1, 3325, 1273, 164, 4762
nosdivad, 2273, 40.0, 4071, 713, 225, 5009
noseblunter, 1653, 51.2, 1757, 1966, 137, 3860
NotMyDay, 1970, 24.0, 1159, 777, 50, 1986
novix, 1313, 30.5, 2762, 4445, 306, 7513
nunavuttaxi, 1637, 28.8, 2507, 1265, 65, 3837
nutgrinder, 1308, 63.6, 314, 231, 41, 586
nvc, 1509, 33.2, 3767, 4672, 349, 8788
nwayfarer, 1085, 51.0, 73, 121, 4, 198
oakseed, 930, 39.8, 2094, 3539, 262, 5895
obamacare, 1417, 75.4, 17, 8, 1, 26
obgyn, 1001, 31.3, 1745, 1990, 80, 3815
obikats, 1085, 40.7, 2709, 3227, 165, 6101
Octv, 841, 68.1, 68, 145, 2, 215
ocumichu, 1548, 31.8, 4785, 7413, 1110, 13308
odnadenaz, 1114, 29.9, 686, 761, 24, 1471
ogreforce, 1248, 26.2, 618, 606, 49, 1273
oguzusman, 1482, 25.3, 7371, 4088, 462, 11921
ohrworm, 1415, 28.2, 7014, 9100, 882, 16996
OJSimpson, 1787, 29.0, 13977, 13765, 1908, 29650
okazako, 1408, 34.3, 1805, 1577, 73, 3455
Olarin, 1271, 32.0, 1022, 1276, 129, 2427
olcga, 1550, 21.2, 309, 358, 49, 716
OldBuddy, 1499, 28.7, 1186, 948, 28, 2162
oldengawy, 1543, 72.2, 160, 255, 16, 431
OldHolborn, 1268, 53.6, 404, 493, 23, 920
oldprovincial, 1166, 40.9, 481, 703, 27, 1211
olebob, 1237, 31.9, 2242, 1793, 89, 4124
OleKicker, 1334, 19.9, 16060, 14643, 815, 31518
olemuc, 1156, 44.7, 117, 94, 10, 221
OLIVETREE, 1426, 25.3, 253, 167, 22, 442
Olneb, 1623, 21.5, 4167, 3616, 193, 7976
Omsk, 1905, 35.1, 620, 275, 50, 945
onceandfutureking, 966, 94.6, 6, 11, 2, 19
OneArmBoxer, 1857, 23.3, 11186, 7114, 771, 19071
onebasispoint, 1147, 46.5, 441, 305, 38, 784
onedayfly, 1117, 36.7, 1721, 3178, 190, 5089
Onelegkicker, 1068, 53.1, 861, 1155, 71, 2087
OnlyTheBlood, 1280, 22.3, 8561, 12332, 1279, 22172
oonwah, 1093, 63.6, 372, 364, 13, 749
openlook, 1462, 27.6, 2597, 2507, 98, 5202
optimize, 1372, 35.4, 101, 79, 1, 181
Oracleman, 1188, 59.7, 159, 328, 24, 511
Orangedoom, 926, 34.4, 540, 1333, 107, 1980
orionchik, 1352, 29.2, 1308, 1244, 93, 2645
ornito, 1489, 23.4, 17630, 14428, 1048, 33106
Oroblram, 841, 99.5, 3, 30, 3, 36
Orusse, 1867, 34.9, 115, 111, 8, 234
OsaridSaris, 1646, 36.4, 2599, 1097, 228, 3924
Oscarzulu, 1719, 29.2, 10830, 3375, 887, 15092
ossihousi, 1322, 33.4, 2114, 2082, 139, 4335
Ostojic, 1913, 30.0, 1152, 1068, 153, 2373
oswjas, 1330, 26.2, 219, 166, 21, 406
othermeans, 1214, 31.1, 6594, 6443, 425, 13462
otherworldly, 1396, 43.4, 2161, 1839, 153, 4153
OTK, 1632, 34.0, 2493, 2869, 557, 5919
otrenav, 1124, 61.4, 7, 55, 0, 62
ottanik, 1677, 25.3, 10458, 9903, 707, 21068
oubok, 1216, 31.7, 511, 599, 66, 1176
ovaskainen, 1611, 25.0, 1658, 847, 141, 2646
Ovoplav, 1534, 31.1, 167, 126, 16, 309
oxothnk, 1220, 32.9, 220, 238, 22, 480
paar, 1556, 22.8, 8842, 9666, 1123, 19631
pabhi, 1560, 94.5, 657, 637, 93, 1387
pabloarg, 1464, 27.1, 3471, 3678, 482, 7631
paculla, 1706, 35.5, 785, 777, 80, 1642
Paillao, 1411, 66.6, 23, 16, 0, 39
Pajonal, 1374, 28.5, 5443, 6713, 582, 12738
pallonetto, 1280, 31.2, 2123, 3314, 373, 5810
Papaflesas, 1581, 21.0, 38978, 43211, 3724, 85913
papafrita, 1518, 68.4, 224, 196, 18, 438
PappuTheGreat, 1056, 55.1, 112, 167, 3, 282
Paradoxen, 1189, 31.2, 221, 387, 35, 643
paragn, 1425, 27.7, 7770, 10967, 595, 19332
parasbrcr, 1339, 58.8, 375, 190, 22, 587
Paregorics, 1636, 31.6, 1854, 1937, 222, 4013
parisestmagic, 1581, 41.3, 8953, 9403, 676, 19032
parsleydonn, 1438, 33.3, 1245, 446, 144, 1835
PastorEd, 1394, 41.9, 2213, 2942, 186, 5341
PastorK, 1396, 22.6, 7982, 7434, 529, 15945
pateupegui, 1220, 25.6, 3723, 6919, 534, 11176
patients, 1588, 37.2, 840, 598, 30, 1468
patosky, 1511, 30.1, 3467, 4061, 372, 7900
Patra, 1632, 49.6, 1249, 652, 169, 2070
paulbuchman, 2063, 28.3, 11938, 5669, 1339, 18946
paultopia, 1373, 27.9, 6610, 5570, 492, 12672
Pawndelion, 1416, 19.4, 8681, 12419, 1432, 22532
pawnDonkey, 1324, 31.1, 1483, 1036, 135, 2654
pawnedpawn, 1307, 31.4, 183, 295, 30, 508
PawnJockey, 1635, 29.2, 5421, 4068, 434, 9923
pawnohqueen, 1230, 100.9, 126, 135, 10, 271
PawnSmacker, 1560, 32.7, 2001, 1733, 190, 3924
PawnSoldiers, 1379, 33.7, 935, 903, 74, 1912
PBee, 1051, 27.1, 751, 1205, 40, 1996
pdas, 1706, 71.2, 463, 328, 38, 829
pedereng, 1100, 43.7, 7547, 10938, 524, 19009
PedroA, 1545, 26.3, 7161, 8369, 648, 16178
pedroselle, 1698, 24.5, 13860, 17718, 1135, 32713
Pekan, 1178, 42.2, 6263, 5099, 459, 11821
peonveloz, 1451, 27.4, 821, 1035, 51, 1907
perfessor, 1555, 37.2, 3415, 3307, 360, 7082
Permanence, 1456, 33.9, 4242, 3275, 297, 7814
peropaf, 1564, 54.6, 117, 61, 8, 186
persianprince, 1815, 27.5, 2643, 2768, 208, 5619
Pesboy, 1699, 50.1, 2463, 2318, 350, 5131
PetkoNikolic, 1422, 34.7, 1839, 1625, 208, 3672
pgr, 1467, 31.3, 10329, 12501, 953, 23783
PhilidorsMate, 1419, 38.3, 4844, 4733, 329, 9906
PhillipGreen, 1347, 26.7, 1227, 1000, 87, 2314
philmic, 1447, 34.7, 13923, 18107, 948, 32978
PhilOfive, 2154, 31.3, 8206, 4049, 1265, 13520
Phoeniks, 1503, 19.8, 5962, 5636, 770, 12368
piedazzo, 1801, 23.0, 16757, 23843, 2805, 43405
pietpluymert, 1966, 27.3, 416, 258, 45, 719
Piggi, 1647, 34.3, 2312, 1159, 113, 3584
pinehead, 1067, 25.1, 1248, 2222, 350, 3820
Pinkgirl, 1574, 32.4, 7889, 4977, 677, 13543
PippLogic, 1326, 209.7, 13, 11, 0, 24
PiranaLoco, 1227, 26.3, 5740, 6765, 393, 12898
pircer, 1926, 25.7, 667, 1141, 109, 1917
pitfall, 1108, 31.1, 8243, 6683, 442, 15368
Pixar, 1109, 59.4, 251, 443, 18, 712
pixfan, 1664, 29.9, 2990, 2243, 364, 5597
platinumbus, 1139, 36.7, 364, 474, 39, 877
Player, 1426, 350.0, 204, 283, 10, 497
playerX, 1509, 48.4, 9025, 4542, 677, 14244
playingforfun, 1323, 27.5, 5101, 10202, 623, 15926
playoften, 1614, 26.1, 9479, 11043, 1146, 21668
Pletnev, 1607, 36.9, 1078, 630, 56, 1764
plotkin, 1265, 37.3, 3556, 6730, 433, 10719
pmeat, 925, 24.5, 848, 2564, 34, 3446
pmipmi, 1634, 31.0, 191, 103, 11, 305
pmiral, 1369, 34.2, 6287, 6021, 622, 12930
Podjevsky, 1578, 30.5, 5603, 4877, 390, 10870
PoindexterIII, 1561, 21.0, 13792, 11594, 1569, 26955
pointenoire, 1465, 19.8, 828, 947, 67, 1842
Polarisman, 1581, 21.4, 9726, 10538, 748, 21012
polite, 1659, 28.6, 26717, 27817, 2663, 57197
pollock, 1893, 80.9, 2394, 1863, 208, 4465
Ponderthis, 1647, 26.6, 4091, 3193, 294, 7578
poorpatzer, 1603, 36.3, 309, 213, 48, 570
PoorPawn, 1369, 30.0, 6427, 6605, 806, 13838
porfavor, 1119, 31.1, 8559, 10855, 715, 20129
potts, 1172, 32.3, 1389, 1561, 78, 3028
powidleusw, 1584, 25.4, 3779, 3455, 253, 7487
pppooolllkkk, 1163, 21.3, 185, 284, 26, 495
PPXAKE, 1960, 26.2, 5248, 6041, 760, 12049
prashantsharma, 1143, 63.7, 48, 200, 7, 255
premed, 1268, 24.2, 887, 1365, 58, 2310
Preserve, 1189, 33.8, 392, 549, 23, 964
pretythesame, 1249, 31.9, 1775, 2207, 139, 4121
Pretzels, 1305, 33.4, 3064, 2026, 146, 5236
Prijovic, 1690, 21.0, 2044, 2355, 235, 4634
princess, 2020, 33.3, 23362, 17952, 1628, 42942
priorityversion, 1756, 32.6, 277, 145, 18, 440
prismax, 1006, 35.7, 666, 1465, 32, 2163
ProfPumpkin, 1319, 31.1, 2097, 2812, 63, 4972
Proles, 1866, 30.6, 70, 102, 26, 198
Propagation, 1341, 33.0, 1412, 1510, 179, 3101
PROSTOR, 1402, 22.4, 400, 227, 21, 648
proudtobeindian, 729, 59.6, 8, 57, 1, 66
PrtgsMnWr, 1193, 33.5, 884, 1383, 61, 2328
psutrecht, 1233, 35.5, 776, 2050, 102, 2928
PsychoGod, 1509, 36.0, 16023, 7296, 614, 23933
ptaha, 1020, 45.8, 319, 607, 78, 1004
pubglhf, 1005, 58.4, 18, 62, 3, 83, 1405, 54.7, 2296, 3687, 269, 6252
Pumpernickel, 1179, 25.5, 531, 712, 62, 1305
purky, 988, 32.1, 97, 249, 3, 349
PushKid, 1285, 37.7, 2014, 2288, 185, 4487
Pushkin, 1348, 19.5, 17098, 30377, 2351, 49826
puzman, 1433, 24.8, 8800, 11864, 738, 21402
puzzlemethis, 1429, 30.7, 562, 1087, 70, 1719
PWA, 1922, 23.1, 7169, 9965, 1659, 18793
Pystota, 1524, 38.4, 1927, 3054, 466, 5447
PZaas, 1563, 32.4, 1344, 781, 57, 2182
qgd, 1508, 24.8, 10899, 11587, 1909, 24395
queendancingpsfag, 1276, 43.8, 85, 100, 1, 186
quelg, 1528, 27.9, 3264, 2895, 179, 6338
quiguisola, 1590, 23.4, 155, 161, 9, 325
QxQ, 1192, 31.0, 6923, 9581, 983, 17487
raccoonmario, 1088, 27.3, 505, 591, 46, 1142
racher, 1690, 31.8, 4604, 5140, 509, 10253
radicalposture, 1493, 54.7, 32, 19, 1, 52
RAFALKOSTECKI, 1675, 28.2, 2954, 2197, 270, 5421
RafaNadal, 1483, 22.0, 1058, 1102, 99, 2259
raffa, 1455, 16.3, 20974, 28286, 1389, 50649
RafiChowdhury, 1559, 58.4, 641, 283, 74, 998
RageET, 1692, 47.3, 131, 141, 7, 279
RAH, 1319, 27.7, 9607, 14992, 938, 25537
RAHEEM, 1136, 42.6, 2214, 3256, 181, 5651
rajharwani, 1111, 43.0, 31, 95, 0, 126
ramac, 1476, 23.6, 853, 1291, 88, 2232
Rambotzky, 1041, 26.6, 267, 522, 24, 813
rameshsrivats, 1461, 24.3, 6543, 4839, 559, 11941
ramparashar, 1632, 23.0, 10953, 7595, 693, 19241
ramrod, 1261, 30.7, 4410, 4597, 292, 9299
RamsesIII, 1641, 30.1, 2900, 2900, 408, 6208
randspringer, 1268, 22.4, 6582, 8029, 548, 15159
Rapier, 1312, 42.4, 480, 585, 56, 1121
RattyMouse, 1351, 27.6, 6421, 5464, 405, 12290
Razinator, 1301, 24.5, 491, 495, 70, 1056
rbnn, 1661, 31.5, 1924, 2168, 250, 4342
RBurg, 1598, 27.9, 6116, 5052, 674, 11842
RCgladiator, 1387, 57.8, 80, 66, 7, 153
rdario, 1266, 22.9, 1239, 2166, 205, 3610
recvx, 1170, 60.4, 25, 37, 1, 63
redgolfball, 1033, 63.6, 1074, 1301, 40, 2415
rednapkin, 862, 35.4, 137, 244, 9, 390
RedPhoenix, 1429, 33.1, 2070, 1432, 259, 3761
redsolarearth, 1312, 33.6, 1119, 1346, 67, 2532
rego, 1373, 28.1, 3110, 4057, 339, 7506
renaven, 1560, 33.7, 2750, 2737, 300, 5787
replywalker, 1467, 35.3, 1996, 1195, 201, 3392
RESE, 1386, 21.5, 392, 305, 25, 722
resistence, 1320, 36.3, 5071, 6130, 413, 11614
resol, 1297, 29.2, 4423, 4074, 196, 8693
retsam, 1348, 20.6, 23964, 25149, 1829, 50942
ReubenFine, 1501, 27.9, 16738, 12815, 1579, 31132
Revup, 1272, 67.0, 18, 13, 0, 31
RexRegorum, 1377, 56.2, 141, 126, 15, 282
ReyDeBuin, 1332, 34.4, 1404, 1628, 231, 3263
rezatavak, 1317, 32.5, 264, 412, 29, 705
rhoalpha, 1547, 29.1, 4573, 3750, 463, 8786
riaz, 1236, 29.1, 8624, 18508, 614, 27746
RiemannUS, 1464, 43.0, 1039, 702, 120, 1861
rimjhim, 1316, 24.0, 2059, 2068, 202, 4329
Ripitup, 1404, 30.1, 8474, 8413, 601, 17488
rjbriggs, 1355, 33.6, 2301, 2964, 210, 5475
rjw, 1207, 32.4, 4585, 5565, 174, 10324
rjymdgfkmnj, 1387, 30.7, 743, 743, 43, 1529
rkosirog, 1201, 40.4, 105, 134, 10, 249
rmatous, 1285, 34.0, 3515, 3138, 367, 7020
RMSWANN, 1406, 44.3, 3044, 3229, 306, 6579
rnickanderson, 1335, 35.5, 1571, 1568, 97, 3236
robalack, 1374, 29.2, 225, 177, 9, 411
RobertJones, 1338, 29.3, 1642, 2019, 117, 3778
roberttdaniel, 1044, 30.3, 2354, 4176, 209, 6739
RobLab, 1473, 31.4, 11358, 6619, 679, 18656
RoboMan, 1292, 32.4, 3127, 2786, 356, 6269
rockday, 1373, 34.6, 1357, 1536, 96, 2989
rodhessing, 1537, 27.2, 14404, 15493, 2068, 31965
rodnojo, 1613, 21.0, 6927, 11260, 514, 18701
roduart, 1158, 36.5, 135, 217, 11, 363
rodzhers, 1384, 101.4, 187, 140, 9, 336
Roetman, 1092, 45.8, 979, 907, 95, 1981
RogerioMaia, 949, 77.0, 11, 24, 0, 35
romanra, 1602, 27.8, 2668, 2265, 268, 5201
Rongley, 1426, 32.5, 1891, 1855, 83, 3829
ROOI, 1125, 41.3, 2112, 3616, 199, 5927
Rookenburg, 1384, 60.1, 65, 72, 5, 142
roqueur, 1331, 41.7, 1635, 1123, 85, 2843
Rosalie, 1329, 30.3, 485, 611, 21, 1117
Rossgo, 1664, 30.1, 12689, 12444, 1243, 26376
RousterRook, 1273, 23.0, 13474, 19362, 1681, 34517
roxannelv, 1250, 27.7, 3867, 4745, 357, 8969
roxtar, 1051, 33.1, 668, 690, 30, 1388
Rrreeetttiii, 774, 102.3, 2, 19, 0, 21
rubal, 955, 79.6, 7, 20, 1, 28
RubiksRevenge, 1495, 30.7, 1083, 847, 70, 2000
rubymoonstar, 728, 88.6, 3, 21, 0, 24
ruchira, 1779, 29.9, 1093, 1492, 121, 2706
rulochess, 1048, 25.3, 139, 162, 3, 304
RuskiyIvrai, 1187, 39.5, 280, 702, 35, 1017
RussianRoulette, 1842, 33.7, 279, 171, 11, 461
rustysabre, 1019, 72.5, 45, 90, 2, 137
Rutherford, 1326, 28.1, 13458, 12567, 334, 26359
rybokas, 1220, 30.6, 3119, 2702, 136, 5957
ryuxiang, 1965, 55.8, 1064, 539, 74, 1677
ryvar, 1486, 29.2, 711, 570, 33, 1314
Ryzen, 1695, 325.5, 0, 1, 0, 1
sabasaba, 954, 31.3, 177, 221, 9, 407
sabirin, 1347, 40.5, 576, 410, 28, 1014
SacredVision, 1419, 32.1, 5200, 6434, 319, 11953
Sadom, 1259, 52.4, 33, 50, 3, 86
saggitarian, 1327, 30.2, 3116, 3855, 159, 7130
Saidin, 1394, 42.5, 1672, 1166, 106, 2944
sairunyun, 976, 89.8, 14, 40, 2, 56
Sakebomb, 1228, 35.7, 82, 76, 2, 160
Salamon, 1254, 36.0, 5920, 7588, 600, 14108
SalimShaikh, 1132, 71.2, 7, 27, 1, 35
Saltmule, 1285, 37.5, 1198, 752, 78, 2028
samarsh, 1008, 54.1, 24, 28, 1, 53
samuraii, 1828, 31.6, 155, 146, 10, 311
sandunguero, 1358, 45.2, 2895, 3053, 307, 6255
Santoshkswamy, 1200, 27.3, 8251, 15032, 953, 24236
Sanvigian, 1214, 24.6, 1097, 1196, 78, 2371
sarweshs, 1530, 18.0, 6670, 6038, 690, 13398
sathiyan, 1355, 24.8, 2137, 2736, 167, 5040
satyr, 1803, 23.6, 1695, 1157, 148, 3000
saurabhj, 1219, 33.0, 108, 207, 12, 327
saveliev, 1229, 53.6, 1985, 2193, 146, 4324
savis, 1260, 45.3, 1248, 1139, 74, 2461
sazechess, 1389, 31.5, 4495, 5092, 370, 9957
Scareplay, 1820, 27.9, 908, 923, 44, 1875
scarrijo, 763, 131.6, 0, 9, 0, 9
Schachmat, 1233, 26.9, 652, 1026, 67, 1745
schaudhuri, 1501, 45.2, 1410, 617, 195, 2222
scheller, 1648, 29.1, 2955, 3739, 305, 6999
Schtango, 1114, 32.2, 1554, 1516, 70, 3140
Sciolaro, 1779, 55.5, 3214, 2185, 384, 5783
scottmshack, 1126, 40.5, 977, 1076, 84, 2137
scottobrien, 1111, 86.3, 907, 2783, 175, 3865
scullyman, 1172, 28.2, 622, 798, 52, 1472
sczi, 1618, 21.6, 3600, 3174, 364, 7138
sdbob, 1525, 39.7, 106, 51, 5, 162
sdkenned, 1055, 55.0, 494, 1077, 49, 1620
sdockray, 1054, 44.0, 43, 51, 1, 95
seaguard, 956, 57.5, 281, 348, 15, 644
seancain, 1452, 32.2, 6605, 4089, 644, 11338
Seewolfman, 1217, 21.1, 1310, 1653, 109, 3072
segv, 1458, 31.0, 11036, 8723, 987, 20746
seinfan, 1266, 26.9, 637, 391, 29, 1057
sekocajb, 1500, 26.4, 267, 228, 27, 522
selenemre, 1145, 71.2, 8, 24, 0, 32
seleros, 1647, 50.6, 63, 30, 5, 98
selrahc, 1583, 27.4, 10512, 4873, 864, 16249
senselessdiver, 1093, 70.5, 1819, 4024, 69, 5912
seolta, 1576, 25.0, 6896, 4369, 593, 11858
serpantin, 1695, 24.7, 646, 918, 50, 1614
sethlong, 1381, 31.2, 687, 853, 32, 1572
Seward, 1164, 36.3, 1822, 2609, 162, 4593
sexbucket, 1180, 33.3, 245, 272, 23, 540
sfochamp, 1496, 36.0, 13326, 12880, 1050, 27256
Sfrums, 1788, 35.3, 396, 383, 61, 840
SgtPork, 1314, 76.6, 263, 145, 27, 435
shacmat, 1232, 36.6, 1549, 5260, 214, 7023
shajanam, 1246, 58.6, 79, 119, 2, 200
Shakagone, 1114, 44.3, 2535, 1647, 193, 4375
shakinbaconman, 1391, 36.8, 877, 523, 82, 1482
shakmahde, 1483, 43.0, 1395, 944, 90, 2429
shakmatsky, 1664, 39.1, 739, 295, 40, 1074
Shatranzi, 1344, 25.7, 4244, 7058, 444, 11746
shawkash, 1425, 40.3, 301, 525, 32, 858
Sheikhzakir, 1234, 27.3, 199, 468, 0, 667
shinethru, 1661, 23.8, 2592, 4819, 272, 7683
shineyday, 1318, 52.7, 590, 606, 33, 1229
Shmitty, 1480, 26.1, 14499, 9981, 1196, 25676
ShoeshineLenny, 1202, 19.5, 347, 339, 16, 702
shortsands, 724, 39.4, 98, 350, 9, 457
shultzl, 1177, 35.0, 1066, 2174, 138, 3378
ShyamPatil, 1656, 24.5, 9630, 5682, 374, 15686
SideshowJoel, 1309, 40.1, 1763, 1392, 139, 3294
sillysicilian, 1202, 35.8, 1201, 1247, 130, 2578
sinalunga, 951, 40.2, 304, 549, 32, 885
singur, 1821, 25.8, 1427, 2128, 203, 3758
SirAdder, 1394, 48.9, 5468, 5774, 412, 11654
sirblack, 1690, 25.0, 12218, 23759, 999, 36976
Sirenus, 986, 43.8, 510, 854, 35, 1399
Sirpooba, 1166, 29.2, 646, 1093, 93, 1832
SirVLCIV, 1680, 51.4, 29, 29, 0, 58
sixbetbluff, 2059, 42.6, 55, 28, 7, 90
siyeta, 1150, 22.7, 191, 356, 10, 557
skimtnbikekayak, 1342, 23.4, 2840, 3606, 308, 6754
Skippio, 1166, 31.5, 180, 362, 33, 575
sleeperknight, 1404, 23.0, 3529, 5385, 737, 9651
slowburner, 793, 33.8, 450, 859, 29, 1338
SlowDrift, 1149, 27.9, 1490, 1321, 116, 2927
slowgamer, 1410, 35.1, 1375, 1166, 218, 2759
SlumpAttack, 1322, 31.2, 628, 1166, 28, 1822
smaguire, 1073, 59.5, 14, 34, 2, 50
smallpuppy, 1498, 29.9, 9281, 8845, 713, 18839
smarlny, 1301, 22.9, 5973, 7970, 631, 14574
smartpawn, 1550, 31.9, 12458, 8407, 934, 21799
smashingbabey, 890, 33.3, 205, 302, 7, 514
smenke, 1573, 30.3, 3435, 3413, 278, 7126
smokinjimmyv, 1784, 22.6, 5538, 12617, 1328, 19483
smoozer, 1311, 33.6, 6446, 6847, 744, 14037
snaggerss, 965, 31.3, 134, 214, 9, 357
snek, 1448, 30.5, 5086, 4790, 387, 10263
snikolic, 1922, 33.2, 5082, 6458, 755, 12295
snob, 1447, 24.6, 16830, 17650, 965, 35445
snycal, 1489, 28.7, 19393, 25308, 1281, 45982
sodacitynate, 1799, 28.4, 814, 664, 81, 1559
Sodumb, 1949, 26.7, 955, 800, 184, 1939
SolarisTC, 1502, 39.0, 4354, 4038, 506, 8898
SolVita, 1764, 22.7, 8407, 8730, 1000, 18137
somannair, 1455, 25.9, 5085, 8953, 939, 14977
Somokai, 910, 54.8, 37, 205, 2, 244
Sonare, 1412, 23.2, 4126, 6070, 285, 10481
Soubotai, 1367, 29.2, 1193, 1245, 90, 2528
southernjumper, 1042, 31.1, 684, 970, 50, 1704
spalpeen, 1800, 23.6, 12583, 18221, 1326, 32130
spanksyou, 1477, 38.3, 1287, 823, 54, 2164
spatchpatch, 858, 126.4, 2, 17, 0, 19
spazzy, 1374, 56.8, 560, 421, 57, 1038
specks, 1112, 26.1, 3838, 5917, 210, 9965
spectr, 1415, 82.3, 19, 8, 1, 28
SpiritXL, 850, 32.6, 294, 1198, 13, 1505
spirobulldog, 1460, 156.2, 3, 3, 0, 6
splinteredthought, 1471, 27.9, 2653, 3035, 130, 5818
Sprunghuhn, 1568, 34.9, 872, 798, 87, 1757
Squeedle, 1485, 27.3, 1136, 754, 81, 1971
sreeneni, 1654, 23.0, 11548, 4036, 810, 16394
srmsdad, 1137, 33.8, 272, 203, 7, 482
ssez, 1329, 31.3, 680, 1048, 68, 1796
ssprotein, 1651, 22.1, 6466, 8607, 550, 15623
sssmashy, 1126, 25.5, 1047, 1772, 47, 2866
stancovich, 1591, 21.6, 1301, 1209, 148, 2658
StanShaw, 926, 47.6, 32, 82, 2, 116
staticforce, 1044, 58.1, 22, 28, 2, 52
Steady, 1159, 36.8, 4826, 6531, 621, 11978
SteffenSN, 1759, 26.8, 2221, 1203, 262, 3686
stefolder, 1113, 32.1, 2198, 4181, 265, 6644
Stenn, 1385, 29.6, 13692, 12273, 1159, 27124
stephenm, 1495, 35.0, 1510, 2292, 150, 3952
stevenpn, 1261, 29.4, 305, 277, 17, 599
steventlamb, 1440, 27.7, 1371, 1047, 109, 2527
Steveolio, 1636, 29.7, 1847, 2728, 76, 4651
StewartG, 1207, 24.8, 2016, 2140, 151, 4307
sTpny, 1308, 26.5, 6262, 9574, 122, 15958
StratPlan, 1367, 39.5, 6141, 6534, 833, 13508
straycatstrut, 1653, 31.6, 4457, 3311, 260, 8028
stretto, 1293, 30.6, 5586, 6277, 282, 12145
stroms, 1117, 29.8, 850, 1016, 55, 1921
Structuur, 1189, 22.7, 1279, 1896, 33, 3208
stryke, 1803, 39.5, 157, 164, 22, 343
SUBARUMAN, 1354, 23.6, 1497, 2963, 123, 4583
SubzeroDD, 1219, 67.5, 191, 273, 16, 480
sugarlandtx, 1243, 73.2, 1029, 1054, 77, 2160
Sullyman, 1379, 27.2, 341, 633, 51, 1025
sumadartson, 1527, 22.7, 7526, 10682, 767, 18975
sumitanand, 1048, 25.3, 464, 1478, 55, 1997
suneroger, 910, 101.3, 5, 13, 0, 18
sunnymoon, 1049, 39.8, 130, 137, 14, 281
sunodissey, 1295, 32.7, 296, 330, 21, 647
supajut, 1153, 27.4, 1461, 1515, 70, 3046
supersache, 1901, 27.4, 5394, 4185, 414, 9993
SUPPRISE, 1106, 26.4, 1033, 3543, 326, 4902
supradeepa, 1016, 42.7, 88, 163, 10, 261
Surbunny, 1586, 24.0, 1002, 480, 57, 1539
svengali, 1278, 50.9, 819, 856, 77, 1752
Swampuskitty, 1098, 37.8, 309, 542, 15, 866
sweetnighter, 1685, 29.9, 6405, 5863, 851, 13119
Swiftcheck, 1232, 45.3, 873, 1216, 23, 2112
SyrenM, 1351, 29.1, 181, 123, 14, 318
TaccyChan, 1391, 31.4, 8878, 10405, 633, 19916
tacticalcat, 1163, 43.8, 291, 918, 42, 1251
tahuilan, 1338, 35.9, 609, 901, 53, 1563
tallyhoe, 1227, 31.4, 2833, 2294, 150, 5277
Tallyhofox, 1475, 31.1, 2127, 1401, 145, 3673
tamilan, 1127, 33.5, 655, 892, 70, 1617
Tanru, 1381, 38.6, 4736, 3012, 367, 8115
tanytany, 838, 36.2, 58, 174, 1, 233
Tapori, 1397, 26.4, 2730, 4670, 441, 7841
tarekharoun, 1323, 37.3, 7172, 3913, 239, 11324
Tawabweiss, 822, 86.8, 5, 35, 0, 40
tealeafreader, 1129, 33.2, 626, 840, 35, 1501
TeddyBaer, 1774, 23.5, 7399, 6866, 557, 14822
Tedysuyatna, 1158, 28.3, 152, 255, 7, 414
telestar, 1538, 28.9, 3580, 4857, 421, 8858
TemporalGambit, 1773, 26.8, 28196, 10586, 1976, 40758
TEMWA, 1516, 25.4, 1562, 2338, 105, 4005
tennischamp, 1376, 25.6, 258, 327, 37, 622
tentornados, 1342, 30.0, 852, 1352, 18, 2222
terapleutre, 1308, 29.5, 2771, 3140, 348, 6259
terna, 1520, 19.9, 5287, 5897, 590, 11774
thallesdiego, 1056, 91.6, 11, 14, 0, 25
THAVA, 1268, 31.1, 1017, 1896, 145, 3058
TheBartender, 1590, 73.7, 5148, 4999, 372, 10519
thechange, 1928, 58.6, 2780, 1547, 302, 4629
TheChessiah, 1154, 32.1, 762, 1048, 21, 1831
TheDumbDane, 1689, 27.6, 1158, 531, 86, 1775
TheEgoKiller, 1543, 31.1, 1856, 1821, 201, 3878
theerawate, 1396, 28.1, 2705, 1900, 201, 4806
thegathering, 1430, 39.7, 2503, 4323, 165, 6991
thegoldenboy, 903, 43.0, 25, 116, 0, 141
theironsheik, 1477, 31.0, 653, 614, 39, 1306
thekillerchickens, 1850, 27.0, 9222, 3655, 998, 13875
themisk, 1417, 27.7, 8053, 11649, 1706, 21408
thenextstevebaker, 1161, 26.4, 815, 1267, 116, 2198
TheRealFox, 1071, 35.0, 759, 1014, 67, 1840
TheReignOfKindo, 1242, 35.9, 639, 688, 58, 1385
TheResident, 1654, 30.5, 11097, 12546, 1106, 24749
TheRisingPawn, 1807, 54.2, 31, 32, 4, 67
TheseusI, 1876, 40.7, 999, 823, 94, 1916
TheSoulOfChess, 1266, 46.6, 147, 292, 14, 453
Thevdia, 1608, 24.1, 1532, 1169, 101, 2802
TheYoungVeins, 1397, 32.9, 377, 384, 35, 796
thgibbs, 1407, 45.5, 801, 600, 74, 1475
ThomasPace, 1273, 25.7, 300, 553, 16, 869
ThomasR, 1267, 28.2, 3226, 5011, 225, 8462
thomson, 1543, 33.8, 3144, 2821, 386, 6351
Thoras, 1588, 31.4, 2376, 2474, 144, 4994
thorntdc, 1341, 44.2, 829, 399, 46, 1274
THORTHEVIKING, 845, 30.0, 185, 674, 18, 877
THowes, 1084, 65.9, 133, 163, 11, 307
thrajin, 1281, 38.3, 654, 558, 45, 1257
tibulom, 1344, 37.7, 5194, 6777, 363, 12334
tiburcio, 1419, 24.4, 11452, 11305, 950, 23707
TIGERWOODS, 1642, 33.1, 1597, 586, 86, 2269
TigranJ, 1378, 36.5, 885, 251, 43, 1179
Tigrann, 1631, 34.5, 11151, 8942, 1127, 21220
tigreton, 1344, 23.0, 3121, 6273, 478, 9872
Timbx, 1477, 45.5, 80, 66, 5, 151
timetowin, 1229, 19.3, 1188, 3063, 153, 4404
timf, 1491, 25.2, 6321, 7429, 580, 14330
Timmesen, 1386, 29.6, 1599, 1854, 187, 3640
Timothy, 1278, 22.4, 23777, 29408, 3300, 56485
timothyinportland, 1045, 52.5, 22, 33, 4, 59
tipko, 1206, 24.5, 552, 800, 98, 1450
tipsycoma, 1414, 205.0, 1, 3, 0, 4
tiptongrange, 1292, 57.1, 163, 140, 9, 312
TIZOC, 1422, 20.0, 3855, 4211, 487, 8553
tjops, 1315, 35.1, 134, 108, 1, 243
tjordanchat, 1187, 31.2, 568, 781, 46, 1395
TJPOT, 1044, 38.0, 2032, 2222, 80, 4334
tkheovmians, 1366, 27.2, 964, 900, 51, 1915
tmcnic, 1095, 40.2, 99, 113, 4, 216
tobydammett, 1551, 26.7, 5535, 8440, 447, 14422
Toddniven, 1478, 44.1, 4819, 3842, 366, 9027
todieisgain, 1552, 24.5, 1970, 2408, 268, 4646
toe, 1404, 30.0, 12313, 11941, 1275, 25529
TOLAG, 1256, 32.8, 1492, 2786, 142, 4420
toledov, 1034, 50.0, 188, 154, 19, 361
tomerzarfaty, 1010, 33.2, 1719, 3296, 120, 5135
Tommm, 1343, 30.5, 743, 507, 58, 1308
tompet, 1272, 32.3, 3022, 2576, 295, 5893
tomwes, 1095, 50.9, 978, 1624, 89, 2691
toneRock, 926, 42.1, 32, 89, 0, 121
TongueTied, 883, 34.6, 80, 167, 5, 252
tonni, 1607, 27.5, 17149, 13116, 2030, 32295
tonoticeran, 1706, 316.0, 1, 1, 0, 2
tonyz, 1308, 33.5, 11157, 11873, 638, 23668
toodlebug, 779, 94.7, 43, 151, 12, 206
torombolo, 884, 67.7, 25, 104, 3, 132
tospringer, 1767, 20.1, 13264, 13410, 1453, 28127
TouringMachine, 1550, 30.0, 1391, 1405, 152, 2948
Toyta, 1731, 24.4, 3773, 2361, 287, 6421
tozz, 1638, 32.2, 2599, 2083, 306, 4988
TPGYRENE, 1542, 29.7, 10307, 6423, 736, 17466
tplachkich, 1449, 31.0, 9089, 1400, 288, 10777
travmelb, 838, 40.9, 271, 417, 12, 700
trb, 1347, 36.6, 2134, 1667, 143, 3944
TreeFrog, 1401, 43.5, 93, 42, 8, 143
TriniCHESSplayr, 1541, 36.3, 771, 926, 38, 1735
trmii, 1050, 37.7, 1483, 1961, 92, 3536
TrouDeBozouls, 1533, 28.6, 371, 477, 42, 890
TroyKa, 1197, 31.9, 2151, 720, 110, 2981
Truckdriver, 1509, 22.2, 15727, 9036, 1109, 25872
truemejicano, 1153, 119.3, 3, 9, 0, 12
trynottolaugh, 987, 34.4, 138, 185, 11, 334
tschup, 868, 26.9, 2628, 6629, 318, 9575
tseltzer, 1654, 31.1, 3695, 3237, 592, 7524
ttasso, 1157, 26.8, 430, 437, 35, 902
ttsuchi, 1093, 67.9, 414, 461, 24, 899
tullamoore, 944, 32.2, 299, 808, 23, 1130
tunante, 694, 75.0, 3, 30, 0, 33
tupapa, 1468, 31.4, 7384, 4553, 508, 12445
Turamon, 1386, 36.9, 3454, 2401, 314, 6169
turkeyboy, 1575, 29.1, 10843, 7692, 650, 19185
tweekgeeks, 1360, 29.7, 364, 1388, 31, 1783
TwentiethMaine, 1374, 27.2, 1916, 3078, 259, 5253
TWG, 1534, 24.4, 10182, 8616, 890, 19688
TwitchBlade, 820, 40.7, 38, 117, 2, 157
twoods, 983, 39.8, 745, 857, 49, 1651
txbeda, 1727, 25.1, 5498, 6260, 483, 12241
Tycew, 1131, 38.7, 1109, 1342, 108, 2559
Tyrantt, 1290, 54.0, 788, 781, 58, 1627
TyroLoco, 1260, 27.0, 1256, 1601, 106, 2963
tzarchess, 1610, 19.6, 1990, 4330, 306, 6626
Uddo, 1327, 27.4, 1836, 2021, 123, 3980
Udon, 1378, 36.2, 2263, 2965, 325, 5553
udovych, 1394, 26.7, 4994, 8081, 657, 13732
UENBGC, 1405, 25.2, 4138, 4700, 548, 9386
UGAFootball, 1456, 31.0, 9270, 8878, 1175, 19323
Uirapuru, 1703, 19.9, 50012, 30930, 3183, 84125
uncleZiba, 1370, 46.2, 2614, 3086, 221, 5921
underestimted, 964, 41.1, 268, 502, 8, 778
unholy, 1362, 48.3, 3897, 3762, 434, 8093
unica, 1400, 55.2, 57, 38, 2, 97
uniqli, 1403, 36.1, 1491, 922, 126, 2539
unnamed, 1245, 35.6, 4951, 5975, 577, 11503
UNPREDICTABLE, 1263, 23.1, 17737, 21505, 1745, 40987
unrandomsam, 1322, 29.7, 4101, 5625, 410, 10136
UnratedOne, 1403, 29.7, 1676, 1954, 93, 3723
urgoodbutimbetter, 1393, 25.0, 1327, 1423, 58, 2808
urineluck, 1502, 48.7, 546, 223, 23, 792
usarob, 1499, 34.4, 1995, 1772, 158, 3925
usclambox, 1310, 40.2, 1404, 1159, 137, 2700
usukvc, 1529, 30.4, 1385, 1029, 126, 2540
USURP, 1191, 25.0, 468, 614, 42, 1124
uthman, 1397, 40.4, 780, 1349, 88, 2217
vadnn, 1524, 27.5, 4690, 3592, 382, 8664
Vagulo, 971, 34.3, 95, 150, 10, 255
valenzuelaalvaro, 1370, 35.6, 403, 386, 31, 820
valeri, 1364, 32.2, 3669, 4428, 343, 8440
ValidusPotens, 1716, 28.5, 6910, 5553, 560, 13023
valuenic, 1565, 30.2, 5444, 3749, 502, 9695
vandrr, 1752, 67.0, 27, 14, 1, 42
vangna, 968, 42.6, 39, 69, 2, 110
varggrav, 1838, 33.5, 98, 52, 6, 156
vars, 1369, 28.0, 4520, 4204, 417, 9141
Vasallo, 1519, 22.9, 2095, 2005, 141, 4241
VBC, 1289, 28.4, 14258, 8405, 513, 23176
Vedmedik, 1529, 22.1, 4867, 3037, 376, 8280
VeganModel, 1977, 54.0, 205, 182, 21, 408
veigas, 1121, 24.8, 2120, 4106, 173, 6399
Velocityzone, 1232, 30.4, 811, 771, 61, 1643
vendemiatrix, 1619, 29.8, 26612, 10172, 1543, 38327
venue, 1489, 26.4, 3413, 4322, 565, 8300
Veramacor, 1424, 29.4, 8344, 4597, 427, 13368
Verretnikov, 1929, 127.5, 10, 4, 0, 14
Vesraj, 1241, 38.8, 66, 107, 4, 177
vicentiko, 1567, 22.0, 3035, 2457, 227, 5719
vicentiu, 1300, 19.6, 2726, 3284, 125, 6135
Vichedragon, 1653, 44.4, 585, 956, 82, 1623
vicoyot, 1317, 30.3, 308, 285, 29, 622
vixpow, 1368, 28.0, 127, 117, 6, 250
vjd, 1734, 28.9, 10128, 10390, 1962, 22480
vjgreen, 1354, 24.5, 3590, 4871, 175, 8636
VladaAmater, 1458, 25.3, 4579, 6697, 874, 12150
VladimirAbakan, 1592, 18.6, 12234, 14088, 1608, 27930
VMCHO, 994, 35.8, 394, 1098, 21, 1513
vmqg, 1365, 43.8, 128, 210, 23, 361
VojFromMars, 1809, 29.5, 1343, 814, 161, 2318
volandd, 1373, 29.1, 5521, 6909, 941, 13371
volkenla, 992, 36.4, 834, 817, 19, 1670
Volks, 1413, 22.4, 12527, 10483, 657, 23667
Vomes, 1668, 29.6, 2745, 2174, 426, 5345
Vorcegy, 1524, 27.8, 1201, 918, 122, 2241
VRL, 1381, 23.5, 4707, 5374, 406, 10487
vsqqq, 986, 82.9, 177, 385, 20, 582
vuhb, 1593, 44.0, 4610, 6051, 732, 11393
vxj, 1354, 42.5, 5423, 7548, 723, 13694
wackytackypatzer, 1499, 30.3, 5440, 2988, 315, 8743
wageslave, 1492, 38.6, 2023, 1294, 148, 3465
wallius, 825, 36.9, 61, 91, 5, 157
WanderingSailor, 1365, 32.9, 89, 62, 7, 158
warfarer, 1597, 25.9, 2075, 1172, 162, 3409
Wayner, 1374, 33.3, 4237, 3796, 317, 8350
wayuat, 1300, 29.7, 8077, 7782, 629, 16488
wclipson, 1355, 43.4, 48, 53, 3, 104
wdywdpusher, 1229, 18.7, 8470, 7946, 660, 17076
weashwin, 1129, 31.1, 910, 1382, 33, 2325
Wedberg, 1530, 30.6, 8866, 7327, 1231, 17424
WelleErdball, 1597, 60.6, 144, 65, 8, 217
WhackaNum, 1361, 22.0, 835, 799, 52, 1686
whiteguardian, 1550, 29.3, 14356, 9361, 848, 24565
whitejediknight, 1219, 37.6, 662, 1070, 26, 1758
WickedMad, 893, 49.1, 19, 71, 2, 92
wildcathughes, 1164, 56.0, 484, 494, 35, 1013
wildcrop, 1160, 25.5, 1835, 2263, 116, 4214
WilliamManahan, 1296, 24.3, 5434, 4375, 586, 10395
williewilliams, 946, 33.1, 510, 830, 72, 1412
Willike, 1035, 68.7, 226, 277, 11, 514
winpower, 1450, 50.1, 294, 317, 58, 669
WinterChess, 1113, 37.4, 482, 659, 98, 1239
wisechess, 1401, 25.1, 188, 162, 17, 367
Wiseguy, 1303, 31.8, 5411, 5720, 254, 11385
wlljmsgllghr, 1037, 49.8, 238, 255, 8, 501
WobblyMan, 1427, 25.1, 2461, 1855, 177, 4493
woodbeast, 1546, 23.1, 12805, 11943, 1237, 25985
woofy, 1328, 27.3, 540, 597, 35, 1172
worrywart, 1356, 27.5, 152, 156, 25, 333
wotjrdla, 827, 148.0, 0, 6, 0, 6
wowboy, 1411, 18.6, 1373, 1269, 67, 2709
wqre, 1482, 24.9, 7172, 3795, 336, 11303
wrtlbrmft, 1726, 30.6, 1435, 1631, 206, 3272
wrzgut, 1401, 22.0, 12832, 18641, 935, 32408
wshell, 1617, 27.9, 2218, 1957, 401, 4576
wthfk, 1198, 39.7, 766, 1618, 48, 2432
wundtsapawnintime, 1310, 71.0, 787, 597, 58, 1442
wutangwong, 1440, 23.3, 640, 682, 60, 1382
wwwZHILINSru, 952, 33.1, 99, 169, 13, 281
wyattb, 1400, 52.6, 602, 789, 46, 1437
wysowa, 1406, 22.0, 5415, 5299, 309, 11023
XaviaStar, 803, 36.6, 611, 1475, 37, 2123
XavierBriche, 1406, 27.9, 7641, 7620, 456, 15717
Xbroom, 1572, 29.2, 6195, 6537, 262, 12994
xcaliberpeng, 1351, 26.1, 1502, 2712, 135, 4349
xcsaber, 1629, 27.6, 1477, 743, 116, 2336
xebos, 1347, 52.9, 639, 453, 27, 1119
xeroxorex, 1905, 20.8, 521, 586, 67, 1174
XiangHe, 1193, 33.2, 805, 1555, 80, 2440
xjphil, 1399, 34.0, 376, 520, 17, 913
XJuvenalX, 1444, 27.1, 11630, 4477, 448, 16555
xorque, 1291, 29.2, 603, 561, 43, 1207
xosepineda, 1080, 31.1, 170, 109, 6, 285
xqsme, 1217, 28.5, 2116, 7632, 308, 10056
XTERMINATER, 1364, 32.1, 2107, 1481, 127, 3715
xxfred, 1292, 28.4, 294, 147, 11, 452
xxice, 1543, 29.5, 536, 685, 64, 1285
xxinoxx, 1263, 38.6, 1580, 2416, 134, 4130
XXXXTOOLXXXX, 1955, 26.5, 755, 389, 43, 1187
Yahowa, 1690, 22.6, 1202, 1228, 104, 2534
yahsan, 1368, 33.7, 2160, 1807, 111, 4078
yakovgreen, 1519, 33.5, 789, 1132, 150, 2071
YangJan, 1385, 39.1, 3998, 4610, 433, 9041
yarmoe, 1686, 27.8, 12553, 5863, 541, 18957
yaronusa, 1203, 72.7, 1072, 1411, 85, 2568
yassoutiger, 1747, 19.5, 7332, 10439, 881, 18652
ycliu, 1445, 37.7, 657, 429, 35, 1121
yddy, 1434, 31.5, 4234, 4510, 342, 9086
yfan, 1646, 24.0, 14897, 18435, 1484, 34816
ykumary, 1371, 33.0, 663, 592, 32, 1287
Ymar, 1833, 20.6, 15647, 20289, 1244, 37180
Yombertro, 1626, 31.8, 888, 529, 39, 1456
Yoshimori, 1746, 30.8, 7501, 5074, 1011, 13586
yourmaster, 982, 26.7, 622, 1364, 44, 2030
YouYue, 993, 32.9, 690, 709, 21, 1420
yrrej, 1964, 18.2, 10318, 4399, 759, 15476
ysnake, 1313, 29.9, 1486, 2249, 140, 3875
ytty, 1441, 26.2, 2869, 1649, 101, 4619
yummycrepe, 1583, 26.4, 11288, 6219, 643, 18150
zaclefou, 1518, 29.2, 7684, 7285, 593, 15562
zadox, 1141, 25.6, 6949, 6375, 429, 13753
Zaichense, 1119, 37.2, 1125, 1880, 134, 3139
Zalmiester, 1353, 53.2, 1091, 516, 60, 1667
Zanskar, 1713, 24.3, 6119, 6393, 771, 13283
ZanyPlebeian, 1060, 44.2, 76, 146, 4, 226
zarand, 1133, 24.3, 901, 1194, 79, 2174
zarubbabel, 1293, 39.6, 151, 128, 6, 285
zbrad, 1722, 39.0, 11353, 11903, 1062, 24318
ZECAURUBU, 1536, 28.8, 3128, 3828, 282, 7238
Zeddyzeddy, 1345, 26.0, 179, 148, 12, 339
zedikiah, 1402, 19.5, 1579, 2319, 135, 4033
zedward, 1552, 24.7, 9253, 8344, 1072, 18669
ZenFAUST, 974, 296.4, 0, 2, 0, 2
Zenlee, 998, 40.3, 123, 217, 5, 345
ZeroTheHero, 1434, 39.4, 998, 960, 77, 2035
zeta, 1526, 33.7, 9301, 5860, 711, 15872
zhaulsan, 1020, 31.3, 299, 548, 33, 880
zigamo, 1421, 29.5, 1309, 2522, 78, 3909
zigzaweak, 1554, 26.4, 4714, 6135, 391, 11240
Zilvio, 1459, 34.7, 15191, 12001, 1059, 28251
zmagic, 1158, 28.3, 5170, 7852, 768, 13790
zmike, 1556, 28.8, 8708, 7274, 753, 16735
zobrathecobra, 1149, 23.8, 3936, 7733, 328, 11997
Zoobie, 1323, 35.4, 4154, 4959, 281, 9394
Zoomy, 1566, 23.4, 21139, 24818, 2024, 47981
zoranb, 1796, 31.1, 5534, 7104, 544, 13182
zorc, 1685, 26.3, 1926, 957, 50, 2933
Zornhau, 1046, 34.5, 692, 1152, 83, 1927
zosiliski, 1025, 42.4, 112, 222, 11, 345
zsram, 1217, 35.0, 773, 844, 66, 1683
