Handle, BlitzRating, BlitzRD, BlitzWon, BlitzLost, BlitzDrawn, BlitzTotal
aaas, 1400, 257.4, 1, 2, 0, 3
Aaashhh, 1150, 52.5, 104, 211, 8, 323
aacash, 1516, 26.9, 1982, 1312, 111, 3405
aadithya, 801, 116.8, 28, 198, 8, 234
aadroem, 1565, 51.7, 3491, 2702, 510, 6703
Aakashozha, 1073, 93.2, 7, 82, 2, 91
Aakiba, 1939, 82.3, 657, 403, 89, 1149
aalmeida, 1396, 42.1, 3283, 1890, 248, 5421
aam, 1788, 32.8, 325, 436, 39, 800
Aamaad, 1405, 30.9, 378, 240, 21, 639
aamm, 1305, 67.7, 581, 149, 31, 761
aandis, 968, 95.7, 29, 78, 2, 109
AAndreevBUL, 944, 122.8, 3, 8, 0, 11
aardy, 1554, 76.2, 2916, 3034, 622, 6572
aarobber, 1193, 113.3, 546, 725, 42, 1313
aaronCSB, 1537, 40.8, 1704, 1519, 96, 3319
aaronn, 1338, 22.3, 9749, 11446, 859, 22054
Aaronthechessman, 1249, 118.3, 13, 36, 0, 49
AartS, 1065, 190.3, 474, 698, 27, 1199
aasdfasdfg, 1556, 62.5, 94, 73, 7, 174
aatyler, 918, 80.1, 71, 100, 5, 176
aazzbyy, 1412, 79.7, 556, 407, 27, 990
ABAKUS, 2077, 28.7, 12921, 13035, 2888, 28844
ABarlow, 998, 148.5, 2, 12, 0, 14
Abatwa, 1030, 25.7, 1215, 2044, 59, 3318
AbbaMichael, 1247, 138.5, 33, 37, 5, 75
abcdfgh, 1555, 33.8, 8886, 12264, 1725, 22875
ABCyoulater, 1331, 70.7, 1264, 849, 45, 2158
AbdiAshirta, 1207, 44.1, 4109, 2217, 165, 6491
abdulsalim, 1340, 74.2, 170, 258, 9, 437
abednego, 1479, 25.2, 11059, 14937, 2041, 28037
abekunin, 1515, 46.1, 5836, 4275, 441, 10552
abelflores, 1189, 92.0, 30, 106, 2, 138
abemarcusd, 1190, 44.2, 644, 652, 75, 1371
Aberathy, 1007, 97.8, 145, 305, 19, 469
AbhijitMukherjee, 1433, 82.5, 86, 93, 13, 192
AbhijitMukherji, 1467, 42.9, 133, 115, 16, 264
abhishekNeo, 1195, 79.1, 128, 133, 15, 276
AbhishekOjha, 1076, 46.1, 103, 98, 6, 207
abhishekparab, 1475, 65.8, 5314, 4202, 407, 9923
abhisheks, 965, 208.2, 0, 7, 0, 7
abhyudaycooldude, 1168, 125.7, 570, 769, 71, 1410
abigsteak, 1039, 148.2, 5, 15, 0, 20
abile, 1697, 21.7, 14897, 15593, 1411, 31901
ablackie, 1250, 33.3, 1639, 1631, 113, 3383
ablaisdell, 1036, 70.6, 355, 439, 29, 823
Ablechess, 1231, 36.5, 614, 587, 19, 1220
ableton, 1086, 86.7, 41, 40, 2, 83
AbouTheCat, 1340, 89.3, 955, 1241, 208, 2404
AbrahamA, 1741, 43.5, 1961, 1017, 277, 3255
abrahams, 1209, 138.9, 14, 31, 2, 47
abrik, 1599, 33.6, 9959, 6600, 464, 17023
abris, 1465, 33.7, 1078, 1007, 136, 2221
abrivado, 1186, 31.6, 4062, 4328, 307, 8697
ABSBEGINNER, 1143, 29.9, 6854, 7869, 933, 15656
ABSBrakes, 1814, 125.9, 153, 123, 36, 312
abtahi, 1068, 107.9, 7, 17, 0, 24
abudum, 1016, 164.4, 10, 25, 0, 35
ABUFALIA, 1855, 24.9, 460, 485, 58, 1003
Abusio, 1044, 116.2, 686, 1352, 115, 2153
abutre, 1026, 30.4, 507, 533, 15, 1055
AbuTreika, 1005, 192.2, 5, 9, 0, 14
accolade, 853, 87.9, 5, 25, 0, 30
AceBonaventura, 2066, 28.4, 1707, 1082, 222, 3011
aceconquer, 1119, 103.2, 970, 1349, 103, 2422
acerbic, 1551, 29.3, 5756, 4049, 425, 10230
Acerook, 1791, 109.3, 196, 255, 21, 472
AcesFullofKings, 1220, 35.3, 1570, 1244, 148, 2962
Achimedes, 1108, 43.0, 5478, 5969, 259, 11706
achmatova, 1650, 133.6, 127, 139, 8, 274
Acholin, 1369, 105.3, 381, 423, 20, 824
Achsah, 1057, 136.8, 11, 28, 0, 39
Achse, 1322, 123.0, 307, 566, 28, 901
achtpuntzes, 1131, 31.3, 2636, 1560, 71, 4267
Acidicaxe, 826, 155.0, 2, 10, 0, 12
Acilegn, 933, 128.6, 14, 26, 0, 40
acimutal, 1461, 65.2, 476, 401, 25, 902
acmad, 1246, 82.8, 164, 348, 12, 524
acormack, 1511, 33.2, 4505, 4151, 391, 9047
acorte, 1187, 156.7, 46, 135, 8, 189
Acropora, 1353, 88.1, 3143, 2587, 162, 5892
actingstudentguy, 1591, 110.0, 1275, 617, 31, 1923
actionbunny, 1099, 101.7, 9, 12, 0, 21
acuarioperu, 876, 92.9, 38, 52, 3, 93
acuriel, 1177, 78.1, 2965, 3554, 183, 6702
acwizard, 1172, 25.7, 5955, 7369, 758, 14082
adal, 1419, 54.4, 4737, 5718, 797, 11252
adamex, 1211, 59.3, 33, 31, 1, 65
adamickgf, 1370, 91.5, 1482, 1779, 134, 3395
adammeier, 1193, 92.0, 26, 12, 3, 41
adamponting, 1463, 37.0, 1468, 871, 154, 2493
adamriese, 1111, 56.7, 2556, 3716, 234, 6506
AdamRou, 1222, 32.5, 883, 653, 53, 1589
ADAMSHABANA, 982, 246.2, 0, 3, 0, 3
adamslakers, 1024, 91.4, 907, 1454, 102, 2463
adamviva, 1412, 32.2, 2930, 3442, 194, 6566
adarknight, 1488, 110.8, 3330, 4396, 153, 7879
adarrain, 1246, 60.3, 688, 702, 65, 1455
adder, 1458, 27.3, 16411, 15841, 2252, 34504
addictinsane, 1547, 33.7, 6832, 4789, 319, 11940
adelaty, 862, 66.8, 9, 70, 1, 80
adelelzenyyy, 1489, 61.7, 193, 393, 27, 613
AdemarNeto, 1886, 58.9, 2747, 1709, 396, 4852
AdemptioSomnium, 1310, 74.7, 5435, 5482, 326, 11243
Adhi, 748, 117.8, 24, 44, 0, 68
adingod, 1580, 31.4, 4660, 5524, 324, 10508
AdisFKN, 1363, 52.0, 53, 61, 5, 119
aditikalpesh, 1034, 78.4, 35, 183, 0, 218
aDiTyAmIsHrA, 1028, 58.9, 63, 97, 7, 167
ADITYAREDDY, 1006, 35.3, 81, 192, 16, 289
adix, 753, 95.9, 125, 407, 24, 556
adjoube, 1222, 290.7, 0, 6, 0, 6
adlerSK, 2088, 38.4, 5238, 3914, 731, 9883
Adliya, 1443, 100.0, 162, 154, 16, 332
Admirn, 828, 115.8, 100, 496, 5, 601
adnad, 1175, 42.4, 2003, 3214, 169, 5386
adned, 1086, 131.7, 51, 121, 4, 176
Adorg, 1359, 48.7, 3246, 3231, 306, 6783
adracmante, 1028, 65.7, 1405, 1335, 71, 2811
AdrianJames, 1231, 53.7, 1266, 1219, 72, 2557
Adrianlaughs, 1402, 114.9, 107, 129, 10, 246
Adrianzolkos, 1694, 43.7, 934, 402, 57, 1393
adritouch, 1876, 22.3, 356, 142, 28, 526
adrotrico, 1621, 38.4, 3192, 1877, 187, 5256
adv, 1711, 59.1, 3486, 2807, 303, 6596
Advantage, 1821, 61.7, 109, 141, 11, 261
adwaith, 1321, 85.6, 365, 544, 40, 949
AEarete, 1308, 115.5, 310, 226, 15, 551
aegisword, 1346, 60.9, 3012, 2342, 148, 5502
Aekolov, 1702, 24.3, 2742, 3781, 542, 7065
aemramos, 1172, 55.5, 743, 975, 45, 1763
aep, 1875, 39.3, 6652, 2058, 375, 9085
Aeppler, 1341, 29.1, 5199, 5003, 584, 10786
Aerandir, 1114, 49.0, 344, 471, 30, 845
Aeriose, 1206, 40.5, 1390, 2108, 113, 3611
aerohugo, 1079, 194.3, 1, 4, 0, 5
aeroporos, 1693, 204.9, 1, 2, 0, 3
aesbee, 1540, 39.7, 1143, 763, 91, 1997
AFalcon, 1162, 52.9, 4219, 6592, 349, 11160
AFCERGY, 1539, 17.7, 14187, 9999, 1934, 26120
afeemomo, 1299, 23.6, 675, 1196, 52, 1923
afegasta, 2036, 113.6, 1080, 948, 156, 2184
affinor, 1223, 109.7, 57, 53, 1, 111
afinkler, 1614, 144.7, 31, 13, 1, 45
AFishInSea, 1813, 93.4, 3435, 3401, 588, 7424
AflacDuck, 2013, 44.7, 1867, 1337, 209, 3413
africanviper, 1336, 69.6, 26, 25, 1, 52
agashish, 1529, 48.4, 4361, 5143, 152, 9656
agatha, 1175, 116.6, 1073, 890, 98, 2061
agavefish, 1537, 22.2, 1786, 2142, 246, 4174
Agazo, 1329, 48.4, 32, 37, 4, 73
agelessdreams, 1735, 102.9, 376, 373, 53, 802
agelos, 1527, 31.9, 656, 400, 34, 1090
agentsofchan, 1681, 59.2, 699, 515, 37, 1251
aggersbot, 1766, 167.8, 1548, 1379, 173, 3100
Aggresivation, 1100, 54.5, 112, 169, 6, 287
agiantpanda, 1029, 112.2, 79, 124, 4, 207
agios, 1462, 42.7, 4229, 4779, 439, 9447
agissler, 1419, 32.5, 5983, 5878, 383, 12244
agjcmlsa, 1408, 29.6, 1204, 1438, 130, 2772
agkazama, 1310, 72.1, 2924, 2156, 161, 5241
agnusMJ, 1266, 254.0, 25, 23, 3, 51
agraw, 1274, 80.6, 41, 27, 1, 69
agression, 870, 133.6, 72, 73, 4, 149
Agriculteur, 1257, 54.5, 317, 355, 16, 688
agrimil, 1370, 15.1, 4139, 9546, 426, 14111
AGtrader, 1868, 24.5, 824, 793, 73, 1690
AGuerra, 1585, 86.7, 30, 52, 4, 86
aguinaldoeric, 1300, 42.8, 148, 228, 6, 382
agusmw, 1283, 81.4, 477, 386, 23, 886
AgustinVictor, 1356, 117.5, 710, 771, 58, 1539
Agweyre, 1801, 90.4, 838, 1044, 99, 1981
ahattar, 1229, 24.0, 8217, 7946, 527, 16690
ahdtjs, 1305, 46.4, 4710, 4182, 96, 8988
Ahktavius, 1097, 68.4, 224, 385, 14, 623
AhmedELdengawy, 1541, 108.5, 20, 20, 3, 43
AhmedFayz, 1489, 17.8, 5223, 5910, 398, 11531
AhNeow, 1256, 25.9, 7472, 14961, 560, 22993
AHnig, 1884, 218.8, 70, 58, 6, 134
ahorse, 1265, 37.1, 2804, 2421, 190, 5415
ahphong, 1576, 31.6, 3577, 1626, 130, 5333
ahrelep, 1324, 48.5, 162, 149, 14, 325
aidalin, 1153, 134.6, 43, 30, 6, 79
Aidanik, 1219, 77.5, 81, 99, 7, 187
Aighearach, 1481, 53.6, 1186, 598, 76, 1860
ailesbury, 1527, 35.2, 1779, 1798, 132, 3709
Aiman, 1582, 36.2, 11222, 7833, 803, 19858
ainong, 998, 60.2, 128, 352, 10, 490
aintnobalogne, 1056, 67.1, 1059, 1235, 55, 2349
airbender, 1691, 32.4, 2207, 2103, 182, 4492
airbornepoet, 979, 35.1, 60, 109, 5, 174
aire, 1537, 37.8, 7843, 9688, 1624, 19155
airstrike, 1789, 33.0, 5895, 5217, 529, 11641
aisyah, 1329, 147.5, 9, 6, 0, 15
aizeder, 968, 45.9, 442, 715, 20, 1177
Aizenmyoo, 1675, 36.5, 498, 198, 27, 723
AJAddison, 1072, 68.6, 3214, 4555, 439, 8208
ajatusir, 1213, 186.9, 1, 15, 0, 16
ajaytripathi, 874, 56.0, 100, 576, 3, 679
ajcchess, 1216, 90.6, 543, 429, 37, 1009
ajedor, 1718, 39.6, 2644, 3994, 348, 6986
Ajedreitor, 1379, 22.9, 1315, 1250, 137, 2702
ajgg, 1552, 55.5, 477, 264, 18, 759
Ajido, 2033, 92.8, 95, 33, 11, 139
AJIT, 1579, 21.9, 6135, 6023, 423, 12581
ajkezier, 1132, 28.5, 3113, 3552, 401, 7066
ajlo, 1267, 30.0, 5125, 4460, 460, 10045
ajmaradict, 1523, 34.3, 706, 427, 16, 1149
akabel, 1154, 48.2, 1799, 2580, 240, 4619
akalamkam, 1673, 25.8, 1391, 1479, 116, 2986
Akamaru, 1451, 47.4, 651, 589, 66, 1306
akapro, 1198, 256.0, 1, 3, 0, 4
AkaRengaWareHouse, 1587, 46.2, 2597, 2728, 247, 5572
Akarubi, 1336, 58.1, 165, 218, 14, 397
AkbarDeeN, 917, 50.9, 461, 526, 24, 1011
akde, 1678, 77.5, 472, 765, 93, 1330
AKFan, 1545, 42.0, 407, 329, 43, 779
AKIKO, 1459, 25.2, 778, 549, 43, 1370
akonspb, 1382, 34.0, 650, 759, 67, 1476
akots, 1849, 25.9, 7350, 8052, 1315, 16717
akramer, 749, 122.3, 3, 18, 0, 21
Akrapovics, 2003, 203.3, 4, 0, 0, 4
aksakal, 1235, 92.6, 17, 41, 5, 63
aksol, 1096, 69.3, 407, 545, 44, 996
akuakuka, 1156, 80.1, 811, 1243, 47, 2101
Akujit, 1357, 34.9, 5456, 5134, 413, 11003
akumba, 1434, 45.8, 1912, 3083, 124, 5119
akurmus, 1398, 43.2, 1089, 962, 48, 2099
Aladinone, 1589, 88.9, 1815, 2658, 216, 4689
alafuzos, 1892, 33.9, 2066, 1614, 250, 3930
Alahambra, 2014, 51.7, 1703, 1386, 229, 3318
alaly, 1376, 50.5, 6401, 6286, 514, 13201
AlanBes, 1540, 35.3, 6203, 5053, 624, 11880
alang, 1381, 26.3, 5246, 7384, 370, 13000
AlanJBear, 1252, 32.3, 613, 449, 17, 1079
alankur, 794, 145.6, 1, 7, 0, 8
AlanPeter, 1295, 31.9, 5360, 3153, 288, 8801
alansilb, 1431, 32.1, 7963, 8281, 526, 16770
Alaperinola, 1317, 49.3, 2117, 2779, 163, 5059
Alatif, 1100, 48.7, 296, 309, 19, 624
Albakshakasparov, 798, 92.2, 9, 129, 0, 138
albaregia, 1512, 79.8, 4973, 3291, 451, 8715
alberecht, 1183, 35.1, 3015, 2999, 247, 6261
albertje, 1789, 315.1, 1, 0, 0, 1
albertokeizer, 1218, 35.4, 99, 99, 10, 208
albertpinto, 1615, 50.5, 4155, 5630, 677, 10462
albertraines, 1303, 49.0, 318, 329, 13, 660
AlBig, 1882, 26.0, 15512, 12932, 1229, 29673
albinbinoo, 1465, 78.5, 90, 66, 2, 158
albrerttgt, 1455, 83.1, 6501, 7637, 223, 14361
albyelv, 1600, 125.5, 1888, 1837, 230, 3955
Albyrdee, 1554, 26.9, 3120, 1764, 234, 5118
Alcalientre, 1047, 51.9, 269, 559, 11, 839
Alcantrix, 1589, 39.2, 760, 370, 50, 1180
alcecla, 1212, 50.6, 481, 602, 11, 1094
aldac, 1402, 33.0, 6392, 3411, 274, 10077
aldair, 1692, 37.8, 6957, 5947, 692, 13596
ALDERIEX, 1452, 59.3, 2789, 4357, 481, 7627
Aldol, 1135, 72.9, 185, 167, 26, 378
aldrich, 1357, 90.6, 22, 29, 3, 54
Aldur, 1356, 93.9, 3472, 2297, 267, 6036
AlecCharles, 923, 119.3, 42, 262, 1, 305
Alechiel, 1719, 97.3, 997, 1592, 96, 2685
alechinez, 1117, 33.8, 1251, 863, 66, 2180
alechinfanous, 1505, 57.4, 80, 72, 15, 167
aleco, 1170, 37.6, 3192, 6131, 285, 9608
Alecs, 1808, 29.0, 8595, 10184, 1009, 19788
Alectryon, 1455, 40.8, 993, 791, 83, 1867
alefff, 1174, 30.3, 1133, 1032, 43, 2208
Alejandreuta, 1569, 35.1, 1564, 1636, 99, 3299
AlejandroM, 1208, 34.2, 2296, 2260, 151, 4707
AlejoNP, 1684, 27.6, 6649, 5399, 638, 12686
alekhinecapablanc, 1575, 41.9, 1601, 2552, 172, 4325
AlekhineDeepSix, 1319, 26.1, 422, 963, 25, 1410
AlekseySaushkin, 1202, 35.5, 337, 409, 54, 800
alenabab, 1257, 25.7, 4192, 4845, 340, 9377
alepet, 1030, 28.6, 427, 1184, 45, 1656
Aleric, 1540, 67.2, 3900, 3215, 388, 7503
aleshakkk, 1472, 22.6, 11103, 21335, 1619, 34057
Alexab, 1963, 30.2, 808, 290, 132, 1230
Alexach, 675, 124.5, 9, 89, 2, 100
AlexanderG, 1413, 32.0, 4801, 5307, 492, 10600
AlexanderPavluk, 1536, 87.5, 19, 11, 2, 32
AlexanderQ, 1057, 43.2, 410, 708, 17, 1135
AlexandraThess, 1629, 42.2, 705, 611, 77, 1393
alexanka, 1136, 88.6, 287, 287, 7, 581
AlexBaban, 1598, 44.4, 6720, 8409, 362, 15491
alexbena, 1495, 46.3, 153, 428, 32, 613
alexborz, 1467, 34.2, 878, 788, 77, 1743
alexbtx, 1321, 75.4, 384, 329, 43, 756
alexca, 1544, 27.0, 9993, 16222, 1114, 27329
AlexCEC, 1258, 72.9, 632, 915, 106, 1653
alexe, 1395, 24.6, 9174, 7437, 425, 17036
AlexeiJC, 1550, 78.1, 76, 23, 1, 100
AlexeyBogado, 1400, 33.7, 1763, 1123, 122, 3008
alexFzero, 951, 137.9, 5, 22, 0, 27
alexinaustin, 1303, 109.4, 4444, 3993, 280, 8717
alexmusic, 1277, 24.0, 3342, 2609, 405, 6356
alexradulescu, 1311, 33.4, 2046, 2902, 320, 5268
AlexRandom, 1543, 53.5, 1200, 1244, 135, 2579
AlexRodriguezX, 929, 84.6, 44, 136, 3, 183
alexstclaire, 1785, 29.5, 600, 569, 49, 1218
AlexusII, 1588, 32.8, 13324, 9875, 1008, 24207
alexyouknow, 1712, 79.5, 5425, 6325, 581, 12331
alexzandros, 1186, 39.1, 59, 83, 5, 147
alfabio, 1470, 56.7, 2615, 3891, 268, 6774
alfamus, 1992, 96.7, 143, 138, 19, 300
alffrevann, 973, 41.3, 1141, 2576, 55, 3772
AlfGarnett, 1714, 80.7, 453, 170, 41, 664
alfredisimo, 1340, 21.6, 6988, 5615, 473, 13076
alfreditopiano, 1315, 104.1, 182, 242, 20, 444
alfredthefourth, 1310, 47.6, 1024, 889, 70, 1983
alfXX, 1368, 54.7, 6773, 5301, 378, 12452
AlgozBR, 1360, 24.4, 2655, 3332, 185, 6172
Algwynn, 1428, 31.6, 2870, 3906, 230, 7006
AlheeKing, 1238, 21.2, 3061, 5645, 257, 8963
Alicffxi, 1394, 55.5, 1795, 2268, 173, 4236
AlienEyes, 1392, 45.0, 2300, 2726, 328, 5354
AlienFever, 980, 30.4, 1281, 1137, 46, 2464
AlienInvasion, 1470, 138.5, 5, 11, 0, 16
AlienKing, 1451, 38.8, 1112, 858, 104, 2074
Alieth, 1848, 68.6, 483, 300, 30, 813
alifant, 1902, 31.0, 803, 453, 37, 1293
aligre, 1267, 37.7, 2545, 2903, 126, 5574
alikan, 979, 86.0, 49, 87, 1, 137
alikshay, 1820, 76.9, 131, 53, 9, 193
alili, 1113, 344.5, 0, 1, 0, 1
aliojin, 1461, 71.6, 3205, 3867, 358, 7430
alipax, 1222, 51.9, 1237, 1124, 62, 2423
alito, 1667, 43.6, 2176, 2458, 307, 4941
alittletempo, 1512, 50.0, 400, 300, 31, 731
Aliver, 1277, 60.2, 316, 308, 29, 653
Aliyah, 1866, 67.8, 1913, 914, 112, 2939
Aljohin, 1926, 58.7, 939, 1489, 185, 2613
alkeksibus, 1482, 33.1, 4754, 4079, 329, 9162
allanzhao, 1269, 56.3, 420, 740, 33, 1193
AllAroundButcher, 678, 126.2, 12, 139, 2, 153
alldeadwhiteboys, 1129, 112.4, 351, 677, 19, 1047
allegories, 1411, 41.4, 1549, 2527, 176, 4252
allegroknight, 968, 175.0, 99, 255, 6, 360
allencox, 1104, 33.8, 471, 592, 43, 1106
Allenko, 1182, 19.3, 662, 1248, 41, 1951
allenm, 1277, 49.7, 3040, 3610, 272, 6922
allenpaul, 1057, 169.3, 180, 161, 19, 360
Allensieah, 1221, 142.5, 7, 10, 1, 18
Allest, 1509, 108.9, 2486, 1187, 142, 3815
Allexx, 1581, 37.6, 7090, 9196, 626, 16912
alleyn, 1440, 28.4, 3438, 2465, 168, 6071
Alliance, 1781, 168.1, 14, 11, 0, 25
allman, 1519, 27.4, 4820, 6510, 530, 11860
allowmartin, 858, 71.6, 11, 114, 2, 127
ALLtheTIME, 1796, 108.8, 5040, 3192, 424, 8656
Allykind, 1540, 71.1, 456, 444, 37, 937
aLmaLja, 981, 101.6, 765, 955, 12, 1732
almart, 1629, 143.3, 42, 12, 3, 57
almcr, 1199, 47.9, 2389, 2055, 292, 4736
AlMina, 1450, 106.0, 3537, 3382, 228, 7147
alms, 1821, 112.5, 2968, 2811, 513, 6292
almujahid, 1313, 76.9, 2585, 2816, 180, 5581
Almuradour, 1235, 65.4, 2509, 3078, 336, 5923
alohachess, 897, 73.4, 13, 29, 2, 44
Alohajim, 1270, 49.7, 1753, 1915, 186, 3854
alokdk, 1298, 35.4, 3200, 5466, 291, 8957
alonm, 1935, 30.0, 12596, 9628, 1381, 23605
Alop, 1192, 134.9, 11, 56, 1, 68
ALorioli, 1357, 59.0, 767, 1505, 76, 2348
ALostArt, 1384, 68.5, 759, 594, 41, 1394
aloveregis, 1811, 117.2, 443, 314, 26, 783
Alparslan, 1763, 68.4, 1185, 1130, 145, 2460
alphafoxtrot, 1511, 92.1, 823, 965, 67, 1855
alphastirke, 1177, 115.4, 611, 670, 26, 1307
Alquinte, 1063, 28.3, 2471, 2676, 121, 5268
alra, 1312, 44.9, 8239, 8209, 368, 16816
alrowan, 1272, 79.7, 783, 648, 28, 1459
Alsace, 1237, 33.7, 4241, 5473, 392, 10106
ALSHAMI, 1811, 46.4, 706, 763, 52, 1521
Altais, 1685, 87.0, 253, 201, 23, 477
AlteSchlunze, 1789, 29.8, 10958, 4428, 702, 16088
AltNto, 1088, 103.7, 209, 305, 6, 520
ALTOTAS, 1353, 37.5, 4356, 4234, 472, 9062
Altrip, 1522, 56.0, 2563, 1429, 178, 4170
altrortla, 1218, 32.9, 4244, 6279, 301, 10824
alupihan, 1327, 121.5, 21, 11, 1, 33
Alvatrus, 1248, 44.0, 2407, 1184, 183, 3774
Alvenko, 1872, 38.8, 404, 300, 63, 767
alvinccruz, 1399, 55.6, 808, 421, 51, 1280
AlvinShow, 1164, 107.5, 3, 16, 0, 19
alvishvinci, 1848, 56.4, 87, 47, 5, 139
Alvruocnar, 1678, 26.3, 4796, 4460, 843, 10099
alwayslearning, 779, 164.9, 1862, 1461, 170, 3493
alwaysultra, 1592, 66.5, 829, 817, 114, 1760
alxandre, 1096, 139.3, 1234, 1131, 97, 2462
alxsb, 1557, 22.1, 9975, 11703, 1320, 22998
Amadaus, 1034, 188.3, 0, 4, 0, 4
amanecer, 1283, 33.0, 569, 689, 27, 1285
amanitedjowongso, 690, 198.0, 0, 7, 0, 7
amaranand, 1117, 95.5, 121, 177, 6, 304
AMART, 1268, 49.0, 867, 996, 62, 1925
amateuratlast, 1583, 23.8, 10561, 10936, 1513, 23010
AmauriDantas, 1336, 42.7, 1288, 1072, 125, 2485
Amauta, 1520, 54.7, 436, 177, 31, 644
AMAVABEL, 1607, 24.4, 2336, 2611, 262, 5209
amaysing, 1528, 78.3, 74, 30, 3, 107
Amazon, 1312, 32.5, 5475, 5773, 420, 11668
AmbiDexter, 2124, 32.7, 3625, 4617, 708, 8950
ambion, 947, 98.8, 561, 934, 44, 1539
Ambot, 1197, 23.8, 1039, 2164, 114, 3317
Amedeus, 1168, 35.1, 703, 716, 38, 1457
AmericanGreed, 1523, 83.8, 255, 279, 41, 575
AmexJam, 960, 120.2, 33, 57, 2, 92
amiableCDN, 1231, 86.2, 5385, 2651, 275, 8311
AmigaJim, 1276, 141.3, 35, 40, 0, 75
AMilli, 1568, 26.7, 471, 314, 36, 821
aminayag, 1361, 64.7, 2354, 2510, 178, 5042
aminkhan, 1360, 69.3, 4328, 2887, 282, 7497
AMirela, 1140, 31.5, 5325, 4429, 274, 10028
amirelattar, 1133, 36.2, 2423, 2487, 203, 5113
Amirh, 1674, 83.0, 2944, 4036, 329, 7309
AMITAF, 1399, 26.6, 8944, 3451, 793, 13188
amiteshnagarwal, 1134, 158.3, 0, 13, 0, 13
amitindia, 917, 105.5, 33, 88, 1, 122
amitmalhotra, 932, 112.2, 36, 107, 4, 147
AmmirAdj, 1241, 112.9, 19, 62, 0, 81
Ammunition, 1465, 125.9, 1541, 1385, 98, 3024
amolv, 1362, 27.7, 2364, 1922, 199, 4485
AMoveAhead, 1507, 30.3, 1233, 2091, 133, 3457
AmpedAl, 975, 52.5, 481, 1272, 41, 1794
ampersand, 1960, 61.2, 283, 44, 13, 340
Amphibion, 1640, 53.5, 494, 456, 84, 1034
amphiprion, 1325, 49.9, 90, 106, 3, 199
ampiong, 1386, 43.3, 71, 26, 2, 99
ampkro, 1350, 47.1, 1180, 872, 65, 2117
Amplify, 1227, 72.5, 281, 320, 28, 629
ampyjoe, 1368, 29.8, 5059, 5733, 297, 11089
amr, 1782, 50.9, 15483, 11221, 1553, 28257
AmsterdamSlim, 1954, 33.8, 3848, 2038, 577, 6463
AmyLee, 2053, 76.6, 196, 93, 14, 303
ANABAS, 1674, 106.9, 185, 164, 25, 374
anachronism, 1592, 29.2, 1447, 1280, 188, 2915
anahita, 1442, 117.2, 735, 1290, 79, 2104
anail, 1387, 116.8, 10, 15, 0, 25
Anakreon, 913, 350.0, 0, 2, 0, 2
AnalyticVI, 825, 137.2, 0, 50, 0, 50
anamyik, 1097, 29.9, 1813, 2792, 181, 4786
anandjoshi, 1346, 127.2, 14, 35, 3, 52
anandk, 1513, 31.6, 3442, 6222, 698, 10362
anandkvs, 1737, 44.4, 6337, 5334, 567, 12238
Anarchbishop, 1232, 75.9, 352, 391, 29, 772
Anarchyrules, 977, 90.4, 37, 27, 3, 67
Anarquico, 1194, 44.0, 1714, 3503, 89, 5306
anatoliakin, 1257, 54.2, 1894, 2835, 198, 4927
Andaluzito, 1068, 53.4, 727, 1041, 73, 1841
ANDGREG, 1285, 126.9, 907, 868, 77, 1852
AndHar, 1291, 50.2, 1575, 965, 63, 2603
andhh, 1220, 36.9, 1408, 1629, 134, 3171
AndMorg, 1466, 102.1, 45, 30, 2, 77
AndN, 1806, 21.3, 2671, 2764, 376, 5811
andna, 1919, 272.5, 1, 0, 0, 1
andonehotsauce, 1050, 96.3, 128, 274, 17, 419
andragona, 1012, 33.3, 1174, 2049, 64, 3287
andreale, 1086, 79.3, 2187, 3027, 183, 5397, 1781, 28.6, 51256, 25401, 2517, 79174
AndreD, 1856, 191.3, 2419, 1515, 159, 4093
andreialex, 1167, 37.0, 1973, 2076, 87, 4136
andreiasw, 1037, 86.0, 92, 159, 4, 255
andrejas, 1115, 44.5, 1165, 1076, 61, 2302
AndreNY, 1075, 102.3, 11, 147, 6, 164
andreomr, 1278, 75.6, 1921, 1744, 107, 3772
andrepcrs, 1121, 67.2, 152, 279, 6, 437
AndresChess, 946, 122.5, 56, 113, 3, 172
AndresElPez, 1080, 28.7, 242, 384, 20, 646
andresfhernandez, 1539, 30.5, 3745, 3382, 225, 7352
andreskata, 1054, 63.6, 136, 118, 11, 265
AndreSoares, 1232, 90.7, 2307, 3539, 267, 6113
AndrewAJ, 1536, 27.4, 4981, 6221, 215, 11417
AndrewCrotty, 1426, 41.7, 3140, 3951, 356, 7447
AndrewGuest, 944, 171.4, 1, 5, 0, 6
andrewparis, 1366, 22.9, 2318, 2615, 194, 5127
AndrewRR, 1461, 43.3, 1867, 1601, 213, 3681
Andriitis, 1126, 54.9, 1105, 1914, 152, 3171
androidcell, 1375, 107.7, 656, 741, 96, 1493
Andropov, 1539, 33.0, 6118, 5660, 647, 12425
andyalex, 1266, 39.5, 1040, 1393, 90, 2523
andyandyw, 2042, 32.0, 4721, 2492, 592, 7805
andyba, 772, 167.0, 48, 182, 0, 230
andybeech, 1547, 42.6, 3603, 3499, 189, 7291
andycappablanca, 1616, 51.5, 1941, 880, 75, 2896
andygross, 1136, 105.0, 5, 26, 0, 31
andyhot, 1992, 54.0, 2679, 2157, 270, 5106
AndyTML, 940, 45.0, 550, 553, 31, 1134
AndyYuk, 963, 73.5, 454, 652, 43, 1149
AndyZCanada, 760, 62.6, 8, 71, 1, 80
anegorov, 1148, 70.5, 943, 1149, 55, 2147
anerww, 1399, 33.8, 901, 594, 73, 1568
anesh, 1042, 34.7, 135, 331, 10, 476
Anfearmorlaidir, 1264, 21.5, 792, 799, 43, 1634
anfercol, 911, 46.8, 271, 685, 19, 975
AngelAzteca, 1583, 46.3, 624, 540, 48, 1212
Angelique, 1716, 27.1, 2148, 1984, 333, 4465
angelofausto, 1431, 56.7, 1155, 810, 107, 2072
angeltwo, 1342, 18.8, 6948, 4707, 346, 12001
Anglachel, 1405, 37.9, 1307, 824, 144, 2275
anglosachsen, 1126, 31.6, 1574, 2545, 101, 4220
Angreif, 1441, 327.2, 0, 0, 1, 1
ANGRIF, 1113, 43.4, 882, 1358, 100, 2340
angryCanadian, 1121, 26.7, 2878, 3943, 287, 7108
angusaki, 1125, 37.9, 1531, 1647, 52, 3230
anibalito, 1497, 51.0, 6636, 3755, 512, 10903
anicee, 1403, 98.6, 2, 35, 2, 39
aniceto, 1212, 94.7, 33, 40, 3, 76
Aniello, 1503, 43.8, 405, 210, 43, 658
aniket, 1067, 67.3, 223, 600, 20, 843
anild, 1086, 94.0, 113, 148, 9, 270
animals, 1337, 48.9, 101, 105, 10, 216
animalsRpeopletoo, 1668, 42.5, 2037, 1201, 170, 3408
anishm, 1376, 40.3, 3274, 2849, 294, 6417
anithen, 1018, 73.1, 115, 294, 5, 414
ankhra, 1066, 33.9, 717, 1298, 166, 2181
ankitjain, 1135, 26.0, 939, 2060, 42, 3041
ankitvish, 1072, 100.1, 83, 161, 6, 250
ankurgupta, 878, 92.9, 5, 18, 0, 23
anle, 1238, 101.8, 1557, 1500, 106, 3163
ANLewis, 928, 109.5, 19, 39, 2, 60
anmzovitsch, 887, 34.7, 331, 657, 12, 1000
Anna, 1326, 122.2, 2529, 5888, 261, 8678
AnnaMariaT, 1600, 131.3, 1643, 869, 232, 2744
Annie, 1241, 135.5, 2996, 3840, 217, 7053
AnnieK, 1473, 27.2, 6077, 3428, 391, 9896
AnnieMc, 1314, 25.7, 1689, 1412, 134, 3235
annjo, 1394, 38.3, 554, 413, 25, 992
anonymousking, 1561, 24.7, 933, 947, 111, 1991
ANONYMOUSqqqq, 1447, 137.8, 14, 4, 0, 18
anordinaryguy, 1348, 65.1, 956, 707, 73, 1736
anosemememasen, 1232, 42.6, 139, 229, 9, 377
anotherError, 2017, 134.5, 9893, 7500, 1097, 18490
anothername, 1501, 84.4, 3981, 2281, 309, 6571
anotherWay, 1379, 23.3, 15929, 12020, 1090, 29039
Anselmus, 1234, 34.2, 6936, 5529, 297, 12762
anssibalk, 1504, 59.3, 217, 205, 8, 430
Antaj, 1518, 29.4, 343, 182, 11, 536
AntarcticaMan, 1860, 42.4, 1327, 843, 80, 2250
AntaresTSM, 1826, 29.2, 1407, 1755, 213, 3375
antc, 1055, 49.2, 1020, 1850, 132, 3002
antdark, 994, 57.8, 35, 74, 6, 115
anteeks, 1392, 28.7, 537, 732, 46, 1315
anterdabbous, 1190, 108.1, 7, 11, 2, 20
AnthonyBlake, 1371, 46.0, 229, 152, 10, 391
AnthonyNussbaum, 1124, 97.9, 1974, 2972, 114, 5060
anthonypete, 1324, 55.2, 153, 208, 10, 371
anthropositor, 1056, 114.6, 3305, 2616, 206, 6127
AntiCCP, 1759, 99.8, 223, 190, 7, 420
AnticIBM, 1785, 20.7, 3136, 3606, 365, 7107
antimony, 1821, 34.5, 4931, 2746, 582, 8259
antione, 880, 141.6, 12, 41, 0, 53
antizwi, 1788, 29.1, 3225, 1777, 191, 5193
AntKa, 1289, 30.1, 558, 561, 92, 1211
AntonFlo, 1659, 23.7, 6113, 3307, 288, 9708
antoni, 1961, 36.6, 21580, 14787, 2445, 38812
AntoninDvorak, 1659, 63.2, 2583, 1945, 411, 4939
antoninoy, 1446, 32.3, 124, 118, 13, 255
AntonioCAS, 1229, 69.8, 151, 169, 20, 340
AntonioDe, 881, 47.3, 532, 1654, 34, 2220
antoniolorenzo, 1161, 154.7, 8, 12, 1, 21
Antonioni, 1290, 94.1, 1499, 710, 147, 2356
AntonioZ, 1313, 58.3, 2230, 2124, 153, 4507
antonmarin, 1497, 50.4, 1530, 1093, 69, 2692
AntonSup, 1026, 66.8, 278, 413, 13, 704
AntonusBlock, 1252, 62.1, 1587, 2057, 133, 3777
antonymous, 1527, 33.0, 2962, 2712, 202, 5876
antoon, 1397, 32.7, 8652, 9129, 876, 18657
Anupam, 1314, 43.3, 6452, 8334, 751, 15537
anush, 769, 78.4, 85, 184, 6, 275
anwarsadique, 1148, 39.1, 652, 971, 27, 1650
AnyaVexler, 1698, 104.4, 125, 53, 12, 190
aoea, 1289, 71.7, 105, 174, 10, 289
apariciogera, 1310, 106.8, 133, 72, 6, 211
apdccie, 1110, 131.4, 351, 293, 20, 664
APe, 1656, 30.3, 2687, 1418, 237, 4342
apexrtx, 1101, 350.0, 0, 1, 0, 1
APickedHandle, 1408, 31.4, 6102, 6578, 386, 13066
apil, 1164, 27.4, 1522, 1969, 78, 3569
apinheiro, 1130, 38.5, 4041, 4675, 385, 9101
apitka, 1887, 25.2, 4123, 3828, 306, 8257
aplchess, 1173, 30.2, 484, 273, 12, 769
Aplomb, 1516, 66.9, 301, 302, 30, 633
APOCALIIPSE, 1284, 49.7, 491, 579, 35, 1105
apollobikeboy, 870, 43.8, 115, 256, 4, 375
apollolune, 1712, 29.4, 2108, 2062, 117, 4287
apollosaturnv, 1240, 30.4, 1062, 1329, 30, 2421
apostolospal, 1393, 55.9, 1003, 884, 106, 1993
apoteosi, 1512, 35.8, 1598, 1301, 103, 3002
AppianHill, 1461, 73.0, 2500, 1940, 105, 4545
applejacks, 1260, 63.1, 5850, 5135, 630, 11615
Applesinych, 1558, 43.3, 11841, 8487, 660, 20988
Apprendista, 1422, 62.8, 5564, 5027, 568, 11159
Apprenti, 1452, 63.5, 9068, 9102, 625, 18795
aprajita, 1488, 62.2, 129, 153, 10, 292
Apsara, 1569, 273.0, 0, 1, 0, 1
apudooo, 1476, 58.1, 20807, 18708, 2082, 41597
Apurba, 864, 88.1, 18, 96, 1, 115
aputtu, 1284, 59.3, 3362, 4890, 305, 8557
aqeel, 1108, 69.7, 242, 487, 15, 744
aquadawg, 1071, 65.4, 3397, 5503, 167, 9067
AquarianKnight, 1248, 86.1, 148, 285, 13, 446
aqwest, 1402, 30.6, 5102, 3154, 372, 8628
arabianmate, 1822, 48.5, 1550, 1284, 85, 2919
arabplayer, 1242, 59.4, 468, 564, 27, 1059
Arachnoid, 1858, 62.5, 2486, 757, 70, 3313
Aramen, 1380, 134.5, 1013, 540, 53, 1606
AramuMuru, 1696, 37.5, 9646, 5375, 427, 15448
Aran, 1977, 68.1, 1415, 1032, 211, 2658
arathor, 1671, 95.6, 3809, 1540, 219, 5568
Araujone, 1631, 67.0, 746, 856, 67, 1669
aravind, 1787, 145.1, 1505, 790, 131, 2426
arbeiter, 1480, 50.4, 490, 351, 21, 862
arbhs, 1288, 179.8, 48, 165, 1, 214
arbitguy, 1628, 51.5, 1085, 900, 111, 2096
Arcadios, 1500, 68.5, 114, 77, 5, 196
ArcaneWarrior, 1474, 131.4, 301, 258, 31, 590
arcelt, 982, 43.9, 238, 268, 5, 511
Arcetri, 1398, 35.5, 6516, 7181, 495, 14192
arceuslee, 951, 62.4, 35, 128, 2, 165
ArchCN, 1564, 74.4, 61, 50, 2, 113
ArchDoom, 918, 33.6, 581, 774, 23, 1378
Archivarix, 1823, 27.5, 284, 165, 56, 505
archrulz, 1289, 43.9, 273, 313, 24, 610
archship, 1121, 153.6, 244, 215, 26, 485
arconova, 929, 39.3, 243, 804, 25, 1072
arcranger, 1150, 30.5, 3337, 3473, 242, 7052
Arctus, 1589, 87.1, 472, 205, 44, 721
ardiat, 1506, 37.0, 7200, 15817, 481, 23498
areksuroboyo, 1209, 115.9, 992, 1133, 50, 2175
Ares, 2009, 137.9, 2660, 2358, 323, 5341
AreWeThereYet, 1344, 36.1, 1326, 753, 99, 2178
Argentinium, 1589, 42.1, 265, 216, 16, 497
arggy, 1391, 135.7, 1725, 1726, 236, 3687
Argiem, 1043, 52.8, 198, 331, 28, 557
argol, 1473, 40.4, 1223, 1464, 139, 2826
arha, 1749, 54.5, 376, 576, 60, 1012
Aribas, 1368, 109.0, 285, 286, 24, 595
arickjay, 726, 126.5, 28, 82, 2, 112
arifN, 1434, 47.2, 1169, 1165, 81, 2415
arikokopa, 1301, 100.1, 896, 1390, 78, 2364
Arilazuardi, 1274, 116.2, 8, 8, 0, 16
arinov, 803, 34.5, 59, 174, 3, 236
Aritz, 1713, 58.8, 226, 230, 27, 483
arivaca, 1309, 38.9, 1831, 1482, 251, 3564
ariver, 1239, 81.1, 138, 132, 6, 276
arju, 1630, 32.3, 4367, 6207, 392, 10966
Arjusa, 1206, 35.8, 1298, 1846, 105, 3249
arjvul, 1564, 74.0, 3612, 2707, 291, 6610
ArkadyG, 1075, 37.9, 538, 1088, 66, 1692
ARKjoe, 1458, 59.4, 673, 770, 71, 1514
arkmaster, 1422, 39.4, 767, 582, 30, 1379
Arknard, 1189, 38.5, 1479, 1620, 65, 3164
arlekin, 1145, 64.2, 510, 423, 25, 958
arlenesroy, 1210, 33.6, 3391, 2874, 473, 6738
arlequim, 1605, 78.8, 125, 211, 12, 348
Armann, 1157, 35.4, 741, 1133, 87, 1961
armasar, 1238, 114.2, 1524, 1641, 76, 3241
Armatang, 1966, 37.1, 1269, 993, 124, 2386
armeniaca, 1452, 26.6, 1471, 1853, 187, 3511
Armeniansthebest, 1001, 29.4, 738, 1939, 57, 2734
Armoiraglatz, 1235, 42.6, 4081, 3851, 222, 8154
armyfanatic, 1211, 123.9, 8, 16, 0, 24
arnald, 1136, 203.6, 0, 4, 0, 4
Arnaque, 2091, 146.8, 1555, 1296, 246, 3097
arnealfreda, 1288, 46.2, 1667, 2872, 239, 4778
arnelgwapo, 1570, 46.4, 185, 124, 15, 324
ArnoldDueUno, 1320, 38.4, 1258, 1064, 96, 2418
Arnoldus, 720, 147.1, 16, 99, 1, 116
Arpej, 1553, 28.0, 7695, 8513, 551, 16759
Arphaxad, 1328, 28.3, 5257, 5768, 268, 11293
arpii, 1059, 107.6, 984, 817, 45, 1846
ARPunk, 1084, 50.8, 33, 45, 4, 82
ArrogantFrenchman, 1359, 35.3, 471, 795, 53, 1319
Arrrrrrr, 1732, 67.5, 398, 142, 16, 556
arseri, 881, 91.7, 374, 1020, 5, 1399
arsujoc, 1402, 131.3, 200, 98, 12, 310
artbkv, 1450, 144.7, 4, 4, 0, 8
arteagov, 1449, 28.3, 2079, 2197, 261, 4537
Artekk, 1411, 121.5, 179, 128, 11, 318
arterII, 1325, 33.7, 1712, 1728, 147, 3587
Artes, 1313, 87.0, 222, 176, 9, 407
artground, 1269, 28.7, 1545, 1564, 168, 3277
ArthurSc, 1543, 96.2, 160, 213, 4, 377
arthzu, 1663, 31.8, 3039, 3362, 336, 6737
Artifook, 1552, 27.8, 8998, 13611, 897, 23506
artismypassion, 1238, 287.6, 4, 2, 1, 7
Artist, 1344, 17.2, 6990, 7415, 788, 15193
ArtofFear, 1050, 39.2, 59, 128, 13, 200
ArtofGrob, 1246, 112.8, 1025, 1422, 47, 2494
Artolas, 1525, 31.8, 177, 109, 15, 301
ArtSmart, 1193, 26.2, 3675, 4612, 487, 8774
ArturoToscanini, 2435, 269.1, 1760, 2459, 319, 4538
ArtVandelayCO, 1592, 24.4, 3883, 3241, 530, 7654
arulchess, 1324, 83.2, 58, 208, 5, 271
arunj, 1258, 40.0, 813, 1513, 145, 2471
arusha, 2014, 111.9, 4471, 2671, 235, 7377
Arut, 1439, 33.7, 4083, 4798, 540, 9421
arvie, 2047, 31.8, 9820, 4345, 1024, 15189
asaadref, 1724, 241.1, 2, 1, 0, 3
Asafs, 1449, 47.2, 7078, 6957, 536, 14571
asalman, 1643, 85.8, 12244, 13879, 1154, 27277
AsalSaja, 1644, 37.5, 541, 538, 26, 1105
Asbest, 1549, 170.1, 13, 6, 0, 19
ASchreiber, 1178, 68.8, 2708, 3673, 197, 6578
asciiman, 1456, 29.4, 12687, 10503, 914, 24104
asdfgqwerty, 786, 62.6, 35, 153, 1, 189
ASFCHESS, 1135, 49.2, 2980, 4022, 233, 7235
ashania, 1104, 27.8, 301, 305, 21, 627
ashewo, 1344, 34.6, 3893, 3588, 159, 7640
ashishapathak, 1001, 65.7, 200, 478, 16, 694
ashvenky, 868, 155.6, 0, 11, 0, 11
ashwinmn, 879, 190.2, 12, 56, 1, 69
Ashy, 1546, 27.9, 4856, 5601, 509, 10966
asig, 1261, 58.9, 428, 359, 24, 811
asilah, 812, 109.5, 83, 218, 4, 305
aslaa, 1573, 26.2, 1588, 774, 127, 2489
asmena, 1242, 25.1, 8064, 15877, 1051, 24992
asmmkhnaa, 1274, 87.1, 48, 33, 0, 81
asmro, 1193, 22.9, 5385, 7935, 399, 13719
asmsk, 1351, 129.1, 1771, 2020, 131, 3922
asomchess, 1464, 78.2, 234, 203, 16, 453
AsoneW, 837, 123.7, 40, 121, 0, 161
Asparuh, 1563, 230.6, 1, 2, 0, 3
asregmi, 1040, 58.8, 213, 327, 20, 560
assasincreed, 1678, 20.4, 612, 485, 63, 1160
AssemblagePoint, 870, 95.0, 260, 583, 20, 863
astalaveesta, 1196, 34.2, 5329, 11810, 473, 17612
astanapan, 1432, 273.4, 2, 1, 0, 3
asteier, 884, 30.4, 599, 627, 32, 1258
AStein, 1046, 126.8, 341, 401, 24, 766
astello, 2085, 31.1, 1288, 806, 88, 2182
astrida, 1157, 117.4, 43, 45, 2, 90
astrocyte, 1048, 72.8, 146, 272, 7, 425
Astronomas, 1005, 107.6, 155, 232, 10, 397
Astronominoff, 1585, 90.6, 8780, 8835, 436, 18051
AstroUltraMan, 1218, 39.6, 1717, 2143, 33, 3893
asturia, 1301, 188.5, 49, 50, 3, 102
asucampus, 1419, 60.0, 620, 457, 49, 1126
AsuraPriest, 1315, 307.2, 0, 1, 0, 1
asxetos, 1457, 29.1, 17797, 11446, 1009, 30252
Atalaia, 1649, 47.5, 902, 953, 83, 1938
atanasios, 1858, 31.9, 1110, 1167, 209, 2486
Ataraxi, 1269, 119.4, 2223, 3027, 181, 5431
atataro, 1491, 69.1, 295, 266, 47, 608
ateapotist, 1438, 80.2, 730, 522, 33, 1285
atenuador, 1204, 88.9, 64, 80, 4, 148
ATG, 1605, 218.8, 876, 430, 51, 1357
Athenshuff, 1090, 115.0, 111, 160, 8, 279
athosdelafere, 1188, 43.5, 149, 267, 8, 424
Athoury, 1384, 59.1, 212, 331, 21, 564
aththemaniac, 1282, 25.7, 4287, 2885, 308, 7480
Atlantamaster, 1162, 50.8, 75, 76, 2, 153
atlantida, 1565, 85.1, 437, 128, 31, 596
atlasok, 2028, 75.0, 2032, 1009, 115, 3156
atlaw, 1739, 62.4, 6741, 6205, 910, 13856
ATLO, 1225, 24.5, 1755, 2681, 284, 4720
atomm, 1452, 92.2, 839, 807, 99, 1745
atripp, 1356, 108.6, 723, 592, 47, 1362
attackpawn, 1087, 59.3, 1780, 1257, 79, 3116
attero, 1485, 125.9, 22, 17, 1, 40
attiba, 1189, 87.1, 304, 332, 16, 652
AttilaTheHun, 1530, 39.2, 3744, 2987, 318, 7049
atxshotcaller, 1332, 36.3, 292, 435, 15, 742
atyb, 1384, 45.0, 2662, 2244, 202, 5108
Atyeo, 1225, 62.4, 601, 423, 54, 1078
Atzematze, 1470, 27.0, 1314, 852, 58, 2224
aubisque, 1222, 34.5, 406, 370, 29, 805
Audax, 1487, 36.9, 4257, 3210, 292, 7759
audsyn, 1085, 81.8, 50, 65, 7, 122
auenbear, 1145, 42.4, 954, 1326, 52, 2332
aufdermaur, 1135, 84.7, 128, 105, 4, 237
augmented, 852, 137.9, 3, 17, 0, 20
AugustSunshine, 892, 80.3, 52, 189, 4, 245
Aul, 1123, 82.3, 382, 394, 17, 793
auntiegene, 1093, 43.7, 535, 596, 44, 1175
AuntyRuth, 1059, 36.0, 2727, 2559, 118, 5404
AureA, 669, 198.1, 0, 8, 1, 9
AurobindoMira, 1250, 36.2, 145, 235, 20, 400
ausiuguk, 1141, 64.8, 449, 523, 24, 996
AusSauce, 1098, 64.6, 125, 208, 7, 340
aussenschnapp, 1583, 23.5, 557, 377, 37, 971
aussiemickyc, 817, 108.1, 183, 811, 20, 1014
austachess, 1118, 180.3, 3, 13, 0, 16
austinjord, 1648, 31.8, 2956, 2830, 236, 6022
AuthurianKnight, 1441, 126.4, 2, 20, 1, 23
autocadpower, 983, 54.4, 48, 172, 2, 222
AutomaticWeezy, 1551, 61.6, 4960, 4120, 354, 9434
avalp, 1699, 30.3, 4394, 6552, 498, 11444
avanazhi, 1461, 79.4, 32, 23, 2, 57
avandria, 1131, 61.5, 40, 37, 1, 78
avashah, 1441, 27.1, 4542, 3826, 233, 8601
avatarbbb, 1699, 30.7, 2332, 1471, 108, 3911
AVCC, 1915, 62.8, 355, 171, 15, 541
Avertigo, 1929, 79.9, 11537, 9204, 1152, 21893
AVGLLL, 1086, 81.4, 664, 924, 58, 1646
avguste, 1364, 298.6, 0, 1, 0, 1
avgwhtboy, 1198, 32.2, 1320, 1562, 47, 2929
avigiljr, 695, 124.3, 26, 101, 1, 128
avmode, 1140, 55.3, 222, 230, 20, 472
avocadox, 1740, 350.0, 1, 0, 0, 1
avodroc, 1627, 82.4, 598, 693, 53, 1344
Avongaurde, 1685, 85.5, 857, 1093, 57, 2007
Avorio, 1528, 35.1, 3929, 2066, 349, 6344
avrsteve, 1072, 128.0, 1, 14, 0, 15
Avstral, 1523, 153.5, 14, 15, 5, 34
avweije, 1616, 122.8, 7857, 5478, 702, 14037
awadsageralroba, 783, 37.1, 88, 391, 6, 485
awards, 1743, 26.2, 1004, 1235, 90, 2329
awayjudith, 1223, 57.3, 327, 400, 15, 742
AWidowMaker, 1742, 156.3, 496, 355, 56, 907
Axe, 1684, 20.6, 23865, 17549, 2396, 43810
axelina, 852, 230.8, 807, 754, 61, 1622
axelr, 1510, 27.9, 4039, 4339, 607, 8985
axetil, 1790, 97.3, 1613, 811, 74, 2498
AXLJOSH, 1486, 52.9, 1957, 1733, 254, 3944
axlr, 1060, 57.2, 1860, 2772, 323, 4955
axn, 1781, 123.8, 1920, 2126, 309, 4355
AXTbIPKA, 1434, 25.8, 7371, 3560, 406, 11337
ayatolaroknrola, 1172, 25.0, 3092, 5593, 441, 9126
aygunozy, 1585, 128.6, 680, 1068, 97, 1845
ayi, 1364, 24.4, 14478, 16241, 1028, 31747
ayinky, 1755, 27.5, 11701, 2820, 351, 14872
ayjara, 1027, 143.4, 52, 59, 1, 112
aymmd, 1272, 79.3, 21, 74, 1, 96
ayorius, 783, 128.3, 48, 130, 0, 178
ayushu, 938, 130.5, 28, 52, 1, 81
ayze, 1105, 41.5, 478, 1298, 68, 1844
Aza, 1826, 40.7, 5894, 4520, 550, 10964
azd, 1540, 31.9, 10265, 8578, 1172, 20015
azonips, 1583, 32.1, 2428, 3220, 287, 5935
azriel, 1640, 55.0, 3425, 1743, 197, 5365
AztecEagle, 1455, 39.1, 6046, 4427, 297, 10770
Azterix, 1226, 102.2, 64, 35, 5, 104
aztkbrown, 1143, 32.4, 1753, 953, 64, 2770
Azubuike, 862, 104.6, 6, 62, 2, 70
Azuras, 1692, 40.2, 2815, 2409, 228, 5452
Azver, 1400, 35.2, 615, 486, 44, 1145
azzaonnet, 1086, 37.4, 2249, 3725, 307, 6281
baalzebul, 1359, 29.6, 11094, 16938, 1295, 29327
BABASBABE, 1318, 33.5, 4733, 2040, 151, 6924
Babbel, 1918, 28.1, 4123, 2291, 359, 6773
babnik, 1081, 70.0, 293, 250, 9, 552
bacchist, 897, 127.7, 24, 98, 3, 125
BacchusFab, 1306, 144.5, 4, 8, 0, 12
Backlack, 1362, 28.2, 1899, 2681, 81, 4661
backnforth, 1774, 52.6, 15196, 18749, 2121, 36066
backtothefuture, 1498, 23.1, 6629, 7335, 516, 14480
badassninja, 1763, 81.1, 120, 151, 10, 281
BaDbOyHeRe, 1278, 25.6, 517, 472, 31, 1020
badbutch, 1055, 60.4, 997, 964, 84, 2045
badmovebruce, 1751, 49.4, 6310, 4626, 774, 11710
BADnessss, 1086, 126.8, 59, 85, 7, 151
BadPlayerdm, 993, 81.5, 100, 72, 7, 179
BadReligion, 1276, 23.6, 2247, 3574, 206, 6027
Badyl, 1633, 44.7, 292, 106, 12, 410
BaenreGHL, 1450, 60.3, 335, 311, 23, 669
bafflegab, 1730, 56.1, 485, 477, 46, 1008
Bage, 1513, 30.2, 10282, 10148, 1067, 21497
baggerbusta, 1230, 205.7, 2, 4, 0, 6
Bagins, 1404, 27.7, 1010, 1057, 77, 2144
bajobajo, 959, 44.1, 482, 304, 22, 808
bakaduran, 1736, 110.4, 253, 368, 30, 651
BAKERMANS, 1156, 28.7, 385, 420, 19, 824
bakeshake, 1583, 201.8, 10, 16, 0, 26
Bakshi, 1238, 33.9, 3115, 3313, 314, 6742
bakugan, 1674, 52.3, 1044, 696, 61, 1801
balassa, 1295, 25.4, 7144, 11501, 555, 19200
balazar, 1434, 29.2, 3460, 5173, 328, 8961
balbir, 1457, 23.5, 4342, 3750, 335, 8427
baldasso, 1565, 26.8, 975, 853, 28, 1856
baldi, 907, 117.9, 45, 172, 3, 220
baldyjon, 1184, 27.9, 6474, 9313, 1124, 16911
balkanboy, 1751, 33.7, 5904, 9979, 934, 16817
ballenero, 1189, 28.3, 1442, 2209, 99, 3750
balovzky, 925, 216.5, 14, 61, 0, 75
Balrog, 1707, 112.6, 265, 198, 52, 515
Balthazaroba, 902, 100.1, 25, 76, 6, 107
balthom, 1363, 27.7, 5872, 10421, 268, 16561
Bamgit, 1536, 54.0, 380, 531, 35, 946
Bancer, 1289, 50.8, 85, 95, 9, 189
Bandesz, 2158, 73.0, 6410, 2899, 379, 9688
bandoo, 1073, 57.0, 426, 634, 45, 1105
bandwagon, 880, 144.3, 187, 585, 18, 790
Bandya, 1223, 41.7, 117, 112, 3, 232
Banghede, 1306, 117.1, 25, 28, 2, 55
Bangthe, 995, 199.0, 7, 24, 1, 32
banihas, 1320, 54.2, 140, 100, 9, 249
bankanidhi, 1626, 68.1, 1368, 676, 60, 2104
Banning, 1155, 87.1, 68, 112, 1, 181
banshik, 1134, 41.4, 1654, 1571, 77, 3302
BanzaiWagner, 1345, 35.0, 401, 333, 44, 778
Barakman, 1051, 298.0, 0, 2, 0, 2
BarBacon, 1210, 135.9, 47, 49, 1, 97
Barbarevic, 1303, 35.8, 3223, 4510, 512, 8245
BarbarianBrain, 1165, 48.5, 3057, 4774, 295, 8126
barbary, 1770, 55.5, 2263, 2605, 116, 4984
barbitueight, 1372, 38.0, 1389, 726, 146, 2261
barbos, 1184, 31.1, 1034, 1298, 70, 2402
barbraid, 1057, 28.4, 673, 1025, 32, 1730
barchi, 1593, 236.2, 760, 579, 64, 1403
BarfGag, 1380, 68.4, 257, 148, 14, 419
Bariman, 1090, 135.7, 13, 68, 1, 82
Barkeeper, 938, 113.5, 7, 26, 0, 33
Barnaul, 1707, 87.9, 1033, 839, 100, 1972
BarnesEBB, 1484, 21.5, 4549, 4181, 251, 8981
baronic, 1510, 46.9, 66, 71, 4, 141
Barook, 1472, 39.3, 512, 432, 28, 972
barraabus, 1133, 93.2, 3680, 10215, 184, 14079
barracano, 1721, 31.1, 7897, 9224, 1235, 18356
barracoman, 2017, 118.7, 62, 10, 1, 73
barrar, 1199, 96.3, 3126, 5249, 199, 8574
barrigon, 1258, 37.0, 661, 825, 38, 1524
barriosgeb, 1412, 24.8, 171, 198, 6, 375
Barrone, 1196, 22.1, 335, 565, 12, 912
barrytaylor, 1055, 225.7, 0, 3, 0, 3
barrywelsh, 1316, 34.3, 1835, 1800, 86, 3721
bartab, 1086, 128.3, 41, 75, 0, 116
bartsimspon, 1241, 43.3, 263, 569, 16, 848
Barva, 1509, 29.1, 738, 852, 54, 1644
basald, 1832, 90.2, 3644, 4513, 408, 8565
basdoo, 1099, 63.3, 279, 313, 25, 617
basejump, 1455, 83.3, 1852, 1898, 230, 3980
Baseman, 1754, 42.4, 2253, 2135, 317, 4705
bashandash, 1654, 40.0, 32838, 20911, 1775, 55524
Basicmann, 1351, 37.7, 2301, 2221, 209, 4731
basilphoto, 954, 156.8, 82, 232, 6, 320
basketjerk, 916, 41.0, 191, 249, 10, 450
bassale, 1237, 36.5, 3690, 2221, 184, 6095
bassosoolo, 1616, 27.0, 6537, 5274, 634, 12445
bastardu, 1604, 31.6, 1052, 2455, 114, 3621
bastianh, 1459, 38.1, 1076, 1128, 176, 2380
basvdieren, 1143, 27.9, 1587, 1233, 157, 2977
Batangapo, 1752, 89.6, 2350, 2953, 199, 5502
batbrad, 1029, 32.0, 1123, 1548, 70, 2741
Batia, 1659, 39.1, 16007, 17838, 1327, 35172
batjko, 1517, 57.7, 1834, 2134, 159, 4127
Batmankp, 1075, 37.7, 2306, 2262, 77, 4645
batoutofhell, 1705, 29.9, 3659, 1234, 329, 5222
batoz, 1634, 350.0, 0, 1, 0, 1
battez, 1456, 50.2, 5082, 7109, 796, 12987
Battlecruiser, 2002, 166.1, 590, 562, 63, 1215
BATU, 1239, 83.0, 1743, 2203, 101, 4047
batyi, 1360, 112.5, 10245, 8421, 694, 19360
Bauernendspiel, 1644, 188.2, 3, 3, 0, 6
bauernfaenger, 1527, 77.9, 405, 534, 48, 987
bavaqua, 817, 85.1, 9, 38, 0, 47
bawdy, 1624, 32.2, 2489, 2936, 322, 5747
Baweja, 1423, 32.0, 1169, 993, 60, 2222
Bawss, 882, 150.1, 2, 13, 0, 15
Baylan, 1284, 138.1, 684, 928, 80, 1692
bayokyok, 1352, 26.8, 924, 1514, 48, 2486
bazak, 1546, 29.9, 19788, 24481, 1643, 45912
bazin, 1315, 34.3, 8174, 9952, 887, 19013
Bazirov, 1296, 25.6, 11057, 14640, 1173, 26870
bazziboy, 1190, 60.9, 1019, 1314, 65, 2398
BBBstock, 1466, 56.5, 1583, 1156, 127, 2866
BBendingR, 961, 45.3, 46, 138, 1, 185
bbezak, 1315, 36.1, 4075, 3902, 195, 8172
bboobboo, 1570, 63.1, 525, 697, 42, 1264
bborah, 1263, 37.9, 2428, 2802, 178, 5408
bbplayer, 1339, 281.9, 0, 1, 0, 1
bbqxpawn, 1328, 37.4, 3370, 4712, 215, 8297
bbrom, 1381, 31.2, 4550, 5100, 535, 10185
BCCANADA, 1083, 36.1, 386, 465, 10, 861
bcdsxsxsx, 1133, 41.6, 314, 505, 22, 841
bchamateur, 1360, 22.0, 5042, 6000, 491, 11533
BChannell, 1149, 51.7, 681, 681, 41, 1403
bcpftw, 1337, 43.8, 771, 502, 44, 1317
BDavies, 1215, 103.9, 71, 129, 3, 203
bdawg, 1027, 91.0, 2965, 2304, 142, 5411
BDDB, 1313, 46.7, 4824, 7864, 800, 13488
bddcdj, 1130, 34.0, 7272, 5354, 200, 12826
BDelaney, 1221, 44.6, 1413, 906, 91, 2410
Bdellovibrio, 1274, 87.0, 2271, 2565, 127, 4963
Bdgsurgeon, 1170, 47.3, 719, 765, 31, 1515
bdiller, 1825, 25.0, 26077, 32677, 2088, 60842
BDMCHESS, 1119, 54.4, 632, 879, 104, 1615
bdwyer, 1093, 60.0, 1532, 1694, 143, 3369
bdzim, 1197, 26.8, 602, 570, 49, 1221
Beakjerky, 540, 92.1, 39, 205, 2, 246
Beakov, 1394, 41.4, 4186, 4948, 344, 9478
beakyou, 1063, 37.5, 1592, 2998, 108, 4698
BearBear, 1516, 65.2, 275, 258, 24, 557
Bearfan, 1177, 167.0, 113, 162, 7, 282
beargrylls, 1793, 32.7, 1819, 1891, 149, 3859
BearSkee, 1234, 30.3, 5211, 5188, 288, 10687
bearwulf, 1435, 42.6, 497, 316, 25, 838
BEASTX, 1570, 68.7, 297, 141, 14, 452
beatenup, 1542, 42.2, 1284, 761, 191, 2236
BeauBella, 1487, 25.2, 1487, 1269, 77, 2833
beaudenon, 1030, 57.9, 164, 256, 10, 430
BeautifulChess, 1249, 38.4, 367, 372, 28, 767
Beb, 1199, 18.3, 10511, 13728, 611, 24850
becarb, 1774, 29.5, 1615, 1979, 234, 3828
beckley, 1247, 75.0, 103, 70, 8, 181
Bedreddin, 1731, 31.5, 1721, 1822, 226, 3769
BEEB, 1248, 34.1, 930, 814, 59, 1803
beefa, 1210, 53.0, 4342, 2052, 181, 6575
beejai, 1662, 72.2, 13357, 7717, 636, 21710
Beepers, 1289, 51.2, 996, 983, 74, 2053
BeerMuscles, 1463, 124.7, 319, 302, 32, 653
BEEROBOT, 1197, 27.0, 14818, 14742, 2042, 31602
beersheva, 1719, 46.9, 2364, 2200, 356, 4920
beforecrying, 1760, 119.0, 289, 282, 31, 602
Beg, 1231, 39.2, 94, 325, 10, 429
Begoner, 1838, 31.6, 14702, 5096, 883, 20681
begreen, 866, 96.0, 52, 163, 4, 219
begunner, 1308, 18.1, 746, 693, 24, 1463
Bejoymathew, 1276, 127.1, 7, 10, 0, 17
bekker, 1710, 62.7, 572, 442, 73, 1087, 1940, 104.4, 15774, 13082, 2559, 31415
Belamont, 1416, 56.9, 384, 559, 32, 975
bellabonzo, 1693, 127.0, 747, 454, 82, 1283
bellacasso, 1106, 102.0, 4, 11, 0, 15
Bellaco, 1182, 44.2, 1886, 1930, 171, 3987
Bellcross, 1488, 38.8, 348, 244, 28, 620
bellguy, 1593, 142.8, 1684, 1642, 115, 3441
BelliloisDeBase, 1498, 29.5, 13527, 7887, 485, 21899
Beltser, 1264, 74.9, 101, 103, 6, 210
Belua, 1449, 34.0, 3258, 2419, 224, 5901
Bemildred, 1464, 128.3, 400, 225, 30, 655
benborden, 1352, 211.7, 1, 3, 0, 4
Bencci, 1819, 68.0, 107, 118, 13, 238
Bendare, 881, 80.5, 26, 39, 0, 65
BeneathBlue, 1498, 47.2, 415, 244, 28, 687
benedictus, 1233, 36.8, 3423, 5715, 323, 9461
Benediktplayer, 1624, 45.6, 283, 335, 25, 643
benfish, 1341, 292.0, 1, 1, 0, 2
bengalbh, 710, 137.7, 2, 38, 1, 41
Benitovsky, 1642, 91.8, 897, 849, 83, 1829
benjaminduensing, 1026, 138.3, 82, 117, 10, 209
Benjamzalot, 1299, 80.9, 2726, 3106, 292, 6124
benjik, 1132, 70.1, 50, 109, 2, 161
benjor, 1349, 43.6, 1958, 1987, 201, 4146
Benjusin, 826, 133.9, 1, 8, 0, 9
bennynovik, 1882, 293.2, 1, 0, 0, 1
benoco, 1080, 350.0, 0, 1, 0, 1
benoitsky, 1615, 32.3, 2851, 3387, 329, 6567
Bensei, 968, 56.7, 17, 61, 0, 78
Benson, 2088, 350.0, 5, 3, 1, 9
benthurston, 1025, 227.9, 1, 6, 0, 7
bentway, 1195, 42.2, 756, 571, 55, 1382
benyaakov, 1375, 51.2, 695, 945, 69, 1709
BEO, 1828, 37.9, 8002, 6278, 926, 15206
beow, 1817, 24.8, 256, 500, 29, 785
beppie, 1834, 29.1, 3587, 3685, 313, 7585
bepthree, 755, 109.0, 42, 126, 9, 177
Berambulator, 1450, 60.9, 2011, 2118, 173, 4302
Beregond, 988, 115.2, 1184, 1403, 71, 2658
Bergel, 2163, 50.7, 1410, 566, 112, 2088
bergeruw, 1166, 38.4, 4225, 2183, 165, 6573
Berig, 1744, 35.4, 980, 956, 114, 2050
berlinman, 1736, 31.5, 1655, 2244, 242, 4141
Bernardbovy, 1443, 31.2, 1373, 1470, 188, 3031
bernardtan, 1581, 38.8, 2633, 2892, 501, 6026
bernhilz, 1295, 42.5, 2691, 4306, 297, 7294
Berp, 1669, 85.0, 366, 232, 47, 645
berserkergang, 1479, 35.0, 370, 555, 60, 985
BERTA, 1760, 122.5, 284, 120, 9, 413
BertiBen, 1291, 33.4, 3188, 4582, 196, 7966
Bertl, 1563, 28.6, 17018, 11622, 1320, 29960
BertoltBrecht, 800, 52.0, 71, 235, 1, 307
Bertoplamus, 1146, 55.3, 1557, 2326, 129, 4012
bertschi, 965, 50.6, 60, 99, 7, 166
berzerkly, 1669, 49.8, 2347, 960, 110, 3417
besenstiel, 1463, 81.8, 3695, 5202, 698, 9595
Besta, 1414, 30.2, 1782, 1869, 106, 3757
bestbytest, 1715, 116.5, 668, 296, 23, 987
BestOfTexas, 1225, 63.2, 102, 161, 10, 273
besugo, 1426, 29.5, 9482, 4171, 672, 14325
betaben, 1505, 26.6, 10766, 10814, 860, 22440
betancourt, 1428, 83.1, 623, 766, 60, 1449
BetaVersion, 1280, 37.1, 602, 544, 39, 1185
Betin, 1579, 51.2, 1069, 1099, 167, 2335
Betis, 1851, 21.6, 1021, 809, 129, 1959
beto, 1363, 55.9, 2140, 2348, 169, 4657
BETOMEX, 1119, 42.2, 398, 361, 32, 791
BetoScaramal, 1626, 33.9, 1101, 818, 70, 1989
betro, 817, 88.0, 6, 66, 0, 72
bevincass, 1588, 156.4, 158, 45, 7, 210
Bevs, 1591, 28.9, 4900, 3953, 350, 9203
bewareofme, 1150, 66.0, 228, 385, 25, 638
BewildaBeast, 1478, 32.8, 1020, 684, 90, 1794
beyadika, 1086, 159.8, 4, 7, 0, 11
Beyatch, 1709, 23.7, 2868, 3127, 621, 6616
Beyonder, 1514, 46.0, 4116, 4019, 396, 8531
beyondillusion, 997, 33.9, 518, 1361, 47, 1926
BeyondSky, 1407, 19.9, 5960, 8316, 209, 14485
Bezeal, 2362, 50.9, 198, 69, 12, 279
Bezemsteel, 1905, 95.8, 355, 108, 21, 484
bezzyFourteen, 1319, 76.2, 19, 20, 1, 40
bfnd, 1664, 24.9, 4195, 4137, 194, 8526
bfris, 974, 38.9, 1746, 1963, 174, 3883
BFskinr, 1459, 44.1, 1122, 1580, 104, 2806
Bgone, 1471, 220.4, 3, 1, 1, 5
bgpinball, 1658, 25.7, 38410, 20891, 2969, 62270
bgvlad, 1042, 292.6, 0, 2, 0, 2
Bhairav, 972, 149.3, 28, 46, 0, 74
bharathumasankar, 1419, 31.5, 2754, 3431, 188, 6373
bharati, 1478, 121.2, 91, 95, 4, 190
bharti, 1629, 30.2, 3783, 3482, 231, 7496
bhatiagirish, 1202, 47.7, 2219, 2733, 102, 5054
bhguey, 1405, 21.2, 1799, 2361, 125, 4285
bhimster, 1832, 238.1, 8144, 9884, 1323, 19351
Bhoirav, 1086, 44.3, 219, 371, 15, 605
bholamoira, 1003, 69.3, 158, 404, 11, 573
Bhrugu, 1284, 113.7, 71, 87, 2, 160
BHuMAHuE, 1190, 25.0, 484, 451, 25, 960
BHZ, 1255, 38.3, 185, 179, 13, 377
bianchimani, 1222, 33.3, 885, 961, 146, 1992
BianKaKing, 1132, 170.0, 4, 7, 0, 11
biased, 1209, 100.6, 77, 164, 8, 249
bibleman, 1405, 156.7, 391, 428, 20, 839
Bicchi, 1383, 35.6, 8722, 6099, 478, 15299
biche, 940, 27.5, 2085, 4345, 439, 6869
bielcoz, 1281, 104.8, 109, 141, 6, 256
Bielefeld, 1120, 36.0, 2093, 2178, 123, 4394
BiffRoy, 1208, 83.4, 108, 275, 17, 400
bigaitch, 1455, 47.0, 1012, 296, 163, 1471
bigaveli, 1202, 58.2, 208, 349, 18, 575
bigblanko, 904, 88.8, 7, 17, 0, 24
bigchip, 1241, 70.0, 3084, 2406, 211, 5701
BigDaddyCheckmate, 1446, 39.8, 156, 147, 10, 313
bigdonkey, 1962, 103.6, 2601, 1406, 401, 4408
bigfacerec, 1158, 37.6, 2226, 2864, 211, 5301
bigfer, 977, 137.7, 27, 45, 1, 73
Biggafigga, 1195, 36.8, 2774, 3800, 266, 6840
biggerFishy, 1148, 132.5, 505, 576, 26, 1107
biggerr, 1315, 38.6, 53, 83, 3, 139
Biggly, 1094, 75.2, 307, 423, 15, 745
biggypaul, 1732, 29.8, 2934, 3067, 346, 6347
BigmacJ, 1519, 42.8, 1471, 1672, 102, 3245
BigMacTruck, 1430, 76.4, 207, 123, 10, 340
Bigmouthfrog, 1316, 45.4, 1311, 1504, 154, 2969
bigmtnskierx, 1133, 70.9, 334, 306, 25, 665
BigOlFish, 1131, 272.4, 580, 688, 65, 1333
Bigphat, 886, 109.6, 13, 14, 2, 29
bigpoint, 1234, 40.3, 5155, 10127, 815, 16097
BigQman, 1337, 23.6, 7722, 8741, 417, 16880
BigSid, 1604, 24.5, 12911, 10946, 1312, 25169
BigSky, 1897, 27.6, 18475, 15321, 2865, 36661
bigtruckrida, 830, 126.3, 6, 25, 1, 32
BigulaMor, 1339, 168.7, 325, 621, 16, 962
Bigulim, 1066, 106.9, 621, 921, 28, 1570
BiH, 1548, 22.1, 10208, 12747, 698, 23653
BijuKeralaINDIAN, 1600, 35.0, 2007, 2449, 188, 4644
bikica, 1041, 75.6, 283, 641, 33, 957
BilboBag, 958, 230.7, 0, 4, 0, 4
bilca, 1568, 31.9, 4123, 2966, 370, 7459
bilichi, 1099, 107.6, 2, 9, 0, 11
Biliu, 1281, 40.1, 1063, 1163, 71, 2297
BillChenPoker, 1439, 139.8, 9, 21, 1, 31
billcp, 911, 77.6, 9, 28, 0, 37
billig, 1565, 33.4, 11330, 8600, 555, 20485
billllbo, 1247, 27.2, 1193, 1122, 132, 2447
Billoboy, 1447, 27.9, 1811, 1635, 62, 3508
billRoca, 1357, 43.3, 3031, 3074, 283, 6388
Billroth, 1403, 26.1, 2523, 3723, 347, 6593
BillSykes, 2134, 141.0, 18369, 14184, 2287, 34840
BillyBatson, 1795, 24.5, 373, 381, 75, 829
billychess, 1167, 37.6, 1016, 1018, 44, 2078
billycollierIII, 992, 34.9, 277, 549, 6, 832
BillyJoel, 1655, 99.9, 1145, 1015, 136, 2296
billyjoetuck, 798, 102.5, 5, 22, 0, 27
BILLYSUNDAY, 1178, 130.3, 2017, 2663, 76, 4756
bilybob, 900, 41.1, 136, 278, 9, 423
bimasakti, 1744, 23.3, 633, 827, 57, 1517
bimbus, 825, 121.0, 31, 77, 1, 109
Bimmy, 1744, 23.6, 7570, 8720, 567, 16857
binoche, 1713, 25.6, 6460, 7749, 938, 15147
BIONCHESS, 1422, 143.5, 14, 6, 1, 21
biondy, 988, 92.0, 21, 73, 0, 94
bionic, 1493, 44.9, 4589, 4249, 469, 9307
biotdi, 1454, 33.9, 3309, 2729, 123, 6161
bipedo, 1512, 22.4, 9338, 12961, 533, 22832
bipsman, 1481, 43.4, 3738, 3384, 322, 7444
Birdcatcher, 1432, 93.9, 70, 84, 2, 156
birdingbri, 1084, 123.6, 5, 5, 1, 11
birkus, 1466, 34.0, 4692, 7651, 974, 13317
biryuk, 1292, 61.3, 1055, 901, 127, 2083
bishaftu, 1657, 33.4, 3170, 2288, 119, 5577
bishopbebop, 996, 56.4, 19, 45, 4, 68
BishopBludgeon, 1454, 91.0, 108, 56, 4, 168
bishopbuster, 1083, 56.9, 27, 37, 3, 67
BishopbyTrade, 1504, 32.0, 12774, 11046, 1038, 24858
bishopfix, 953, 77.9, 16, 36, 1, 53
bishopjones, 1375, 29.5, 5317, 5073, 176, 10566
bishopsac, 1999, 88.4, 5085, 1838, 326, 7249
bishopsd, 1112, 53.1, 218, 341, 10, 569
BishopsGambit, 1279, 52.6, 220, 221, 15, 456
bishoptakesknight, 1367, 38.6, 95, 139, 5, 239
bistar, 1737, 74.8, 12969, 8192, 1068, 22229
Biting, 1738, 253.1, 3, 1, 0, 4
Bitinio, 1475, 30.5, 806, 423, 41, 1270
BitsandBytes, 1323, 23.8, 659, 1136, 73, 1868
Bitvonnik, 1365, 37.0, 173, 118, 8, 299
bizarro, 1158, 74.0, 1156, 1891, 61, 3108
Bjana, 1552, 50.0, 22, 142, 4, 168
BJCAS, 1259, 33.5, 1585, 1137, 36, 2758
Bjornar, 1370, 96.4, 815, 831, 125, 1771
bjorsa, 1603, 28.4, 1482, 1668, 155, 3305
bjs, 1672, 47.0, 5941, 3665, 582, 10188
bkaiser, 1166, 36.0, 3691, 3063, 312, 7066
bkarsten, 995, 296.7, 0, 2, 0, 2
bkmiictian, 1209, 61.0, 279, 457, 28, 764
bktattack, 1501, 31.9, 555, 378, 55, 988
bkvt, 1472, 43.7, 388, 539, 43, 970
Bkyong, 1349, 86.4, 220, 184, 12, 416
blackace, 1228, 119.7, 27, 40, 2, 69
BLACKATTACK, 1723, 25.6, 5215, 6607, 336, 12158
blackayo, 1230, 166.1, 3, 4, 0, 7
Blackball, 1265, 34.9, 2106, 2349, 221, 4676
blackbolt, 1532, 110.1, 911, 757, 75, 1743
BLACKCATS, 1109, 45.4, 6378, 9207, 341, 15926
BlackCatTino, 1017, 105.3, 36, 101, 1, 138
BlackCherry, 1534, 95.9, 72, 46, 2, 120
Blackcomb, 1498, 64.8, 647, 1069, 194, 1910
BlackDay, 1413, 87.0, 3817, 4984, 501, 9302
blackdogranch, 1261, 32.9, 955, 1142, 112, 2209
blackfactor, 834, 241.0, 3, 12, 0, 15
blackfeather, 1648, 119.3, 167, 119, 11, 297
blackforcemetodic, 1321, 107.5, 34, 40, 4, 78
blackicehawk, 1147, 38.4, 577, 1027, 59, 1663
BlackKnightZa, 1279, 39.2, 1378, 1167, 70, 2615
BlackLingo, 1191, 61.2, 1313, 1265, 91, 2669
blacklove, 717, 69.3, 22, 149, 0, 171
blackmale, 1014, 42.9, 39, 62, 0, 101
BlacKnights, 1358, 36.2, 818, 1523, 78, 2419
blackrhino, 1240, 52.3, 1267, 1093, 136, 2496
BlackSand, 1391, 84.1, 386, 287, 37, 710
Blacksburg, 1265, 36.0, 317, 435, 14, 766
BlackSpy, 1129, 27.9, 278, 484, 18, 780
BlackWhite, 1344, 39.6, 3020, 4555, 326, 7901
blackwitch, 1239, 81.8, 202, 73, 16, 291
BlackxStar, 1197, 71.2, 174, 338, 13, 525
bladebob, 1233, 54.8, 124, 158, 7, 289
BladeCreed, 811, 74.0, 124, 789, 7, 920
Blaine, 1360, 210.8, 10, 7, 1, 18
Blakeos, 1357, 103.0, 2632, 1625, 157, 4414
Blakhorse, 1882, 22.1, 8557, 12599, 869, 22025
blamag, 1402, 46.2, 4067, 5254, 364, 9685
blanci, 1400, 37.7, 4388, 3642, 404, 8434
blankeehater, 1056, 119.7, 17, 64, 2, 83
Blanson, 925, 86.6, 75, 114, 8, 197
blastol, 1926, 98.8, 4855, 4643, 343, 9841
Blazedchess, 1129, 31.9, 137, 181, 6, 324
blazeup, 1363, 199.9, 0, 4, 0, 4
Blazey, 1481, 65.7, 393, 297, 31, 721
blcrcktt, 1220, 50.9, 1208, 639, 32, 1879
Bleeb, 1901, 25.5, 5304, 1291, 306, 6901
blerg, 1429, 39.4, 5989, 5746, 466, 12201, 1873, 92.2, 295, 178, 34, 507
blindedsun, 1446, 138.3, 9, 17, 2, 28, 1526, 80.8, 134, 116, 16, 266
blindlead, 1358, 114.4, 1445, 1213, 90, 2748
BlindLeadingBlind, 1499, 38.1, 2455, 1941, 229, 4625, 1159, 244.7, 25, 66, 3, 94
BlindRobot, 1906, 75.3, 4496, 3064, 314, 7874
Blinkeedotcom, 1256, 27.3, 1102, 1105, 84, 2291
Blittzin, 1654, 111.7, 497, 399, 40, 936
Blitzdoc, , , , , , , 1791, 41.4, 9964, 3598, 409, 13971
Blitzeppelin, , , , , , , 997, 65.9, 172, 221, 7, 400
BlitzerYeah, , , , , , , 1470, 35.5, 2254, 1602, 131, 3987
Blitzkriegbop, , , , , , , 1395, 29.1, 2267, 3750, 287, 6304
blitzmonster, 1337, 31.0, 2784, 2327, 335, 5446
Blitzt, , , , , , , 983, 71.4, 111, 285, 6, 402
BlitzThree, , , , , , , 1563, 218.2, 4076, 3566, 441, 8083
blitzVader, 1637, 30.8, 3021, 1641, 306, 4968
BlkSabb, 1625, 26.4, 3304, 3586, 363, 7253
blobcutie, 1140, 39.5, 1157, 1487, 74, 2718
blokeinVA, 900, 132.1, 2, 10, 1, 13
Blondie, 1503, 37.3, 270, 194, 16, 480
bloodge, 1535, 47.6, 134, 141, 17, 292
BloodyBob, 1619, 25.9, 297, 312, 23, 632
bloomer, 1375, 59.9, 2971, 3899, 268, 7138
blore, 1736, 21.7, 30932, 17728, 3304, 51964
blssurfer, 1271, 45.7, 3232, 3603, 299, 7134
BlueandWhite, 1764, 32.5, 4227, 3834, 411, 8472
BlueBanana, 1780, 96.0, 6625, 7569, 560, 14754
BlueBishop, 1358, 33.9, 6253, 5915, 477, 12645
BluebloodedHunk, 809, 77.7, 52, 270, 6, 328
blueboogie, 1305, 79.1, 602, 450, 25, 1077
bluedevels, 1088, 68.7, 1893, 4097, 282, 6272
BlueElf, 1055, 59.3, 2749, 1883, 332, 4964
blueeyoe, 1412, 27.1, 1976, 1749, 145, 3870
bluefrenk, 1577, 81.2, 83, 59, 5, 147
bluegibson, 1766, 64.3, 5783, 3961, 951, 10695
bluegreenz, 1523, 64.9, 17, 33, 5, 55
BlueLogic, 2070, 70.6, 968, 1918, 124, 3010
bluelotus, 1211, 26.4, 1467, 1752, 52, 3271
bluemovemaker, 991, 110.4, 33, 158, 3, 194
bluepisces, 1646, 34.3, 818, 1131, 104, 2053
Bluerabbit, 1431, 31.7, 10119, 9157, 402, 19678
bluesuede, 1142, 53.5, 3328, 3136, 202, 6666
Blunderboyster, 1250, 148.7, 344, 302, 20, 666
Blunderdome, 1516, 24.7, 3212, 2874, 452, 6538
BlunderlowBill, 1885, 51.8, 810, 646, 58, 1514
BlunderOften, 1221, 148.2, 6, 13, 1, 20
blusiryn, 1041, 61.3, 44, 48, 1, 93
bmansvette, 1029, 80.1, 192, 450, 5, 647
bmccchess, 1134, 339.4, 0, 1, 0, 1
bmcully, 1094, 40.4, 124, 129, 11, 264
bmeeks, 1052, 205.7, 0, 4, 0, 4
BMFR, 1503, 26.9, 10050, 8386, 758, 19194
BMiddleton, 1057, 169.3, 1, 8, 0, 9
BMills, 718, 248.1, 0, 3, 0, 3
bmiyc, 1267, 68.9, 928, 1431, 68, 2427
BMO, 1749, 33.4, 14901, 9755, 1306, 25962
bmonkey, 1454, 61.2, 544, 414, 26, 984
bmpascoguin, 1392, 93.6, 1034, 860, 51, 1945
bnn, 1421, 25.9, 16299, 11036, 375, 27710
boardbosstwo, 1009, 97.8, 73, 115, 4, 192
boardquake, 1767, 350.0, 26, 19, 3, 48
BobbyNoblitt, 1234, 112.1, 614, 356, 74, 1044
Bobbyreal, 2248, 35.5, 2503, 838, 327, 3668
bobbythegreatest, 1524, 27.9, 1360, 489, 192, 2041
Bobbyw, 1407, 51.5, 44, 34, 2, 80
bobclay, 1824, 25.6, 3453, 3886, 546, 7885
bobetko, 1167, 44.6, 644, 991, 58, 1693
bobflanagan, 1162, 47.1, 125, 108, 11, 244
bobhill, 1629, 73.1, 3297, 4217, 485, 7999
bobjay, 1190, 27.8, 6557, 5937, 604, 13098
BOBLOVE, 1705, 33.0, 2158, 3177, 264, 5599
Bobok, 1444, 24.7, 1438, 1236, 89, 2763
BoboKek, 1104, 29.4, 802, 1674, 44, 2520
BobsChessChamp, 980, 47.9, 222, 479, 24, 725
bobscreech, 1439, 44.4, 203, 258, 19, 480
Bobsh, 870, 117.1, 311, 1345, 10, 1666
BOBSHOOK, 1078, 170.9, 5, 4, 0, 9
bobsongtan, 1619, 23.7, 6735, 4528, 630, 11893
Bobtzu, 1356, 59.4, 139, 94, 12, 245
bobvancan, 1092, 53.0, 814, 1145, 27, 1986
Bocharoja, 1427, 44.1, 796, 566, 75, 1437
bockle, 711, 131.9, 2, 21, 0, 23
Bodegroes, 1155, 29.8, 4108, 4085, 352, 8545
bodiddlee, 1400, 48.0, 2604, 3917, 250, 6771
bodom, 1049, 43.2, 502, 601, 58, 1161
Bodur, 1189, 29.7, 1144, 1307, 57, 2508, 1933, 42.1, 1444, 1185, 191, 2820
Boeketstraat, 1641, 32.8, 7035, 4491, 481, 12007
Boethius, 1445, 49.1, 3041, 4247, 388, 7676
BOGGLE, 1318, 39.0, 8236, 5536, 393, 14165
boggus, 1515, 25.7, 14595, 10775, 1179, 26549
bOgui, 1074, 51.5, 1161, 4016, 124, 5301
bogusz, 1229, 32.9, 21480, 25956, 1963, 49399
Bohan, 1568, 46.7, 2277, 1972, 217, 4466
bohnster, 1018, 65.1, 1235, 1291, 64, 2590
bohort, 1116, 26.6, 700, 1021, 84, 1805
boiler, 1814, 28.2, 14906, 17166, 2875, 34947
boinaverde, 1430, 29.7, 11580, 10833, 1106, 23519
boingo, 1306, 34.9, 5202, 7326, 453, 12981
boitshepo, 1165, 28.7, 430, 743, 19, 1192
bokertov, 1537, 98.9, 107, 37, 8, 152
bokken, 1571, 24.7, 23687, 19718, 2660, 46065
Bokononist, 1010, 176.6, 2, 6, 0, 8
bokuto, 1052, 36.2, 417, 1044, 60, 1521
Boldmann, 1069, 183.0, 22, 33, 1, 56
bolete, 1300, 122.3, 91, 115, 8, 214
bolio, 706, 136.7, 21, 100, 2, 123
Boltfan, 1957, 27.3, 1890, 1202, 139, 3231
bolzon, 1430, 51.4, 341, 114, 19, 474
bombardeio, 1333, 36.7, 421, 296, 24, 741
bomboloncammello, 1189, 25.3, 330, 342, 21, 693
bombordir, 1249, 225.4, 0, 2, 0, 2
bonapart, 1622, 29.8, 8420, 9167, 880, 18467
bonch, 1763, 67.4, 7764, 5188, 522, 13474
bondebonde, 1134, 75.8, 464, 631, 22, 1117
bondu, 1226, 49.6, 1039, 2100, 44, 3183
BONH, 918, 21.6, 34623, 53436, 3802, 91861
bonillaice, 1407, 64.2, 2132, 2978, 216, 5326
Bonolo, 1132, 130.3, 2, 17, 0, 19
BonusSocius, 1204, 36.4, 318, 263, 25, 606
booaoogoo, 1003, 92.7, 214, 238, 10, 462
boodeli, 973, 73.4, 339, 304, 15, 658
boogrizzle, 1223, 46.5, 858, 846, 53, 1757
Bookmarked, 1295, 47.6, 142, 121, 7, 270
Boolin, 974, 115.9, 57, 98, 1, 156
boomboomroom, 1096, 89.2, 166, 118, 3, 287
booneesh, 780, 159.6, 2, 10, 1, 13
bootlegblotto, 916, 200.5, 0, 5, 0, 5
Bootvis, 1462, 52.3, 2655, 1822, 197, 4674
bootytalk, 1251, 73.7, 15, 117, 1, 133
BopoH, 1239, 56.0, 289, 435, 15, 739
Boran, 1374, 97.6, 8686, 19466, 1175, 29327
boredsilly, 1374, 197.6, 1, 3, 0, 4
Borgite, 1559, 27.8, 954, 1047, 93, 2094
borgonov, 909, 104.5, 5, 18, 2, 25
borisak, 1558, 28.2, 6897, 7874, 965, 15736
BorisFromRussia, 1208, 39.0, 409, 388, 29, 826
BorisG, 1253, 247.9, 15, 42, 2, 59
Borke, 1117, 37.3, 374, 249, 17, 640
Bornsch, 1391, 38.4, 5102, 5055, 344, 10501
borokov, 1123, 28.3, 1798, 1160, 59, 3017
Borsa, 1309, 29.9, 6981, 5808, 411, 13200
borshik, 1661, 93.1, 132, 180, 11, 323
Bosanquet, 1392, 105.0, 458, 480, 40, 978
bosconiovitch, 1326, 52.6, 76, 60, 2, 138
boscorelli, 1651, 74.3, 367, 182, 23, 572
boskey, 1166, 54.0, 226, 257, 24, 507
bossmanforlife, 1031, 41.7, 403, 930, 23, 1356
Bosssssss, 1128, 87.7, 16, 138, 5, 159
botchvinik, 1498, 54.7, 2513, 3318, 342, 6173
BothFeet, 942, 60.8, 1310, 2837, 87, 4234
bottini, 1799, 43.3, 7983, 8193, 1368, 17544
Bouakeo, 1056, 97.9, 41, 49, 0, 90
Bouchala, 1282, 31.6, 2386, 2731, 305, 5422
Bouncer, 1580, 30.5, 8963, 8752, 966, 18681
bourgas, 1808, 47.4, 6054, 3879, 666, 10599
BourneMan, 1481, 42.3, 3964, 342, 32, 4338
bovoaruba, 1558, 23.0, 2223, 1864, 141, 4228
bowi, 1568, 32.0, 1141, 1124, 99, 2364
bowlvi, 1280, 26.4, 7087, 9222, 323, 16632
boxturtle, 818, 54.5, 94, 340, 6, 440
boxwalla, 1050, 79.7, 244, 284, 26, 554
boxy, 1661, 22.3, 9636, 6577, 680, 16893
boygipit, 1781, 31.6, 1451, 1862, 105, 3418
Bozzka, 1360, 42.8, 352, 372, 29, 753
BQueezy, 1292, 47.3, 178, 181, 10, 369
bracalov, 1704, 33.5, 8379, 3250, 614, 12243
Bracon, 1290, 30.6, 5020, 6925, 610, 12555
bracyr, 1345, 337.7, 1774, 2096, 157, 4027
bradipo, 1490, 227.0, 440, 343, 37, 820
brahames, 1489, 23.0, 1116, 1341, 101, 2558
BrahmanYogi, 771, 141.8, 2, 10, 0, 12
brainybrawler, 1026, 132.1, 38, 89, 0, 127
BrakeOff, 1288, 29.6, 3185, 4560, 419, 8164
Brakey, 1235, 36.1, 1593, 2070, 118, 3781
brana, 1634, 26.6, 1182, 1160, 71, 2413
Brandesian, 1269, 42.5, 2136, 1760, 212, 4108
brandnothing, 1353, 31.4, 1719, 2328, 122, 4169
Brandoch, 1522, 24.6, 2571, 2294, 160, 5025
brandonn, 1447, 48.4, 3711, 4028, 206, 7945
brandx, 1214, 84.7, 1120, 1914, 162, 3196
Brantfany, 1663, 33.3, 570, 244, 22, 836
brasilianchess, 1352, 84.3, 137, 72, 23, 232
BraveBishop, 1440, 31.3, 670, 869, 68, 1607
braveking, 1511, 122.2, 5349, 5982, 323, 11654
bravoshark, 839, 54.0, 184, 414, 15, 613
Brazof, 1841, 141.0, 728, 319, 60, 1107
brazorf, 1553, 35.7, 4236, 2653, 243, 7132
brazucanl, 1233, 24.6, 2458, 2705, 34, 5197
brdytoloose, 1211, 51.3, 1202, 1810, 82, 3094
BREAKOUDOWN, 1197, 315.6, 0, 1, 0, 1
brenobf, 993, 247.2, 0, 3, 0, 3
BrettBinns, 1046, 144.6, 15, 29, 0, 44
brettdj, 1514, 57.0, 1998, 2601, 165, 4764
brettfavre, 1262, 119.3, 183, 380, 14, 577
BrewersGambit, 1120, 94.1, 21, 16, 1, 38
brews, 1602, 51.6, 14972, 16438, 1432, 32842
BrianGallagher, 1658, 70.4, 3868, 1453, 386, 5707
Brief, 1572, 33.9, 2779, 2701, 225, 5705
BriFri, 1063, 75.7, 23, 51, 4, 78
briga, 895, 112.9, 2, 12, 0, 14
brigante, 1502, 114.7, 5722, 3406, 296, 9424
brighterspot, 1354, 32.6, 11869, 7172, 788, 19829
BrightMoments, 1350, 128.9, 438, 609, 44, 1091
brigwag, 1524, 43.7, 573, 389, 69, 1031
Brillianov, 1727, 56.6, 34, 51, 5, 90
brilliantankit, 1504, 83.1, 6, 38, 2, 46
Brillig, 1063, 48.9, 2166, 2732, 315, 5213
Bringarov, 1769, 31.7, 2972, 1715, 213, 4900
Bristols, 1113, 82.6, 39, 48, 3, 90
brittaundvolker, 1340, 33.3, 3150, 4379, 184, 7713
BRKJ, 929, 49.5, 49, 119, 0, 168
brkla, 767, 132.8, 11, 134, 0, 145
brnirmala, 1033, 35.6, 1594, 2403, 187, 4184
brobdingnag, 1649, 92.8, 275, 276, 53, 604
Brode, 1425, 29.2, 2354, 1614, 148, 4116
Broinvestments, 1009, 114.0, 5, 17, 0, 22
brokenclock, 1822, 28.0, 4702, 4565, 538, 9805
BrokenNeck, 1793, 31.6, 1864, 1687, 178, 3729
bromantel, 1365, 36.9, 5012, 4191, 225, 9428
bromelie, 1626, 24.5, 8105, 4138, 542, 12785
bromineguy, 994, 237.8, 0, 2, 0, 2
broncho, 1153, 101.0, 13, 96, 0, 109
broncobakhos, 1390, 23.9, 411, 656, 39, 1106
bronsteen, 1295, 83.8, 16, 28, 1, 45
bronsteina, 1256, 35.6, 1244, 2375, 140, 3759
BronsteinTheBest, 1516, 29.2, 1017, 1010, 99, 2126
bronteSS, 1434, 83.7, 2899, 3283, 403, 6585
BronxWD, 1361, 45.6, 374, 455, 41, 870
Brony, 1395, 36.7, 4607, 4954, 337, 9898
BrooklynGeneral, 890, 111.1, 21, 54, 1, 76
broom, 1905, 49.1, 20368, 18938, 2355, 41661
Broose, 730, 94.2, 5, 46, 0, 51
BrorJace, 1318, 44.1, 535, 412, 53, 1000
BrosKaramazov, 1313, 131.6, 111, 182, 11, 304
brouchek, 1655, 122.1, 4078, 2906, 302, 7286
Browbeater, 1638, 25.8, 6439, 7041, 438, 13918
Brown, 922, 198.2, 464, 498, 34, 996
brownpotato, 1503, 105.0, 73, 67, 3, 143
brrk, 1062, 124.6, 154, 224, 13, 391
brucebrucebruce, 807, 41.7, 140, 679, 14, 833
BrucyBaby, 1220, 104.3, 347, 283, 26, 656
bruegel, 1701, 56.5, 2326, 2537, 208, 5071
bruhane, 1444, 22.7, 626, 660, 40, 1326
brukha, 1215, 86.6, 238, 278, 22, 538
brumpfschmlog, 1314, 30.2, 3907, 5067, 277, 9251
BrunAlves, 1367, 63.0, 497, 615, 61, 1173
brunftbert, 1437, 26.0, 11863, 8002, 931, 20796
BrunoBommel, 1897, 33.2, 449, 371, 47, 867
brunopucp, 1274, 66.5, 79, 109, 4, 192
brunosa, 1087, 131.2, 26, 25, 1, 52
brusqplay, 1566, 115.2, 12191, 15702, 651, 28544
bryanmiller, 1125, 50.9, 102, 82, 3, 187
bryantbabin, 1144, 39.7, 431, 775, 20, 1226
BryantPark, 1456, 46.6, 1251, 1508, 121, 2880
brzi, 1941, 54.3, 906, 637, 130, 1673
bsalvesen, 1115, 134.9, 112, 174, 15, 301
bsarado, 1969, 27.7, 4643, 3391, 683, 8717
bsenanayake, 1322, 24.3, 306, 466, 42, 814
BShubert, 1034, 137.1, 107, 182, 9, 298
bslavkov, 1772, 29.7, 9307, 1615, 355, 11277
bsliced, 947, 100.1, 734, 3363, 110, 4207
Bsmile, 1784, 32.5, 3710, 2663, 259, 6632
bspurlock, 1403, 56.8, 1500, 1264, 161, 2925
bstail, 992, 217.4, 0, 4, 0, 4
bsummer, 1574, 114.8, 9083, 7588, 480, 17151
bterzic, 1356, 30.4, 1438, 2804, 220, 4462
btmitchell, 1386, 41.0, 4217, 4598, 179, 8994
btrucker, 1355, 64.0, 483, 384, 39, 906
buceluis, 1196, 60.1, 232, 433, 21, 686
bucheron, 1657, 39.2, 8795, 9521, 745, 19061
Buckyball, 1287, 72.6, 1797, 1776, 328, 3901
bucwet, 807, 84.2, 16, 52, 1, 69
BudakBaong, 1430, 79.1, 406, 262, 30, 698
BuddahBelly, 1136, 89.9, 8, 12, 0, 20
Buddhahead, 1743, 37.3, 3945, 3760, 460, 8165
buddhu, 1330, 116.4, 8055, 7770, 466, 16291
buddyblack, 1114, 66.1, 140, 117, 4, 261
BuddyBooski, 691, 41.9, 47, 182, 2, 231
Buderim, 1011, 92.8, 420, 744, 24, 1188
BudFive, 1360, 36.6, 1192, 1337, 68, 2597
budikalahan, 1169, 178.4, 0, 7, 0, 7
Budster, 1200, 166.4, 2, 7, 1, 10
budzwayne, 1364, 80.3, 342, 136, 17, 495
buencat, 1749, 333.5, 1, 0, 0, 1
buenosaires, 1485, 30.5, 779, 1334, 71, 2184
buffalohead, 1268, 38.3, 1862, 1429, 103, 3394
BuffaloNYoUSA, 920, 78.7, 240, 274, 7, 521
buffito, 791, 197.7, 0, 7, 0, 7
BugBug, 1761, 82.3, 1781, 2373, 234, 4388
bugga, 1582, 169.1, 5, 5, 0, 10
BugHug, 998, 311.0, 0, 2, 0, 2, 2224, 66.2, 2716, 1170, 277, 4163
bukellas, 1232, 38.3, 245, 307, 27, 579
Bulawayo, 1341, 47.6, 3317, 3606, 214, 7137
bullant, 1143, 78.6, 192, 409, 52, 653
bullbuffalo, 1269, 36.6, 787, 1547, 34, 2368
BULLCRUSHER, 1268, 22.9, 2518, 5568, 113, 8199
Bullgullet, 1699, 86.2, 624, 540, 53, 1217
bullsnake, 1481, 24.1, 3112, 5387, 250, 8749
buln, 1168, 56.0, 2584, 3453, 270, 6307
bulonski, 1219, 48.8, 519, 713, 41, 1273
Bumhova, 1615, 42.4, 3544, 3356, 190, 7090
bungker, 1319, 94.7, 101, 527, 7, 635
bunicul, 1259, 24.7, 1655, 1972, 224, 3851
Buninyong, 1425, 35.0, 2754, 1364, 187, 4305
buniy, 1640, 69.7, 9439, 9691, 1096, 20226
Bunkbuster, 1781, 66.6, 321, 403, 53, 777
Bunkerman, 743, 96.9, 13, 65, 0, 78
Bunko, 1836, 97.1, 70, 22, 3, 95
bunzing, 1500, 44.7, 2077, 2391, 81, 4549
Burbel, 1219, 55.7, 932, 893, 44, 1869
burdoff, 1901, 51.4, 1494, 1760, 168, 3422
BurghBread, 1326, 46.7, 916, 1339, 57, 2312
Burlfish, 1127, 65.1, 241, 339, 7, 587
burraburra, 868, 130.7, 1208, 2325, 61, 3594
BurtForFun, 918, 34.5, 15955, 18512, 1170, 35637
burundanga, 1209, 116.1, 207, 214, 15, 436
BusDriver, 1623, 26.6, 25930, 25052, 2470, 53452
bushwhacked, 1066, 102.4, 552, 632, 33, 1217
Bushwhacker, 1048, 232.7, 13, 36, 1, 50
bushytail, 1363, 24.4, 7496, 7882, 760, 16138
buskingswami, 1236, 43.3, 1068, 861, 83, 2012
bust, 1425, 60.3, 3898, 3565, 703, 8166
BusyBug, 1231, 46.6, 205, 176, 13, 394
butiki, 1328, 42.5, 5677, 4790, 405, 10872
Butin, 954, 31.8, 1158, 2144, 77, 3379
buttbrain, 1427, 21.3, 2963, 2437, 198, 5598
buzdik, 1840, 25.5, 8592, 8209, 1594, 18395
Bvantage, 1085, 23.7, 2517, 2787, 99, 5403
Bvcaa, 801, 242.0, 0, 3, 0, 3
bvw, 1233, 81.2, 27, 35, 1, 63
BWare, 1341, 24.5, 1576, 1729, 108, 3413
BWLer, 1946, 40.1, 1391, 817, 237, 2445
bwoody, 939, 31.9, 352, 654, 18, 1024
ByAx, 1027, 45.9, 386, 583, 60, 1029
byknight, 1399, 91.2, 802, 1133, 142, 2077
BYOO, 734, 105.1, 49, 221, 4, 274, 1392, 36.4, 1965, 1493, 110, 3568
bzackay, 1308, 108.2, 70, 61, 6, 137
bzzzbz, 1294, 31.0, 4881, 3779, 461, 9121
Caballoquince, 1230, 22.6, 497, 533, 54, 1084
caballorey, 1144, 83.3, 4247, 2600, 214, 7061
Caballos, 1576, 91.3, 71, 55, 6, 132
cabayo, 1045, 95.8, 136, 263, 8, 407
Cabazorro, 1558, 120.1, 304, 407, 55, 766
cabba, 1345, 119.8, 29, 40, 0, 69
cabbagehead, 1692, 38.1, 4101, 3722, 290, 8113
cabeee, 1803, 138.8, 18, 23, 0, 41
cabemer, 775, 183.8, 0, 9, 0, 9
cabiron, 1574, 65.0, 1065, 1263, 88, 2416
cabrainvocado, 1210, 44.0, 484, 1360, 43, 1887
cabriceo, 1370, 27.1, 466, 972, 117, 1555
cacaso, 1313, 29.6, 850, 1092, 68, 2010
caculezinho, 1226, 55.9, 418, 512, 41, 971
CAdaddy, 1985, 39.5, 2873, 1483, 413, 4769
cadelgado, 1265, 36.6, 2941, 2463, 274, 5678
Cadeuses, 1402, 48.7, 744, 1139, 43, 1926
cadger, 1496, 45.5, 661, 568, 38, 1267
Caecielien, 1652, 27.7, 7139, 3927, 288, 11354
caesarax, 1226, 43.1, 98, 99, 10, 207, 1147, 93.4, 279, 764, 48, 1091
cagouille, 1318, 176.4, 158, 531, 21, 710
Cahhill, 1177, 108.2, 11, 31, 2, 44
cahmet, 822, 57.8, 23, 530, 2, 555
CaioBLank, 986, 102.6, 26, 52, 0, 78
caionov, 1156, 28.7, 3523, 5098, 398, 9019
CaiseNVant, 1072, 90.0, 449, 717, 35, 1201
CaissaLives, 1810, 28.1, 4322, 1914, 394, 6630
caitope, 1935, 120.7, 35, 29, 0, 64
Cakeovic, 1692, 94.6, 643, 710, 80, 1433
Calabanos, 1193, 67.0, 4691, 5887, 544, 11122
CalabiYau, 1417, 107.1, 1311, 1065, 136, 2512
calanan, 1531, 120.4, 1941, 383, 77, 2401
calcomar, 1338, 42.1, 44, 65, 8, 117
Calebboy, 1421, 23.9, 4149, 3147, 183, 7479
calexander, 1061, 28.9, 1836, 2043, 145, 4024
calibdus, 1283, 42.1, 389, 395, 22, 806
CalicoCat, 1462, 36.6, 6306, 2263, 269, 8838
californiakid, 666, 40.3, 112, 1015, 3, 1130
Californio, 1349, 21.9, 7465, 8253, 419, 16137
calmchess, 1181, 64.6, 1375, 2363, 124, 3862
calviniski, 1486, 200.6, 2, 3, 0, 5
Calx, 1498, 18.0, 28683, 30262, 3100, 62045
camblue, 1163, 50.5, 614, 470, 78, 1162
camerontcu, 1040, 52.7, 464, 625, 9, 1098
camiloasc, 1026, 93.5, 117, 202, 2, 321
Camjoy, 1328, 27.8, 2720, 3860, 689, 7269
camora, 1128, 105.4, 27, 82, 1, 110
campechess, 1205, 26.0, 480, 519, 26, 1025
campelo, 1886, 69.6, 18, 13, 3, 34
Campylobacter, 1521, 30.8, 4254, 6226, 713, 11193
Camray, 1544, 24.5, 4372, 4705, 328, 9405
camsarim, 1022, 143.9, 19, 27, 1, 47
Canadian, 1729, 88.6, 118, 88, 13, 219
canadianman, 1490, 36.8, 1147, 869, 106, 2122
Canadianpimp, 1353, 35.8, 286, 215, 14, 515
CanadianSerb, 1157, 39.4, 2275, 2460, 154, 4889
canallarc, 1266, 82.2, 56, 83, 2, 141
canariaptm, 1340, 35.7, 892, 696, 65, 1653
cancri, 1156, 43.9, 1518, 1709, 103, 3330
Candihapped, 1035, 119.0, 72, 91, 6, 169
CandleKnight, 1758, 57.9, 9026, 9971, 686, 19683
candoattitude, 869, 160.9, 0, 10, 0, 10
CandyFloss, 1046, 32.2, 3879, 9144, 178, 13201
canio, 1276, 18.1, 42727, 41874, 3110, 87711
cannellacc, 1103, 51.1, 1003, 992, 54, 2049
canoeman, 1705, 26.2, 2148, 2076, 377, 4601
Canoves, 1497, 60.5, 2850, 1861, 234, 4945
canoy, 1651, 307.6, 0, 3, 0, 3
CanRus, 1502, 21.6, 1932, 2082, 232, 4246
CanSicilian, 1603, 42.2, 3347, 1932, 194, 5473
cantbe, 2011, 38.9, 552, 363, 109, 1024
capablancaa, 1013, 151.1, 5, 10, 0, 15
Capafun, 1948, 21.7, 14150, 9614, 705, 24469
capajechin, 1864, 55.4, 1085, 353, 50, 1488
capalasky, 1066, 138.1, 43, 86, 3, 132
CapBranagan, 1212, 132.4, 454, 779, 12, 1245
capchessguy, 1440, 25.6, 3707, 3593, 371, 7671
Capela, 1857, 30.9, 3534, 4801, 306, 8641
Capistran, 1897, 58.9, 3708, 927, 111, 4746
Capitano, 1351, 38.5, 4376, 4602, 314, 9292
CapitanSgrakkio, 1611, 53.3, 1121, 2609, 124, 3854
capoeirista, 1303, 24.5, 10462, 10480, 286, 21228
CappaOrsini, 1380, 210.9, 1, 8, 0, 9
capricornus, 1275, 34.8, 11108, 8563, 1248, 20919
CaptainAndy, 1073, 37.2, 268, 362, 14, 644
CaptainCrunch, 1523, 37.5, 960, 1179, 96, 2235
captainiso, 1363, 55.4, 137, 133, 26, 296
CaptainPlanet, 1465, 82.9, 1368, 2054, 169, 3591
CaptainWooly, 1020, 230.9, 0, 4, 0, 4
capuchess, 1610, 72.7, 655, 1442, 151, 2248
capucine, 1429, 120.5, 1526, 1440, 165, 3131
carabosse, 1876, 240.0, 295, 104, 18, 417
Carandiru, 1500, 132.7, 17, 43, 1, 61
caraneo, 961, 51.6, 93, 157, 1, 251
carasmare, 1406, 212.4, 9, 14, 0, 23
carbonatedbeef, 1225, 77.8, 48, 43, 4, 95
carbonero, 1585, 32.1, 7212, 7928, 612, 15752
carepov, 1579, 36.6, 2405, 2289, 315, 5009
cargentina, 811, 93.6, 10, 76, 9, 95
Carito, 1806, 28.3, 2806, 2332, 252, 5390
Carl, 1456, 24.5, 31160, 22077, 1068, 54305
carlAlind, 1215, 158.4, 5, 11, 0, 16
CarlBannwart, 1277, 109.0, 56, 98, 11, 165
carlbecker, 1202, 45.9, 3375, 3698, 270, 7343
CarlGiraffe, 1652, 25.3, 852, 991, 81, 1924
carlisleutd, 1702, 41.6, 606, 413, 57, 1076
carlitoshp, 1339, 124.8, 218, 298, 16, 532
carlobaluta, 1150, 92.6, 602, 630, 53, 1285
carlosbrossi, 1199, 28.9, 2084, 2144, 121, 4349
CarlosBT, 1724, 50.2, 2044, 2353, 164, 4561
carloscervantes, 1399, 56.5, 168, 132, 11, 311
CarlosF, 1599, 156.5, 16, 23, 0, 39
carlosfgarciac, 1411, 32.2, 1056, 546, 54, 1656
carlosgw, 1293, 113.2, 301, 220, 44, 565
Carlove, 1509, 32.0, 11191, 11716, 373, 23280
Carls, 1336, 52.6, 2930, 3022, 270, 6222
CarlsHair, 1739, 350.0, 1, 0, 0, 1
carltonsmith, 1647, 271.1, 1, 2, 1, 4
carlwin, 1251, 35.1, 1794, 1942, 27, 3763
CarmenS, 1165, 34.4, 719, 1006, 73, 1798
Carnell, 1070, 47.7, 311, 288, 16, 615
Carnife, 1195, 56.4, 493, 451, 31, 975
carokannlover, 1532, 127.6, 389, 306, 38, 733
caroldmysold, 1785, 41.7, 2276, 2000, 324, 4600
caroman, 1457, 130.8, 404, 367, 49, 820
caron, 1353, 36.4, 1777, 788, 180, 2745
Caropawn, 1236, 46.4, 1795, 2013, 144, 3952
carparov, 2071, 37.6, 10231, 8526, 1023, 19780
CarpathianForest, 1912, 239.2, 1, 1, 0, 2
carpenocte, 1394, 45.4, 2248, 3881, 214, 6343
carpentaria, 1068, 24.9, 2638, 2617, 287, 5542
carperci, 1101, 73.5, 8437, 8519, 803, 17759
Carpiano, 1181, 75.9, 266, 510, 36, 812
Carquinyoli, 1832, 23.1, 3142, 2954, 233, 6329
carrierguy, 1321, 43.8, 1341, 1399, 143, 2883
carrierizio, 1384, 35.6, 262, 337, 66, 665
carsan, 834, 113.9, 22, 89, 2, 113
Carville, 1343, 41.8, 3736, 2608, 223, 6567
CaryPaul, 1492, 22.3, 7286, 10082, 1148, 18516
casca, 1738, 65.6, 744, 599, 84, 1427
Cascagians, 1390, 41.6, 1173, 1605, 80, 2858
casimirotustetas, 1728, 45.1, 1879, 2787, 200, 4866
casix, 1612, 50.0, 1678, 1380, 96, 3154
cassiorsi, 1379, 37.0, 3402, 4325, 366, 8093
castelupi, 1370, 39.1, 866, 842, 58, 1766
CastleCastle, 1702, 60.2, 755, 464, 64, 1283
CastledKing, 1504, 72.0, 6974, 1842, 373, 9189
CastleShannon, 1262, 25.6, 620, 1768, 72, 2460
castling, 1500, 34.6, 2359, 7685, 300, 10344
Castrol, 1317, 108.0, 135, 123, 13, 271
CatalystENDALL, 1030, 183.6, 0, 5, 0, 5
catbett, 1051, 138.9, 3, 14, 0, 17
catcheck, 1312, 25.4, 12812, 15367, 1330, 29509
caterwaul, 1030, 47.6, 2932, 4068, 174, 7174
catfriend, 1285, 83.7, 74, 64, 1, 139
catgoesmeow, 1391, 295.0, 0, 1, 0, 1
cathexis, 1395, 31.4, 1462, 1251, 113, 2826
CathyNYC, 1321, 32.0, 6321, 10546, 1069, 17936
catmandu, 1145, 44.7, 1165, 1345, 118, 2628
CatNamedShrody, 1203, 46.7, 1444, 1884, 121, 3449
CatPat, 1209, 31.1, 1232, 2960, 178, 4370
Catpaw, 1450, 66.6, 453, 300, 42, 795
catri, 1026, 31.4, 2237, 1780, 140, 4157
catriac, 1297, 36.9, 2044, 2315, 112, 4471
catrina, 1877, 89.3, 725, 751, 80, 1556
caturNight, 1877, 250.3, 48, 23, 9, 80
CaturSantai, 1195, 148.0, 2, 9, 0, 11
CavaleiroNegro, 1525, 34.4, 2827, 4573, 479, 7879
cavemanfivesix, 671, 96.8, 132, 863, 14, 1009
Cavil, 1099, 41.0, 3970, 6496, 312, 10778
caviteno, 2037, 89.6, 1320, 2115, 134, 3569
cawi, 1358, 37.2, 3966, 3272, 452, 7690
cazeau, 1076, 95.6, 653, 1017, 46, 1716
cbaron, 840, 185.6, 1, 7, 0, 8
Cbba, 1172, 49.5, 744, 1002, 115, 1861
cbeauprewatier, 1212, 31.8, 481, 394, 74, 949
cbrunq, 856, 109.3, 122, 206, 3, 331
cbu, 1884, 36.7, 4923, 3321, 479, 8723
cbzy, 1525, 36.5, 230, 598, 41, 869
ccarn, 766, 92.1, 64, 214, 1, 279
CCCP, 1875, 46.4, 4245, 4643, 771, 9659
Ccentinela, 1482, 36.1, 520, 526, 61, 1107
ccievoice, 1107, 27.6, 2379, 2586, 127, 5092
ccrawford, 1276, 22.7, 628, 891, 22, 1541
ccvaibhav, 1266, 59.4, 472, 762, 35, 1269
CDay, 1655, 44.6, 5690, 3788, 390, 9868
cdecde, 1168, 26.4, 2438, 2436, 129, 5003
cdmighty, 1208, 27.0, 861, 2578, 37, 3476
CDohrmann, 1064, 30.2, 90, 133, 7, 230
cdonks, 852, 107.3, 181, 510, 17, 708
cdubz, 1660, 52.3, 549, 371, 44, 964
ceblanton, 1073, 131.0, 297, 322, 22, 641
cecropia, 1615, 27.6, 7126, 7397, 695, 15218
cedarchopper, 1346, 28.3, 6713, 8945, 554, 16212
CedricTheKing, 1315, 132.8, 172, 132, 15, 319
cedroma, 1261, 31.9, 230, 329, 29, 588
cejurs, 1616, 26.6, 9294, 7656, 751, 17701
Cekouhaca, 1567, 54.3, 1387, 1867, 93, 3347
Celavie, 1654, 24.3, 6711, 7391, 418, 14520
cellotape, 1306, 59.9, 40, 32, 6, 78
celsolrc, 1385, 33.2, 6858, 8721, 518, 16097
CelticBard, 1275, 34.3, 4501, 4894, 348, 9743
celtix, 1348, 44.1, 1259, 729, 100, 2088
Celtruler, 1030, 142.3, 32, 78, 9, 119
CemSultan, 1526, 103.3, 1220, 763, 85, 2068
CEngst, 2073, 120.2, 566, 209, 19, 794
Cenos, 1356, 46.3, 194, 209, 16, 419
Central, 1564, 70.8, 1256, 967, 151, 2374
ceolfrith, 1435, 64.3, 949, 854, 66, 1869
ceomoses, 1320, 124.4, 43, 39, 2, 84
Cerebrius, 1754, 44.6, 721, 704, 73, 1498
CERjr, 1223, 37.6, 460, 412, 24, 896
certbrain, 1340, 146.6, 47, 52, 8, 107
Cervelo, 1306, 83.6, 297, 334, 35, 666
cervetto, 1752, 38.0, 458, 540, 55, 1053
cesaralacran, 1702, 130.6, 15, 39, 2, 56
cesarvanelli, 1072, 38.2, 287, 248, 10, 545
cesinharp, 1349, 37.3, 46, 82, 5, 133
cespinochess, 1300, 93.7, 36, 81, 3, 120
CfHoEoSlS, 1251, 79.0, 138, 134, 12, 284
Cfmirelesr, 1703, 47.1, 162, 84, 3, 249
cfv, 1412, 29.2, 16927, 20674, 1970, 39571
CFVFIII, 1221, 36.9, 189, 334, 15, 538
cgiraobarreto, 1421, 54.5, 2822, 2188, 193, 5203
CGORDO, 829, 93.3, 15, 105, 0, 120
Cgrunner, 1105, 27.6, 522, 578, 42, 1142
chacaleitor, 1109, 50.1, 29, 27, 2, 58
Chadsassou, 1484, 26.9, 4781, 3405, 319, 8505
CHAFIK, 1738, 346.0, 1, 0, 0, 1
Chagoyo, 1569, 230.1, 2868, 2159, 410, 5437
chainsawwarrior, 2008, 42.7, 9173, 4303, 468, 13944
chalups, 993, 85.4, 224, 221, 13, 458
Chamit, 1000, 97.5, 236, 481, 11, 728
Champagneee, 1344, 28.4, 130, 178, 2, 310
Champan, 1645, 115.5, 203, 176, 27, 406
chanakyakranti, 1085, 137.2, 5, 14, 0, 19
chancemedley, 1016, 187.7, 9, 20, 1, 30
chandel, 938, 61.8, 13, 102, 1, 116
changchaos, 1633, 26.3, 3963, 4179, 380, 8522
CHANMAN, 932, 58.4, 1400, 2895, 48, 4343
Chansax, 1564, 139.4, 754, 748, 40, 1542
chantguy, 871, 88.2, 87, 215, 3, 305
Chaos, 1848, 96.5, 5953, 8073, 1962, 15988, 1227, 74.9, 1537, 2411, 106, 4054
chaparov, 1544, 29.1, 5207, 6629, 441, 12277
ChapBMS, 1424, 25.8, 531, 395, 78, 1004
Chaplain, 1571, 35.9, 7218, 4305, 603, 12126
chardan, 1228, 74.7, 4123, 4431, 362, 8916
Charels, 1439, 34.0, 464, 413, 19, 896
CharingCross, 807, 81.7, 85, 287, 3, 375
charliemc, 1407, 43.6, 2497, 1867, 247, 4611
CharlieMR, 1257, 57.5, 116, 192, 13, 321
Charry, 1213, 22.9, 3616, 5643, 101, 9360
Chatturanga, 1454, 78.5, 340, 365, 32, 737
chaun, 1793, 33.8, 16291, 15450, 1456, 33197
chavezricardoa, 1147, 105.7, 1055, 1327, 144, 2526
chbw, 1066, 108.8, 10, 19, 1, 30
checbenj, 1346, 22.3, 23311, 27536, 1573, 52420
Chechen, 1580, 193.6, 0, 2, 2, 4
checkermorph, 1274, 48.4, 526, 450, 35, 1011
CheckerOne, 1264, 26.0, 5680, 4963, 317, 10960
checkguy, 1522, 42.7, 963, 684, 77, 1724
Checkhound, 1127, 38.5, 464, 539, 21, 1024
CheckMagnet, 1865, 120.8, 527, 484, 162, 1173
CheckMatesQueen, 1645, 297.9, 0, 1, 0, 1
checkmatewht, 1081, 31.8, 1098, 1843, 74, 3015
checkoff, 1250, 31.1, 6450, 7237, 336, 14023
Checkoutthismate, 782, 61.6, 115, 364, 3, 482
Checkovian, 1897, 27.0, 5619, 4387, 626, 10632
ChecksAccepted, 1122, 126.1, 14, 45, 5, 64
CheckTease, 1633, 48.6, 342, 253, 26, 621
checkten, 1643, 263.5, 1100, 2911, 260, 4271
checkthisout, 1289, 22.6, 359, 395, 68, 822
cheechee, 1192, 25.1, 859, 891, 47, 1797
cheer, 1942, 39.9, 1053, 834, 211, 2098
cheesebored, 811, 36.8, 86, 223, 3, 312
Cheeseboy, 818, 122.9, 6, 34, 0, 40
Cheeseheadtothe, 1685, 28.7, 5001, 2757, 449, 8207
Cheesehut, 1678, 107.6, 1848, 1039, 134, 3021
cheess, 1126, 45.1, 1122, 1905, 45, 3072
Cheessus, 1363, 29.5, 3775, 2597, 214, 6586
chefzig, 1388, 92.4, 164, 194, 8, 366
cheiquizinho, 1466, 34.1, 4444, 6126, 452, 11022
chekmypawn, 1295, 29.2, 2788, 2606, 131, 5525
chelee, 1426, 46.6, 3386, 3620, 191, 7197
chelnygo, 958, 85.3, 48, 121, 2, 171
chemiczka, 1509, 302.3, 0, 0, 1, 1
chems, 1459, 84.0, 335, 274, 35, 644
chensea, 1059, 81.7, 21, 22, 0, 43
chequemate, 1379, 30.9, 10650, 15181, 1061, 26892
cheriabin, 1265, 122.3, 762, 2524, 74, 3360
CherrylandCafe, 1635, 350.0, 4, 5, 0, 9
cheschampion, 1240, 107.9, 85, 54, 8, 147
chesilyn, 1860, 51.9, 823, 839, 94, 1756
chesnstuff, 1893, 20.8, 836, 872, 122, 1830
ChessAAnthony, 827, 136.3, 3, 13, 0, 16
Chessaddicted, 1344, 47.8, 3496, 4195, 336, 8027
chessadmiral, 1420, 51.8, 1156, 894, 70, 2120
ChessAlly, 1328, 45.3, 303, 248, 15, 566
chessandmate, 1330, 86.1, 697, 1054, 188, 1939
chessarmour, 1560, 27.5, 10026, 10006, 752, 20784
chessastronomy, 1583, 42.4, 2472, 3965, 375, 6812
ChessAtack, 1563, 40.0, 1908, 1775, 240, 3923
ChessAttack, 1205, 82.7, 89, 242, 6, 337
ChessBaronE, 1260, 54.8, 64, 42, 4, 110
chessbliss, 1193, 96.6, 77, 141, 4, 222
ChessBook, 1659, 46.9, 3247, 3539, 521, 7307
chessboyjazz, 781, 95.1, 65, 265, 10, 340
Chessboywonder, 1275, 28.4, 2456, 3592, 269, 6317
ChessBrave, 1325, 66.3, 5289, 7104, 269, 12662
chessburqer, 1201, 42.9, 164, 309, 5, 478
chessbuzz, 1200, 54.2, 728, 857, 100, 1685
chesschisschuss, 954, 32.2, 156, 329, 10, 495
chesscupid, 1690, 103.8, 389, 565, 56, 1010
chessdata, 1301, 180.6, 5, 5, 0, 10
chessdev, 1210, 58.5, 2952, 3213, 329, 6494
ChessDhruv, 834, 137.8, 5, 36, 0, 41
chessdivorcee, 1339, 24.2, 2737, 3240, 107, 6084
ChessDj, 1336, 201.3, 9, 5, 1, 15
chessdori, 1297, 33.5, 2495, 5664, 175, 8334
Chessdrama, 1563, 246.6, 1, 1, 0, 2
Chessdudicus, 1309, 92.4, 441, 496, 12, 949
Chessec, 1746, 23.5, 8008, 11453, 714, 20175
ChessEducator, 2237, 45.0, 1409, 622, 135, 2166
Chessempion, 803, 181.5, 1, 6, 0, 7
chessend, 1463, 24.7, 1133, 2385, 78, 3596
chesserp, 1350, 35.5, 7597, 8004, 582, 16183
chessextra, 1124, 124.3, 30, 56, 3, 89
chessfandan, 1147, 25.4, 2897, 4040, 305, 7242
ChessFanSR, 1030, 116.1, 20, 24, 1, 45
Chessfist, 884, 72.1, 41, 102, 3, 146
chessfolk, 1247, 131.9, 107, 123, 5, 235
chessforce, 1554, 30.0, 31499, 14699, 1532, 47730
chessfouse, 1402, 36.3, 3555, 3217, 197, 6969
chessghad, 1469, 22.1, 1437, 1028, 155, 2620
chessgrm, 1275, 31.7, 4711, 6132, 334, 11177
ChessHF, 1313, 119.1, 250, 355, 29, 634
chessholic, 1425, 80.9, 279, 269, 17, 565
chessimprov, 1613, 36.5, 1724, 1128, 70, 2922
chessindia, 1373, 29.1, 2402, 2226, 172, 4800
chessisbest, 1088, 84.3, 293, 348, 40, 681
chessjan, 1383, 18.8, 3022, 3859, 225, 7106
chessjazz, 1447, 29.4, 5851, 5793, 638, 12282
chessjb, 1175, 78.7, 62, 109, 7, 178
chesskeen, 1535, 19.1, 13973, 20974, 1125, 36072
chesskky, 1018, 64.0, 194, 395, 18, 607
ChesskNorris, 1105, 90.4, 414, 933, 25, 1372
Chesskovski, 1561, 38.8, 5080, 3124, 230, 8434
ChessLondon, 1474, 71.1, 1966, 2982, 188, 5136
chessloon, 1371, 45.4, 4788, 4227, 199, 9214
chesslosser, 1460, 39.2, 5877, 5051, 376, 11304
chessmani, 1125, 29.1, 454, 377, 21, 852
chessmanny, 1635, 76.2, 336, 355, 29, 720
chessmart, 1485, 39.0, 584, 1334, 127, 2045
ChessMastaShake, 1390, 27.7, 3853, 3467, 300, 7620
Chessmatics, 1271, 44.4, 91, 88, 3, 182
Chessmaxim, 1275, 60.8, 56, 60, 5, 121
ChessMeister, 1460, 42.1, 5197, 5320, 706, 11223
ChessMethOde, 941, 155.6, 11, 38, 1, 50
Chessminded, 1090, 98.9, 31, 66, 4, 101
ChessMonkee, 1439, 40.3, 282, 353, 28, 663
chessmossa, 1640, 38.6, 780, 1246, 83, 2109
ChessNetDogbert, 1428, 75.3, 1470, 1747, 250, 3467
chessnicdote, 1257, 85.9, 170, 249, 24, 443
Chessnimal, 1434, 41.1, 253, 237, 19, 509
Chessnooob, 926, 37.9, 69, 186, 1, 256
chessnyc, 1313, 24.0, 2876, 2997, 254, 6127
ChessOverlord, 675, 59.6, 35, 270, 3, 308
Chessoyd, 1416, 96.6, 861, 615, 55, 1531
chesspagol, 1419, 32.9, 1758, 1534, 121, 3413
chesspalace, 1307, 63.5, 97, 113, 9, 219
ChessPatterson, 1101, 127.3, 61, 68, 4, 133
chesspigeon, 1322, 42.1, 3543, 5088, 292, 8923
chesspirit, 1377, 32.2, 5242, 6286, 302, 11830
ChessPlease, 1378, 33.8, 6263, 6058, 508, 12829
chesspot, 1054, 34.2, 643, 854, 21, 1518
chessren, 1735, 73.8, 351, 301, 33, 685
chessshow, 1873, 70.8, 1276, 1084, 177, 2537
chessspringer, 1029, 150.3, 3, 9, 1, 13
chessstat, 1395, 68.7, 122, 79, 11, 212
Chessstyles, 1814, 125.7, 4192, 3388, 453, 8033
chesssuperstar, 1482, 76.5, 1651, 2785, 185, 4621
ChessSystemsHere, 1779, 36.4, 2559, 1786, 244, 4589
ChessTatour, 1851, 51.6, 4498, 4440, 513, 9451
ChessterFIN, 1380, 47.1, 6135, 3660, 343, 10138
Chessteroo, 992, 112.4, 5, 28, 0, 33
ChessThing, 1334, 85.0, 597, 430, 49, 1076
chesstmorgan, 1171, 53.3, 2501, 2888, 244, 5633
ChessToGo, 1390, 33.5, 625, 1312, 45, 1982
chesstrapper, 1457, 27.2, 5752, 3168, 302, 9222
chesstueurs, 1754, 44.0, 4617, 6252, 467, 11336
chesstyle, 1274, 46.0, 3257, 3190, 291, 6738
chessup, 964, 130.3, 259, 292, 49, 600
CHESSUSSR, 1337, 57.1, 72, 115, 8, 195
ChessUtoo, 1627, 27.2, 4380, 4554, 376, 9310
CHESSVEN, 1343, 49.9, 804, 1054, 95, 1953
chessviner, 1637, 106.3, 117, 76, 4, 197
chesswanderer, 1514, 52.2, 2126, 2389, 197, 4712
chessweicong, 1747, 70.7, 233, 275, 37, 545
Chesswithin, 1227, 51.7, 85, 55, 7, 147
chessxwizard, 1028, 129.5, 74, 135, 17, 226
ChessYesYahweh, 1517, 116.8, 293, 209, 11, 513
chestchest, 1306, 75.0, 386, 1481, 25, 1892
chesterchess, 1839, 95.6, 5335, 7036, 688, 13059
chestercueca, 1735, 38.4, 11123, 10783, 1535, 23441
CHETSIFU, 1100, 59.9, 650, 786, 54, 1490
chettra, 1350, 28.7, 4929, 9500, 265, 14694
Chevalaile, 1130, 38.0, 3988, 4463, 233, 8684
Chevreuil, 1362, 66.0, 4745, 4297, 382, 9424
chezawho, 1207, 45.0, 3208, 2549, 139, 5896
chgribas, 885, 123.3, 31, 196, 3, 230
chi, 1519, 33.0, 8177, 7802, 730, 16709
chiappablanca, 1567, 32.2, 1331, 849, 95, 2275
Chicagin, 1222, 165.4, 6, 8, 0, 14
chicagobob, 1356, 23.7, 8790, 6270, 727, 15787
chicagochess, 939, 58.2, 259, 151, 15, 425
chichakly, 925, 83.7, 5, 25, 0, 30
chichikov, 1488, 46.7, 3379, 4519, 236, 8134
Chichoto, 1564, 33.2, 4031, 5430, 454, 9915, 2090, 80.1, 625, 321, 62, 1008
ChickenWalker, 1013, 152.6, 8, 18, 0, 26
ChicoOne, 1176, 145.5, 2, 6, 0, 8
ChiCubbyBear, 1100, 149.2, 10, 12, 0, 22
chidex, 1407, 30.9, 433, 583, 17, 1033
chiefcito, 946, 41.6, 63, 107, 4, 174
Chiefwinthemall, 1096, 57.1, 407, 395, 13, 815
chiefy, 1607, 33.8, 5131, 5882, 594, 11607
ChiElmore, 1369, 52.7, 1652, 1841, 163, 3656
chigoatchess, 1570, 58.9, 194, 119, 17, 330
Chillapov, 1383, 60.7, 487, 448, 34, 969
Chillis, 1164, 54.5, 3476, 3440, 230, 7146
Chimango, 1559, 79.5, 2212, 2247, 255, 4714
ChimeyRhymes, 1237, 145.0, 20, 210, 2, 232
chimurenga, 1559, 34.9, 11558, 11863, 1256, 24677
ChimWorK, 1212, 132.2, 12, 14, 1, 27
chinadad, 1005, 119.6, 55, 136, 5, 196
ChinaMike, 1314, 30.0, 3146, 3496, 272, 6914
chingching, 1262, 59.0, 6160, 5689, 739, 12588
chintamani, 1387, 99.0, 54, 27, 5, 86
chintan, 1125, 36.9, 1853, 1314, 66, 3233
chintar, 1370, 25.8, 4093, 6169, 229, 10491
ChipmunkMan, 1206, 29.3, 3487, 3978, 130, 7595
ChipperJ, 1726, 64.3, 301, 489, 60, 850
chiptalker, 1064, 84.0, 118, 225, 10, 353
chiquitokan, 1274, 25.8, 1687, 1965, 234, 3886
chiripal, 1287, 37.8, 2955, 2429, 250, 5634
chitownbear, 1360, 20.6, 4001, 7261, 359, 11621
ChiTownDad, 1144, 337.4, 0, 1, 0, 1
chitumin, 1499, 126.3, 2427, 2545, 131, 5103
chkchess, 1719, 51.4, 521, 191, 43, 755
chloethecool, 907, 52.4, 761, 716, 80, 1557
chocaholic, 1638, 41.0, 963, 1254, 163, 2380
chocomallo, 1110, 78.3, 605, 723, 38, 1366
Chogasbord, 1186, 36.3, 578, 458, 15, 1051
choki, 1428, 28.4, 16752, 12738, 1515, 31005
choks, 1028, 52.0, 546, 2355, 69, 2970
Chompion, 1332, 19.5, 5108, 3434, 174, 8716
chook, 1416, 46.3, 3026, 2594, 190, 5810
CHootBAAL, 1722, 26.7, 8431, 4642, 616, 13689
ChopinMaster, 1046, 131.3, 18, 25, 1, 44
chopinscherzo, 1187, 44.4, 379, 360, 28, 767
choutagahar, 1516, 31.4, 1964, 2464, 135, 4563
Chovanec, 1484, 71.8, 172, 109, 12, 293
chriscog, 1427, 92.1, 355, 230, 16, 601
chrisdee, 1276, 59.8, 35, 12, 0, 47
ChrisFischer, 1201, 46.7, 464, 624, 33, 1121
CHRISfromMISS, 1393, 34.9, 1705, 2282, 199, 4186
Chrisie, 1424, 21.3, 4530, 3733, 179, 8442
chrisjk, 1149, 45.9, 249, 388, 19, 656
chrislybbert, 894, 121.7, 4, 19, 0, 23
chrismears, 1008, 120.2, 37, 50, 3, 90
Christen, 1354, 37.0, 12581, 10662, 428, 23671
Christian, 1717, 29.9, 5300, 3366, 401, 9067
christianwparker, 867, 57.0, 503, 947, 18, 1468
christoforo, 1185, 30.9, 140, 656, 7, 803
ChristofRomyuod, 1397, 54.4, 502, 532, 51, 1085
christos, 1162, 109.2, 764, 785, 48, 1597
ChrisVinall, 1286, 46.3, 712, 551, 25, 1288
Chromaticprisoner, 1211, 27.3, 1234, 1321, 96, 2651
chromegoat, 1286, 117.5, 24497, 28955, 1884, 55336
chromeoboy, 1547, 117.2, 229, 231, 19, 479
Chronofugit, 924, 65.5, 125, 124, 12, 261
Chronometer, 1505, 245.0, 0, 3, 1, 4
chrReid, 823, 123.5, 23, 81, 1, 105
ChrSav, 1492, 84.9, 142, 221, 16, 379
chrstphrdbsn, 1475, 46.2, 150, 290, 39, 479
chrysanthemum, 1044, 102.9, 356, 633, 26, 1015
chscgc, 1336, 73.7, 84, 129, 6, 219
chthonicangel, 1102, 89.4, 29, 62, 5, 96
chtijean, 1514, 76.5, 2985, 3018, 132, 6135
chuah, 1674, 133.8, 1624, 807, 156, 2587
Chubbychicken, 1333, 101.8, 79, 57, 8, 144
chubbychubus, 1426, 36.8, 8692, 8871, 527, 18090
ChuchoElRoto, 1348, 30.7, 381, 442, 16, 839
ChuckDarwin, 1200, 49.1, 660, 1075, 39, 1774
Chuckiegg, 1675, 27.5, 544, 333, 32, 909
chucklebrain, 1124, 39.2, 1363, 1591, 126, 3080
ChuckNorrisChess, 1213, 107.9, 8, 15, 0, 23
chuckscap, 1292, 81.3, 794, 607, 33, 1434
Chumakov, 1564, 64.8, 5042, 2641, 251, 7934
churningpigskin, 1173, 27.5, 17030, 13726, 1087, 31843
CHUrras, 1107, 39.0, 125, 275, 11, 411
Chusmary, 1039, 74.5, 162, 230, 6, 398
chuzuk, 1584, 33.1, 485, 456, 58, 999
chvegeta, 1273, 75.3, 7, 43, 1, 51
chzmstr, 1462, 38.8, 9129, 4632, 671, 14432
CiaranG, 1046, 34.4, 285, 391, 14, 690
Cibola, 1139, 24.0, 7390, 10439, 594, 18423
cica, 1718, 31.1, 2624, 2368, 282, 5274
ciclon, 1336, 35.5, 6031, 8596, 561, 15188
cikadejo, 1076, 43.9, 76, 87, 8, 171
cincyfan, 1309, 48.0, 961, 632, 61, 1654
CindyBert, 1872, 54.6, 225, 273, 22, 520
Cinepal, 1190, 84.1, 582, 798, 67, 1447
ciompi, 1553, 37.8, 4213, 4867, 394, 9474
Ciompolov, 1344, 19.8, 4576, 4686, 372, 9634
ciramor, 1177, 33.2, 566, 775, 40, 1381
circlec, 1357, 132.0, 3, 9, 1, 13
circum, 980, 131.2, 45, 147, 9, 201
Cirko, 1419, 102.0, 1354, 2881, 144, 4379
ciscocool, 1393, 24.2, 559, 431, 62, 1052
ciscokidder, 1403, 98.2, 2697, 3790, 331, 6818
CitizenCane, 1400, 22.9, 11702, 11345, 1845, 24892
cityofashes, 1112, 207.9, 1, 4, 0, 5
ciupilica, 1378, 200.3, 5, 8, 1, 14
cizar, 2013, 96.3, 7185, 4104, 1514, 12803
cjbish, 1335, 43.0, 1288, 1252, 113, 2653
CJdaWarchild, 1105, 126.6, 294, 459, 29, 782
cjdoherty, 759, 97.6, 32, 117, 0, 149
cjhope, 986, 118.0, 79, 123, 3, 205
CjWickham, 1607, 83.8, 739, 551, 24, 1314
ckdgns, 1428, 33.6, 2439, 2346, 174, 4959
ckuttruff, 1492, 51.1, 543, 858, 40, 1441
clanelle, 1894, 55.3, 1347, 1503, 203, 3053
ClarenceWithers, 1172, 36.8, 1767, 4630, 177, 6574
clarinetref, 1309, 34.3, 2540, 2133, 191, 4864
classAvenger, 1441, 34.6, 10058, 6667, 836, 17561
classicaltext, 1059, 89.2, 606, 653, 42, 1301
claudinho, 735, 55.8, 7, 52, 0, 59
claudioadinho, 1383, 29.3, 3650, 3955, 324, 7929
claudiociubecca, 1284, 29.6, 317, 288, 41, 646
Clavier, 1226, 78.5, 37, 129, 10, 176
claywill, 949, 133.8, 6, 26, 2, 34
clcprodigy, 1566, 49.3, 2542, 3843, 414, 6799
cleannumberone, 1068, 28.3, 803, 1050, 58, 1911
ClearBlueSky, 1226, 71.3, 83, 82, 9, 174
Clearnote, 1725, 44.9, 2092, 917, 79, 3088
ClearPond, 1252, 29.5, 2107, 2057, 136, 4300
ClearTheWay, 1353, 136.2, 2798, 3622, 399, 6819
cleduc, 1366, 32.0, 12964, 7547, 931, 21442
CleversonCordova, 1600, 30.7, 556, 359, 49, 964
clgroncho, 1552, 105.9, 11, 7, 1, 19, 2029, 29.4, 9667, 5597, 1531, 16795
CliffS, 1186, 49.2, 2900, 2705, 305, 5910
climbit, 1473, 35.7, 2913, 3621, 277, 6811
clmnky, 1795, 85.4, 1386, 1216, 119, 2721
CloakedRaptor, 1090, 333.4, 4, 10, 0, 14
Clobber, 1874, 59.5, 56, 10, 1, 67
clocksfiftyfive, 1249, 34.4, 1848, 2245, 143, 4236
clockworkchaos, 1438, 52.4, 1656, 1590, 152, 3398
ClockworkKing, 1461, 36.5, 1792, 1579, 211, 3582
ClokeandDagger, 1121, 56.9, 762, 814, 35, 1611
clonedqueenss, 1002, 133.3, 25, 43, 2, 70
cloorem, 1097, 38.8, 145, 234, 10, 389
clopez, 1266, 39.7, 444, 899, 22, 1365
clothesinsideout, 1478, 35.8, 1320, 1433, 176, 2929
clouis, 1276, 29.8, 4187, 3962, 322, 8471
Clownarama, 1303, 58.0, 3893, 3953, 334, 8180
clpilot, 1422, 46.2, 772, 711, 65, 1548
clrengif, 1780, 96.5, 695, 554, 49, 1298
cluck, 1176, 22.5, 4139, 9626, 615, 14380
clutchmane, 903, 135.7, 49, 63, 2, 114
ClxPawn, 1580, 23.3, 20154, 9576, 1008, 30738
cmambrin, 1491, 48.1, 1466, 2665, 254, 4385
CMAnderson, 1194, 40.0, 6503, 5451, 431, 12385
CMargol, 1076, 31.9, 1756, 2890, 47, 4693
cmasteroneone, 1425, 33.6, 1391, 1274, 160, 2825
cmcj, 990, 34.6, 1259, 1800, 130, 3189
CMI, 1601, 41.1, 784, 1352, 72, 2208
CMoniz, 1355, 44.4, 565, 801, 50, 1416
cmpcmp, 1351, 74.1, 1249, 1248, 132, 2629
cmunson, 1237, 95.2, 119, 263, 12, 394
cmurrieta, 1300, 32.7, 1626, 1162, 58, 2846
cmvirtusio, 1314, 106.2, 365, 419, 35, 819
cmyfoto, 1504, 114.3, 144, 84, 8, 236
cnjay, 1421, 60.0, 70, 56, 1, 127
cnyplayer, 844, 97.7, 35, 114, 1, 150
CoachCrupp, 1288, 113.8, 1057, 755, 56, 1868
CoachDallas, 1648, 31.6, 266, 484, 38, 788
CoachFAQS, 907, 79.7, 71, 262, 1, 334
cobaia, 1504, 55.7, 628, 768, 66, 1462
cobean, 1480, 104.9, 1531, 2103, 97, 3731
Coboa, 1551, 27.3, 8529, 8316, 603, 17448
CobraCommander, 2030, 29.2, 17301, 9774, 1226, 28301
CobraMcD, 1762, 111.3, 49, 18, 0, 67
Cockoo, 1314, 51.4, 6653, 6140, 298, 13091
CocktailNation, 1292, 27.2, 619, 741, 82, 1442
cocodrilo, 1671, 46.0, 2019, 826, 143, 2988
codheadsoup, 1337, 193.2, 5, 2, 1, 8
Codjigger, 1174, 56.1, 5199, 4739, 425, 10363
codysf, 1477, 33.4, 1911, 2301, 256, 4468
Cofrancesco, 1312, 50.5, 375, 423, 13, 811
cogliostro, 1128, 342.3, 0, 2, 0, 2
COHGNH, 1163, 56.5, 2074, 2535, 124, 4733
CoinTrader, 1257, 36.9, 4173, 4275, 120, 8568
CokAcemi, 1557, 24.4, 6738, 6607, 334, 13679
Cokein, 974, 81.6, 13, 27, 1, 41
coker, 1437, 57.2, 45, 17, 6, 68
cokietheclown, 1865, 28.8, 154, 96, 13, 263
coldbeam, 1018, 136.0, 11, 25, 2, 38
coldknight, 1277, 37.2, 1467, 1854, 103, 3424
COLDPredator, 1867, 134.6, 281, 177, 15, 473
colibrius, 1532, 30.0, 673, 523, 41, 1237
colindru, 1410, 71.6, 214, 97, 12, 323
colinnw, 904, 120.7, 79, 156, 2, 237
collardgreens, 1263, 125.1, 220, 147, 6, 373
colmenares, 1342, 40.4, 2248, 2255, 204, 4707
Colod, 1223, 47.2, 1889, 1967, 95, 3951
cololoco, 1383, 56.8, 5702, 5920, 498, 12120
ColorAzul, 1316, 31.7, 971, 1701, 96, 2768
Colse, 1305, 89.6, 1442, 1569, 87, 3098
Coltaine, 1677, 49.3, 1874, 1226, 133, 3233
ComboKid, 1405, 137.5, 177, 240, 10, 427
comedyguy, 1164, 69.2, 98, 127, 2, 227
cominitto, 1478, 29.6, 10629, 16494, 1130, 28253
complete, 2052, 22.1, 25371, 16497, 3192, 45060
comptepoubelle, 1141, 78.7, 709, 1048, 44, 1801
compusa, 1236, 42.8, 1493, 1640, 60, 3193
computerproof, 1168, 68.4, 969, 1489, 68, 2526
computerr, 921, 143.4, 0, 7, 0, 7
Conecctor, 1454, 50.9, 266, 995, 46, 1307
conerad, 1313, 99.0, 398, 370, 36, 804
conkerman, 1376, 68.4, 246, 256, 14, 516
Conquerer, 1449, 120.0, 76, 112, 4, 192
ConradoSalazar, 1451, 27.8, 824, 1444, 114, 2382
Conscientiousness, 1723, 25.4, 1086, 627, 66, 1779
consdandin, 1121, 66.5, 38, 169, 2, 209
Conspicuous, 1133, 60.4, 232, 236, 17, 485
constable, 1332, 52.8, 1186, 1097, 57, 2340
constantinet, 1108, 78.1, 1588, 1862, 120, 3570
consuelo, 1946, 67.4, 536, 284, 44, 864
consultantca, 1322, 48.3, 1929, 1495, 166, 3590
consummer, 945, 96.0, 168, 142, 9, 319
contak, 1115, 40.4, 1362, 1300, 68, 2730
contrastlife, 891, 61.8, 151, 363, 8, 522
controldes, 975, 175.6, 0, 6, 1, 7
controltheweb, 1462, 46.5, 1772, 1717, 150, 3639
convverge, 1025, 89.9, 220, 612, 15, 847
coolaa, 1088, 280.7, 2, 3, 0, 5
coolb, 1257, 53.1, 32, 38, 5, 75
coolexpert, 1892, 46.7, 131, 141, 9, 281
CoolGamer, 1669, 25.9, 1787, 1679, 277, 3743
CoolHandFluke, 1615, 42.0, 589, 864, 61, 1514
Coolin, 1162, 102.9, 77, 66, 9, 152
coolname, 1458, 97.1, 3159, 3755, 309, 7223
coolreit, 1396, 34.0, 2710, 3012, 353, 6075
coopnomaks, 1630, 28.7, 5007, 3053, 268, 8328
coopon, 1167, 81.3, 116, 207, 8, 331
CoorsB, 1155, 39.2, 1126, 1687, 71, 2884
copperwindow, 1636, 28.2, 25936, 20310, 2017, 48263
coprobo, 1249, 35.9, 374, 487, 46, 907
Corbenik, 968, 146.6, 1, 14, 1, 16
CORCHESS, 1835, 81.3, 429, 160, 21, 610
corea, 1390, 35.3, 5888, 3943, 567, 10398
cormacyusef, 831, 60.0, 74, 339, 3, 416
Cornbx, 1241, 45.2, 1202, 1149, 62, 2413
corneliuspremier, 1792, 129.3, 10, 6, 2, 18
Cornpawn, 1831, 162.5, 5, 2, 0, 7
corotss, 1258, 131.2, 3885, 4223, 143, 8251
corpuscollossus, 1310, 59.8, 4646, 5541, 323, 10510
CortezTheKiller, 1413, 29.5, 5642, 7438, 595, 13675
Corzzo, 1232, 21.7, 6512, 8618, 570, 15700
cosanturgut, 1409, 49.4, 779, 963, 13, 1755
Cosaron, 1461, 32.9, 2395, 2838, 237, 5470
coset, 1272, 48.7, 776, 1102, 38, 1916
cosimuccio, 1223, 27.7, 583, 579, 37, 1199
CosmicM, 1540, 34.9, 7388, 6013, 739, 14140
CosmicMeltDown, 1543, 69.5, 3715, 3188, 501, 7404
CosmicSwirl, 1431, 48.6, 595, 704, 44, 1343
costel, 1483, 22.9, 3709, 5536, 338, 9583
costica, 1666, 28.2, 1604, 1532, 174, 3310
Cotopaxi, 1301, 24.3, 4980, 5212, 531, 10723
cottagehamilton, 1157, 92.6, 421, 1008, 25, 1454
coucouhibou, 1516, 31.3, 1238, 924, 76, 2238
countdown, 1530, 31.7, 9373, 6295, 1049, 16717
Counterschlitz, 997, 54.1, 7342, 9147, 923, 17412
countryspirit, 1239, 23.5, 1229, 1893, 120, 3242
couture, 1434, 40.9, 2898, 2537, 133, 5568
covek, 1340, 165.1, 6, 6, 0, 12
Cow, 1276, 77.1, 1536, 1923, 212, 3671
cowboywatson, 1108, 176.2, 0, 7, 0, 7
CowGoesMooove, 1703, 52.4, 2435, 1641, 144, 4220
Coxybleue, 1222, 28.2, 6834, 9373, 612, 16819
cpmmr, 1242, 63.6, 217, 410, 35, 662
cpnt, 716, 125.7, 175, 1010, 16, 1201
cpotnar, 933, 212.2, 48, 75, 1, 124
cpparsifal, 1558, 40.8, 4099, 2468, 265, 6832
CptnAwesome, 799, 72.0, 96, 288, 5, 389
cptslayer, 527, 157.8, 1, 22, 0, 23
cpttromp, 1464, 26.1, 2117, 2886, 203, 5206
cqs, 1273, 34.5, 2410, 1958, 154, 4522
Cra, 1141, 39.0, 879, 1143, 75, 2097
CraigMorgan, 1287, 109.8, 145, 224, 14, 383
craigscott, 1160, 99.5, 381, 464, 21, 866
Cranith, 2011, 41.4, 9088, 6584, 899, 16571
crankchap, 1104, 44.1, 1592, 1485, 76, 3153
crankinhaus, 1710, 60.4, 5342, 4771, 363, 10476
cranstondoomoore, 1063, 135.6, 32, 71, 0, 103
CrapsMaster, 1571, 24.2, 685, 764, 9, 1458
Crapton, 1557, 45.3, 785, 909, 60, 1754
craquou, 1234, 30.2, 2172, 3421, 282, 5875
crashandburn, 1270, 48.5, 3854, 4515, 100, 8469
CrashBint, 1413, 108.9, 4384, 3944, 495, 8823
crashtest, 1065, 142.2, 101, 147, 9, 257
CRAvensRock, 1586, 26.9, 3860, 2715, 404, 6979
crayongod, 783, 39.6, 808, 905, 24, 1737
CrazedManiac, 1984, 84.5, 1002, 675, 105, 1782
crazycousins, 753, 165.1, 133, 141, 16, 290
crazycro, 1229, 30.5, 812, 801, 96, 1709
crazyim, 1560, 45.1, 162, 101, 7, 270
crazyjigsaw, 1138, 216.3, 1, 2, 1, 4
crazylasker, 1457, 51.5, 1121, 616, 51, 1788
crazyplayer, 1714, 30.6, 8257, 10371, 982, 19610
crazyrain, 1522, 34.2, 2626, 2260, 120, 5006
CrazyTempo, 1508, 76.0, 4252, 1996, 180, 6428
crazyyugo, 1076, 241.1, 264, 258, 25, 547
crciii, 939, 60.0, 469, 1189, 50, 1708
crcober, 933, 45.2, 102, 140, 7, 249
Creamy, 1238, 70.3, 833, 493, 56, 1382
CreamyGoodness, 1584, 32.5, 23398, 20114, 1741, 45253
CreamyNebula, 1166, 242.4, 0, 5, 0, 5
creativegenius, 1065, 72.2, 288, 423, 17, 728
cregan, 1482, 37.7, 611, 408, 61, 1080
Cremaster, 1506, 45.7, 3422, 2029, 226, 5677
Cremonator, 2337, 122.1, 918, 669, 85, 1672
crenroth, 1536, 32.7, 4172, 3561, 253, 7986
creyes, 1155, 40.0, 1461, 2197, 140, 3798
Cric, 1694, 32.6, 2965, 3398, 443, 6806
crickit, 931, 131.3, 109, 298, 5, 412
Crim, 1695, 37.3, 6729, 7081, 647, 14457
crimemastergogo, 1106, 44.5, 545, 862, 20, 1427
crimsonk, 1517, 42.7, 1298, 3109, 155, 4562
crippledpawn, 1316, 28.0, 6060, 7502, 596, 14158
crisso, 1399, 49.4, 384, 301, 27, 712
cristianh, 1494, 31.3, 6573, 6766, 1746, 15085
CriticalWish, 1119, 78.9, 586, 845, 66, 1497
crle, 1377, 25.1, 7379, 7199, 566, 15144
Crocdile, 924, 39.1, 233, 587, 20, 840
crocochess, 1375, 111.8, 794, 640, 98, 1532
CrocZ, 1419, 65.6, 1631, 1193, 141, 2965
crokit, 1112, 30.6, 1160, 1200, 74, 2434
cronski, 1097, 180.1, 2, 4, 0, 6
crosales, 1511, 33.3, 1700, 2515, 160, 4375
CrossCzech, 1005, 160.8, 2184, 2175, 258, 4617
CrossEye, 1535, 31.6, 15632, 13921, 1086, 30639
crossfireee, 735, 67.5, 10, 74, 0, 84
CrossWind, 931, 350.0, 23, 87, 5, 115
CrottyW, 1222, 70.0, 759, 883, 68, 1710
Crown, 1461, 43.8, 5110, 4099, 299, 9508
crownking, 1244, 34.2, 1171, 1524, 140, 2835
Crowtche, 1062, 61.9, 402, 488, 13, 903
croxley, 1554, 43.7, 2538, 1920, 224, 4682
Cruin, 1311, 25.7, 7188, 5259, 504, 12951
CrushCity, 1011, 45.4, 39, 118, 2, 159
CRUSHR, 1619, 70.2, 242, 135, 15, 392
CRVW, 1621, 24.1, 7446, 6716, 787, 14949
Cryminysakes, 1146, 107.4, 451, 765, 28, 1244
Crypt, 1454, 223.8, 2413, 2339, 227, 4979
crypticbrahmin, 1434, 50.0, 165, 144, 16, 325
Crypticsss, 1386, 61.2, 1149, 734, 99, 1982
Crypton, 1799, 59.2, 4485, 3858, 409, 8752
crzyiii, 1499, 288.0, 0, 1, 0, 1
csinalok, 1583, 35.0, 1998, 2106, 255, 4359
cstarx, 1716, 23.5, 3949, 4016, 449, 8414
csteen, 1131, 42.4, 366, 537, 10, 913
cstefan, 2008, 25.2, 4990, 3421, 352, 8763
CTBOJI, 905, 84.6, 6, 21, 0, 27
ctenitchi, 1030, 37.7, 374, 585, 39, 998
cthree, 1524, 106.5, 1665, 1906, 248, 3819
cttest, 1796, 41.9, 6861, 6471, 1006, 14338
cubaki, 1376, 68.8, 549, 491, 26, 1066
cubism, 1475, 23.5, 7954, 7191, 587, 15732
cubodos, 1694, 36.4, 514, 569, 42, 1125
cuboid, 1178, 26.7, 2601, 3913, 185, 6699
cubs, 1632, 33.0, 15799, 3929, 630, 20358
cubulet, 1597, 37.1, 2056, 1184, 264, 3504
cucho, 1730, 70.1, 3444, 3249, 283, 6976
cuchor, 1858, 21.0, 9514, 10185, 1601, 21300
Cuddly, 1265, 51.7, 374, 393, 20, 787
Cuew, 2142, 127.3, 14, 2, 0, 16
cuileann, 1194, 34.2, 397, 500, 21, 918
Cuilin, 1719, 34.8, 1820, 1938, 129, 3887
Culpius, 1325, 56.4, 7041, 6544, 614, 14199
CUNNINGHORNET, 1267, 66.8, 1051, 1116, 44, 2211
CupidStunt, 1707, 42.7, 1400, 995, 123, 2518
cupofjo, 1331, 146.0, 989, 984, 42, 2015
curbyVII, 1909, 150.0, 677, 664, 55, 1396
Currents, 959, 35.7, 2897, 3995, 183, 7075
currie, 1845, 32.5, 14928, 11801, 1486, 28215
curtainsforzielke, 1455, 62.6, 426, 265, 28, 719
CurtisFLee, 1436, 26.2, 757, 502, 42, 1301
cutebaby, 1570, 29.4, 750, 577, 61, 1388
cutnpaaste, 1206, 44.6, 2275, 2437, 226, 4938
cutterknife, 1622, 23.6, 17164, 19677, 2355, 39196
CVChampion, 1343, 29.8, 258, 201, 16, 475
cviksa, 1907, 41.5, 173, 261, 29, 463
cvrca, 1460, 29.7, 3092, 3009, 279, 6380
cwl, 1360, 232.8, 1, 2, 0, 3
cxcxx, 1176, 55.4, 134, 146, 15, 295
CyberBarbarian, 2082, 245.3, 95, 58, 13, 166
CyberNomad, 1200, 52.8, 439, 309, 24, 772
CyborgZero, 1173, 115.9, 714, 834, 72, 1620
cyceristry, 1597, 32.5, 4830, 6453, 513, 11796
Cyclones, 1480, 28.5, 6067, 3909, 416, 10392
cyclonicsam, 1200, 43.7, 469, 928, 67, 1464
cyed, 1386, 59.5, 2894, 502, 118, 3514
CynicalMagician, 1316, 98.6, 535, 566, 65, 1166
cynima, 1725, 45.7, 409, 259, 19, 687
Cynner, 645, 135.7, 1, 20, 0, 21
cyoeraeth, 1928, 127.1, 69, 54, 11, 134
cyrdro, 1074, 32.8, 1784, 3578, 100, 5462, 1806, 54.8, 1832, 1042, 157, 3031
CYU, 1598, 104.0, 113, 26, 6, 145
dabadalorian, 1174, 45.2, 319, 317, 17, 653
Dabangg, 1010, 125.8, 2, 19, 0, 21
dabbadubba, 999, 67.5, 620, 1278, 46, 1944
daciuk, 1511, 99.4, 49, 28, 0, 77
daclark, 1204, 50.6, 503, 578, 21, 1102
dad, 1551, 35.1, 10631, 10821, 878, 22330
DADABAI, 896, 209.4, 0, 5, 0, 5
dadek, 1511, 22.5, 10355, 15441, 999, 26795
DADGAD, 1084, 131.1, 57, 40, 3, 100
dadoffive, 1361, 54.6, 1381, 487, 89, 1957
daelsterdam, 1236, 42.4, 476, 613, 44, 1133
daemonas, 2110, 116.6, 1144, 861, 136, 2141
Daffers, 1344, 37.5, 5737, 2185, 267, 8189
Daffyy, 1083, 38.1, 216, 277, 19, 512
dagah, 1329, 32.8, 2249, 2856, 163, 5268
dagano, 1539, 45.0, 1412, 991, 96, 2499
dagblad, 1421, 30.4, 13875, 21703, 1840, 37418
daggermate, 877, 99.3, 171, 303, 14, 488
dagoo, 1971, 30.7, 5753, 6146, 838, 12737
DaGreenster, 2086, 78.0, 534, 170, 22, 726
dagrobe, 1143, 33.9, 1410, 1928, 200, 3538
dagtwo, 1150, 219.4, 175, 233, 12, 420
dahai, 927, 40.2, 50, 92, 5, 147
DaHamma, 1999, 61.7, 523, 304, 9, 836
daheart, 1226, 174.3, 4, 10, 0, 14
Dahey, 1191, 207.4, 42, 36, 1, 79
DahvidTheeGreat, 898, 106.5, 74, 169, 5, 248
daidoji, 963, 238.1, 3, 9, 0, 12
DAisTRU, 1376, 253.3, 0, 3, 0, 3
daj, 916, 143.3, 578, 1377, 89, 2044
dajubo, 838, 121.5, 5, 12, 0, 17
dakaduke, 1064, 78.6, 26, 126, 4, 156
Dakinbear, 1256, 160.8, 5, 6, 0, 11
dakotafitz, 1194, 28.5, 7186, 7572, 522, 15280
dalaz, 1482, 102.3, 533, 499, 71, 1103
daler, 880, 91.1, 1332, 2078, 108, 3518
Dalgliesh, 1979, 27.7, 1826, 513, 107, 2446
DaliborL, 1306, 60.1, 1401, 1033, 166, 2600
DallasWe, 1595, 109.8, 276, 346, 19, 641
damabi, 1238, 36.2, 3318, 1876, 166, 5360
damchess, 1057, 27.2, 147, 156, 3, 306
DameRiVA, 1608, 76.6, 4033, 4611, 598, 9242
dameyune, 1103, 24.5, 1579, 2329, 68, 3976
Damianik, 884, 35.7, 303, 373, 13, 689
DamienBlack, 1271, 31.2, 1633, 2076, 159, 3868
damilasa, 1196, 24.6, 8022, 12288, 1031, 21341
Dammadman, 886, 35.2, 2254, 6152, 500, 8906
DAMNATIOH, 890, 23.3, 1265, 1158, 8, 2431
DamoKnight, 1296, 56.4, 737, 480, 52, 1269
damongermian, 1224, 74.2, 56, 98, 2, 156
DamonM, 1429, 25.0, 12843, 12702, 1082, 26627
damouno, 1982, 27.3, 2262, 1741, 302, 4305
DanAguiar, 1172, 55.6, 149, 184, 14, 347
danaildonev, 1507, 45.6, 375, 375, 49, 799
DanBest, 1203, 127.2, 32, 22, 5, 59
danbrug, 1375, 32.0, 834, 537, 69, 1440
dancegr, 725, 92.3, 25, 111, 0, 136
dancethecrow, 1235, 82.9, 545, 264, 22, 831
Dancing, 1326, 28.6, 22908, 5352, 685, 28945
dancor, 1180, 38.9, 255, 350, 33, 638
Dandro, 1349, 30.7, 1124, 1389, 44, 2557
daneg, 1410, 145.5, 130, 249, 14, 393
DaneGer, 1071, 120.1, 9, 23, 2, 34
danfrancisdo, 1018, 147.2, 1, 10, 0, 11
Dangerisgood, 1620, 74.3, 486, 1375, 86, 1947
danielboone, 1692, 62.9, 1356, 1632, 243, 3231
DanielCLA, 1556, 41.2, 964, 576, 58, 1598
DanielDumont, 1387, 64.1, 681, 455, 51, 1187
danielfrazon, 1468, 26.3, 2156, 2387, 266, 4809
danielKorea, 1594, 61.7, 253, 117, 16, 386
danielleshark, 1157, 118.3, 2680, 5912, 421, 9013
DanielSM, 1772, 35.6, 930, 588, 52, 1570
Danifeld, 1210, 158.3, 8, 15, 1, 24
danilogw, 1348, 39.4, 58, 51, 2, 111
DaniloP, 1698, 99.2, 1121, 598, 85, 1804
danilovich, 1434, 101.0, 5938, 6509, 466, 12913
danishwill, 900, 86.6, 29, 108, 1, 138
danjiun, 1389, 57.8, 435, 317, 29, 781
DanKolov, 1693, 136.5, 458, 483, 59, 1000
Danks, 1349, 66.3, 974, 405, 41, 1420
danluguer, 1421, 71.5, 340, 365, 11, 716
danmsft, 1367, 69.9, 1203, 542, 55, 1800
Dannis, 1384, 36.4, 4942, 3793, 185, 8920
dannyloans, 978, 86.3, 33, 91, 3, 127
danpi, 1345, 25.3, 2851, 3304, 227, 6382
DanseMacabre, 815, 64.0, 66, 190, 5, 261
Dantemedo, 962, 79.7, 215, 388, 14, 617
DanTilkin, 1603, 39.7, 4696, 3742, 662, 9100
DantonMAS, 1468, 87.8, 509, 377, 81, 967
dantur, 1412, 23.9, 5594, 5094, 584, 11272
DanZ, 1848, 27.3, 2353, 2303, 381, 5037
danzbar, 1752, 35.3, 736, 802, 92, 1630
Danzig, 1679, 47.8, 3903, 3063, 502, 7468
daran, 1652, 136.1, 7808, 9507, 771, 18086
Darenos, 1252, 43.7, 2701, 3641, 165, 6507
darev, 1187, 62.9, 40, 94, 7, 141
daridgides, 1702, 25.8, 5457, 4510, 310, 10277
dariote, 1516, 75.1, 773, 1045, 94, 1912
DarkBlues, 995, 31.0, 117, 257, 7, 381
DarkGauntlet, 1804, 16.5, 1838, 1959, 218, 4015
darkglobe, 1014, 47.4, 1115, 1568, 59, 2742
Darkknightre, 1029, 34.4, 1899, 4253, 103, 6255
DarkoChess, 1365, 30.2, 3259, 2760, 307, 6326
DarkpawnXLII, 1324, 34.3, 1060, 1249, 109, 2418
darkXknight, 1697, 114.0, 734, 373, 36, 1143
darkyvader, 1169, 56.3, 52, 69, 2, 123
darnakas, 1426, 29.4, 3043, 9941, 493, 13477
darqknight, 1267, 29.2, 3759, 2494, 389, 6642
darrenganga, 931, 63.2, 62, 185, 4, 251
darringtonman, 1394, 30.3, 7505, 7756, 826, 16087
Darrylsh, 1442, 29.8, 6366, 4615, 387, 11368
darscopick, 1173, 43.1, 629, 1155, 47, 1831
DarthDroshen, 1457, 28.5, 123, 131, 7, 261
DarthMaulDeaths, 1336, 120.4, 1, 17, 0, 18
DarthRomble, 677, 139.7, 3, 36, 0, 39
DarthSideburns, 1102, 120.0, 354, 638, 43, 1035
darthSiko, 1074, 86.4, 344, 365, 25, 734
dartking, 1445, 89.2, 200, 207, 11, 418
darumsdad, 954, 85.1, 147, 287, 5, 439
Darya, 1188, 25.4, 3491, 4387, 211, 8089
dassaf, 1251, 33.3, 3436, 4767, 193, 8396
datahook, 1676, 26.2, 2851, 2581, 256, 5688
datalex, 542, 96.5, 3, 57, 0, 60
Dataminer, 1140, 198.1, 330, 308, 40, 678
datoga, 2009, 99.7, 1583, 1330, 222, 3135
datoto, 1582, 30.6, 1351, 872, 73, 2296
davchess, 1135, 72.6, 154, 247, 10, 411
davdebrux, 1589, 31.6, 431, 365, 23, 819
daveburr, 1354, 25.8, 7785, 6681, 827, 15293
davecom, 1185, 34.1, 846, 1324, 117, 2287
DaveGahan, 1850, 51.5, 3133, 2051, 270, 5454
daveknox, 865, 82.9, 10, 21, 0, 31
DaveMcW, 1510, 49.5, 5258, 3813, 438, 9509
DaveMGrant, 1450, 33.2, 6898, 7657, 786, 15341
DaveMHenry, 933, 105.8, 38, 62, 0, 100
davenose, 1480, 29.0, 5071, 5567, 355, 10993
Daver, 1507, 24.3, 18133, 21388, 1282, 40803
daverikgomez, 1257, 95.9, 60, 64, 6, 130
DaveRod, 1414, 47.7, 189, 215, 18, 422
Daveroy, 1222, 91.7, 79, 65, 6, 150
DavetheBravest, 1169, 76.6, 1444, 2166, 178, 3788
davewoodhead, 1551, 14.3, 37353, 33862, 1651, 72866
DavidCLK, 1205, 53.3, 1369, 1356, 81, 2806
davidisflash, 1373, 71.4, 324, 390, 26, 740
DavidKevin, 1245, 90.9, 544, 468, 29, 1041
davidly, 608, 60.8, 34, 155, 4, 193
DavidRo, 1718, 42.7, 3717, 3117, 323, 7157
DavidRoch, 1726, 34.9, 504, 501, 53, 1058
davidsaccount, 1713, 71.3, 831, 537, 68, 1436
DavidWalter, 1637, 33.2, 1078, 479, 81, 1638
davidwebster, 1507, 139.2, 404, 315, 40, 759
davincy, 1551, 42.0, 3287, 4431, 143, 7861
davisZ, 1276, 78.2, 51, 33, 4, 88
davlanon, 1208, 52.4, 182, 213, 12, 407
davorin, 1495, 26.3, 12629, 8211, 714, 21554
Dawai, 1192, 64.4, 1013, 754, 58, 1825
DaWeazle, 1759, 26.3, 6435, 3192, 315, 9942
dawgdaddy, 1538, 33.0, 3976, 3224, 225, 7425
DawnParker, 1189, 31.0, 874, 684, 97, 1655
dawrhino, 1098, 52.9, 970, 1115, 75, 2160
Dayffd, 1389, 30.7, 2210, 1731, 171, 4112
Dayzzer, 1301, 33.8, 276, 264, 34, 574
dazdejkovic, 1623, 53.7, 1423, 1444, 143, 3010
dazdingo, 1855, 71.5, 42, 42, 4, 88
Dazzz, 1348, 59.3, 1336, 969, 145, 2450
dbala, 1196, 49.8, 1839, 1499, 101, 3439
DBalance, 1334, 216.5, 1, 2, 0, 3
dbasta, 1378, 42.5, 1429, 1280, 102, 2811
dbezz, 1387, 104.3, 514, 451, 40, 1005
dbins, 807, 111.0, 37, 146, 0, 183
DBouthot, 1459, 36.6, 2386, 2275, 250, 4911
dcbri, 1377, 58.8, 2191, 2930, 221, 5342
dchessfreak, 1502, 96.3, 645, 530, 148, 1323
dcloh, 1347, 49.8, 1440, 1092, 92, 2624
dcp, 1224, 28.9, 3232, 4170, 220, 7622
dddhgg, 1431, 24.9, 5272, 6811, 831, 12914
DDF, 1359, 128.7, 980, 781, 37, 1798
DDSquared, 1951, 24.8, 798, 1018, 133, 1949
ddunjic, 1155, 29.1, 356, 320, 11, 687
deacon, 1311, 30.4, 16448, 6001, 535, 22984
deadlyhades, 1047, 79.4, 82, 152, 7, 241
deadwooddoc, 1048, 181.9, 0, 15, 0, 15
deadxpool, 1501, 36.0, 2342, 1269, 112, 3723
DeathAdder, 1705, 38.9, 3157, 628, 111, 3896
DeathEater, 1498, 79.1, 1140, 252, 22, 1414
deathflower, 1677, 30.0, 188, 328, 26, 542
Deathnyte, 853, 231.5, 0, 3, 0, 3
DeathToken, 1606, 83.7, 17164, 9074, 1146, 27384
DeathToNWO, 1406, 23.3, 2428, 2538, 226, 5192
DeBeer, 1497, 81.5, 9105, 4698, 518, 14321
DebKing, 1526, 31.4, 3931, 3232, 294, 7457
debojit, 1248, 39.9, 1139, 1162, 55, 2356
Deca, 2083, 85.4, 620, 606, 139, 1365
Decemberist, 1590, 70.2, 102, 92, 10, 204
DeckardCain, 1732, 350.0, 1, 0, 0, 1
deckhand, 1315, 45.9, 174, 252, 20, 446
dedaMisa, 1107, 35.6, 260, 208, 24, 492
DEDave, 1244, 243.1, 1, 3, 0, 4
DeductionHunter, 2017, 40.3, 428, 293, 62, 783
Deejey, 1060, 238.6, 0, 3, 0, 3
deemark, 1670, 43.0, 565, 472, 37, 1074
Deepfluke, 1535, 249.2, 95, 92, 7, 194
deeppanther, 1523, 168.6, 8, 2, 1, 11
DeepPawn, 1377, 149.6, 5, 7, 1, 13
DeepPersian, 1643, 39.7, 660, 1268, 85, 2013
DeepThreat, 1612, 74.0, 999, 718, 90, 1807
deezul, 1100, 113.2, 266, 228, 6, 500
defconned, 1799, 99.1, 154, 88, 11, 253
defenderbwe, 1156, 53.0, 599, 438, 43, 1080
DeformedMarty, 2025, 51.1, 1849, 1196, 85, 3130
degoss, 1091, 39.5, 284, 400, 43, 727
Dejection, 1302, 35.2, 915, 748, 70, 1733
dekwarn, 870, 227.6, 1, 13, 0, 14
DeLaFere, 1225, 27.1, 2803, 3384, 279, 6466
Delaneytmd, 1227, 21.2, 1118, 1639, 112, 2869
Delenn, 1688, 75.2, 396, 329, 49, 774
Delfrate, 1081, 41.0, 292, 636, 10, 938
DelhiBoy, 1624, 21.3, 2272, 2898, 182, 5352
DelicateMonster, 1199, 40.4, 2140, 1300, 102, 3542
DeliveryBoy, 1466, 28.2, 5045, 5390, 539, 10974
dellmusashi, 1092, 82.4, 51, 235, 4, 290
delnaze, 1845, 30.9, 6396, 5617, 703, 12716
delonga, 939, 93.4, 251, 302, 16, 569
deltanovethc, 1460, 96.6, 10624, 19171, 700, 30495
Deltavelorum, 1300, 34.1, 1879, 1396, 133, 3408
Delteam, 1175, 48.8, 736, 835, 33, 1604
DelToro, 1339, 212.9, 138, 489, 17, 644
delwin, 1311, 41.5, 5078, 5990, 419, 11487
Demain, 1876, 78.6, 4843, 4860, 855, 10558
Dementor, 1713, 25.2, 5016, 2938, 489, 8443
demion, 1276, 30.8, 4211, 4972, 371, 9554
Dencat, 1669, 71.5, 3680, 3759, 415, 7854
dened, 1170, 244.3, 1, 2, 0, 3
dengbo, 1918, 40.8, 1187, 1165, 143, 2495
denismolch, 1022, 93.0, 3, 15, 0, 18
denisrud, 1287, 97.1, 70, 130, 5, 205
dennisx, 1388, 26.2, 2418, 3232, 234, 5884
dennmann, 1283, 145.0, 187, 230, 21, 438
denonym, 1657, 30.4, 928, 500, 66, 1494
DeNovoMeme, 993, 138.6, 5, 32, 0, 37
Denrique, 978, 123.4, 9, 18, 1, 28
densuprun, 1752, 36.6, 4487, 6389, 496, 11372
Deos, 1469, 30.1, 4505, 4321, 346, 9172
Depfile, 917, 151.9, 134, 298, 5, 437
depittydawg, 976, 144.0, 83, 178, 9, 270
depresija, 1263, 25.5, 8462, 15101, 841, 24404
deraltesuv, 935, 129.7, 4, 13, 0, 17
dere, 1654, 95.2, 3870, 2960, 254, 7084
dereklau, 1759, 28.3, 3918, 3752, 358, 8028
DerFahnder, 770, 120.3, 30, 66, 2, 98
deribou, 1250, 259.0, 3, 3, 0, 6
DerMorgenstern, 1040, 173.7, 7, 22, 3, 32
derschachkonni, 1172, 47.2, 195, 230, 15, 440
Dertygoon, 1097, 46.0, 275, 361, 17, 653
Deryan, 845, 23.9, 1103, 1527, 196, 2826
descent, 1413, 39.6, 876, 989, 66, 1931
Desdon, 1175, 69.1, 22, 44, 2, 68
Desecration, 1465, 57.4, 1088, 991, 69, 2148
desertfish, 1859, 28.1, 1026, 446, 99, 1571
desertflower, 1776, 125.2, 693, 871, 110, 1674
desiobu, 1480, 27.1, 4001, 3940, 305, 8246
desman, 1124, 91.3, 181, 220, 8, 409
desmarais, 1375, 106.2, 3261, 3318, 148, 6727
desmondfox, 1672, 65.4, 13, 18, 2, 33
Despi, 1659, 32.7, 15958, 14869, 1265, 32092
DestinedToMate, 919, 127.6, 24, 56, 2, 82
detam, 1378, 94.9, 3676, 5616, 231, 9523
devagar, 1433, 31.4, 1040, 852, 119, 2011
devaj, 1733, 65.3, 453, 696, 32, 1181
DeViezeMan, 1964, 41.9, 102, 77, 12, 191
devilant, 1700, 42.4, 2056, 1754, 196, 4006
Devilsbishop, 1594, 26.5, 3998, 5629, 458, 10085
Deviltown, 1588, 26.5, 10343, 10480, 875, 21698
DevilzX, 1498, 192.6, 2, 6, 0, 8
devman, 1309, 65.1, 29, 75, 2, 106
devonchess, 1472, 34.7, 6108, 6632, 588, 13328
devouth, 1223, 59.4, 1100, 2386, 88, 3574
dewildwestkid, 1337, 102.3, 49, 112, 0, 161
Dewofheaven, 1566, 69.7, 3920, 1979, 271, 6170
deworger, 1907, 27.3, 4283, 4123, 628, 9034
dfalgout, 496, 130.8, 6, 125, 2, 133
dfelix, 1609, 33.1, 1678, 1096, 178, 2952
dfgordon, 1886, 40.0, 3606, 1446, 450, 5502
dflam, 1312, 81.8, 135, 160, 6, 301
dfunt, 1394, 66.6, 621, 574, 62, 1257
dgeorgeccc, 1452, 21.0, 3025, 2219, 234, 5478
dgmcremer, 1034, 50.3, 121, 190, 13, 324
dgrdixon, 1308, 72.4, 1779, 2290, 75, 4144
dhaniahmad, 1048, 127.1, 21, 153, 2, 176
Dhanlimboo, 715, 99.5, 14, 247, 4, 265
dhanus, 1243, 109.7, 113, 168, 16, 297
DhirenVS, 1568, 26.1, 5362, 6678, 282, 12322
diablomaster, 1548, 29.3, 601, 547, 82, 1230
Diagonaliser, 1715, 60.6, 3802, 3952, 351, 8105
diamat, 1512, 23.2, 3424, 4955, 273, 8652
diamondjen, 732, 48.7, 110, 643, 6, 759
dianagupta, 1267, 151.8, 10, 10, 0, 20
DianaJacka, 2108, 41.9, 431, 255, 76, 762
Diboss, 1823, 28.8, 4217, 3979, 746, 8942
Dicemice, 772, 130.7, 96, 562, 26, 684
dickluca, 1504, 81.0, 74, 40, 10, 124
dididothat, 1908, 45.1, 2689, 1003, 140, 3832
Didius, 1809, 134.7, 1832, 307, 105, 2244
DiduLudidu, 1676, 30.1, 7149, 3337, 457, 10943
diegar, 1209, 27.1, 1031, 1424, 96, 2551
diegobertucco, 1642, 23.6, 6582, 4463, 357, 11402
diegodie, 1217, 224.4, 0, 2, 0, 2
diegodon, 1845, 52.7, 2643, 2096, 356, 5095
diegog, 1242, 66.8, 3855, 1791, 164, 5810
diegovaquero, 1681, 48.0, 725, 1130, 162, 2017
DieselBurner, 1153, 60.1, 291, 387, 17, 695
diggin, 1854, 27.2, 1161, 2232, 445, 3838
diggsdiggs, 1326, 124.2, 722, 1022, 67, 1811
Dihaz, 1206, 42.1, 1533, 2685, 170, 4388
Dijon, 1211, 64.6, 511, 626, 39, 1176
diluido, 1152, 89.3, 949, 1805, 86, 2840
Dimaoooo, 2088, 320.8, 11, 0, 0, 11
dimaperes, 1632, 48.9, 47, 36, 10, 93
dimasha, 1508, 47.5, 651, 645, 58, 1354
Dimitra, 1174, 57.2, 2140, 2168, 159, 4467
DimkinB, 1195, 33.5, 532, 1040, 74, 1646
Diner, 1599, 34.7, 5323, 3336, 423, 9082
dingoJr, 1328, 76.3, 5699, 6355, 336, 12390
Dinkum, 1356, 145.2, 166, 216, 18, 400
DinoSpider, 1053, 258.6, 0, 4, 0, 4
DINOSSAURO, 1391, 69.3, 45, 40, 4, 89
diogenisd, 1453, 39.5, 796, 181, 80, 1057
dionysusv, 1706, 32.1, 8224, 5777, 492, 14493
DiophantMP, 962, 28.8, 240, 358, 10, 608
Diophantos, 1398, 79.5, 1566, 1348, 96, 3010
Diori, 1280, 37.0, 664, 664, 48, 1376
dip, 1223, 54.5, 108, 126, 18, 252
dipblu, 1241, 23.7, 17574, 18649, 1738, 37961
Dircks, 1742, 32.1, 5251, 1335, 291, 6877
DirkElse, 1250, 31.5, 557, 340, 24, 921
dirtdevil, 709, 98.8, 17, 111, 1, 129
dirtyforker, 1561, 35.9, 3852, 1594, 289, 5735
DirtyHarry, 1843, 55.9, 3018, 4609, 726, 8353
dirtymoney, 1264, 32.8, 698, 628, 43, 1369
disakh, 1552, 25.9, 2085, 1890, 159, 4134
Discoflux, 1046, 28.5, 1138, 1699, 81, 2918
DiscoKnight, 1650, 52.3, 3272, 3031, 381, 6684
Dismemberer, 1594, 95.1, 250, 178, 19, 447
DisonBSB, 900, 47.0, 215, 476, 7, 698
Disquiet, 1288, 57.3, 2145, 2416, 231, 4792
DissidentICN, 1259, 91.9, 245, 219, 28, 492
ditolla, 1859, 74.7, 8290, 7843, 1542, 17675
diverse, 1002, 102.2, 123, 271, 6, 400
Divljak, 1587, 27.7, 13779, 11689, 1204, 26672
DIwakaremo, 1427, 26.3, 1676, 3826, 181, 5683
DixierRebel, 1511, 28.6, 4950, 5595, 569, 11114
dizpater, 1527, 59.2, 3291, 2714, 218, 6223
dizzyllama, 1413, 109.1, 1536, 2080, 139, 3755
djaeronaughty, 1076, 64.1, 68, 412, 10, 490
Djangostiger, 1342, 31.2, 5350, 3689, 315, 9354
djangp, 1479, 16.3, 3618, 3033, 220, 6871
djanowski, 1423, 169.3, 7, 4, 0, 11
djaps, 1329, 67.4, 286, 412, 19, 717
djinmaster, 1440, 27.5, 5743, 5648, 401, 11792
djinnome, 1163, 43.0, 255, 517, 16, 788
djintonic, 1484, 35.5, 5374, 3394, 331, 9099
djjazzyjeff, 1393, 56.4, 2235, 1289, 115, 3639
DJJDev, 1203, 24.2, 2349, 4178, 311, 6838
DJKat, 1768, 25.6, 4557, 4841, 486, 9884
djlewis, 1090, 26.5, 3874, 4186, 80, 8140
DJLikimama, 1047, 118.0, 42, 97, 4, 143, 1943, 59.3, 1325, 701, 74, 2100
DjMochaFrapp, 1052, 33.8, 245, 576, 23, 844
djmyko, 1229, 37.8, 415, 427, 16, 858
Djore, 1153, 147.9, 60, 66, 6, 132
djrsousa, 867, 198.9, 0, 6, 1, 7
DJSchmitty, 1874, 256.8, 3, 0, 0, 3
djurijs, 1480, 38.8, 3253, 1611, 150, 5014
DJusaLATX, 932, 70.2, 144, 252, 4, 400
dkahnd, 1139, 50.9, 1020, 1156, 58, 2234
dkappe, 1639, 23.0, 3299, 4035, 361, 7695
DKBLITZ, 1312, 63.9, 43, 62, 1, 106
DKeeper, 1490, 137.8, 9, 25, 2, 36
dks, 1189, 110.9, 471, 1282, 30, 1783
dkwinwin, 1265, 62.5, 603, 457, 51, 1111
DlanorPierre, 1219, 112.7, 186, 191, 8, 385
dlee, 1449, 44.3, 3007, 2370, 329, 5706
dleitem, 1098, 35.5, 1100, 1704, 171, 2975
DLeviathan, 1280, 40.2, 1693, 1635, 124, 3452
DLGuest, 1348, 26.5, 1531, 1475, 50, 3056
dlittlebear, 777, 155.7, 2, 12, 0, 14
DLS, 1670, 36.0, 5857, 4291, 286, 10434
DMasters, 1614, 22.7, 1042, 917, 75, 2034
DmCh, 1653, 76.6, 153, 281, 19, 453
DmitryD, 1185, 286.9, 569, 430, 23, 1022
dmkplace, 1292, 169.8, 1, 32, 0, 33
dms, 1512, 30.7, 7101, 5186, 752, 13039
DMStarker, 1361, 31.9, 1996, 2854, 186, 5036
dmtom, 1646, 41.7, 1185, 848, 141, 2174
Dndaoud, 1069, 78.6, 62, 113, 3, 178
dnelre, 1659, 42.8, 884, 646, 77, 1607
dni, 1090, 37.3, 4408, 5306, 410, 10124
dnk, 1675, 103.3, 1736, 1027, 46, 2809
DocBrock, 1247, 32.8, 6666, 7729, 415, 14810
Docdhc, 1090, 32.4, 2050, 2284, 52, 4386
docentdenev, 1316, 52.4, 1030, 1275, 48, 2353
DocHammer, 795, 267.0, 0, 2, 0, 2
docmax, 1438, 47.5, 7219, 1944, 408, 9571
docsam, 1713, 46.2, 3135, 3039, 356, 6530
DOCTOERDETROIT, 1250, 62.7, 2642, 3398, 248, 6288
DoctorColossus, 1480, 56.0, 1127, 1018, 119, 2264
Doctorisin, 1130, 39.3, 8164, 10299, 675, 19138
DoctorOfChess, 1385, 29.0, 746, 2390, 85, 3221
DoctorRock, 1446, 51.1, 1454, 671, 119, 2244
doctrpain, 1410, 33.6, 2697, 2236, 288, 5221
dodeka, 1577, 29.4, 2601, 3669, 317, 6587
dodgerblue, 1596, 136.2, 103, 42, 2, 147
dodiesis, 1407, 36.5, 4823, 6960, 595, 12378
DoDoKinG, 921, 69.1, 37, 102, 1, 140
doebs, 1200, 45.4, 2416, 3388, 199, 6003
doemaareenzet, 1794, 30.6, 9924, 8233, 1208, 19365
dogbrother, 953, 61.0, 3213, 4984, 183, 8380
dogfaraway, 1149, 74.7, 120, 164, 6, 290
doggone, 1489, 37.6, 4979, 2295, 367, 7641
dogtooth, 1468, 43.3, 122, 55, 7, 184
Dogyou, 952, 39.3, 489, 1886, 41, 2416
dolgopa, 880, 75.0, 35, 122, 0, 157
DollyH, 948, 80.3, 13, 44, 0, 57
dolochovi, 1154, 168.6, 2, 11, 1, 14
domingocanlobo, 1282, 27.7, 1566, 1119, 49, 2734
dominospizza, 1616, 24.4, 5991, 4837, 727, 11555
DomMacleod, 1509, 96.6, 2069, 1489, 112, 3670
dommel, 1549, 32.9, 7536, 5816, 523, 13875
domspecn, 1257, 46.0, 166, 254, 11, 431
domus, 1534, 64.1, 2465, 1598, 162, 4225
domvar, 1523, 34.6, 1226, 1293, 268, 2787
Donahue, 821, 81.7, 19, 187, 4, 210
Donattello, 1585, 61.5, 7849, 8741, 906, 17496
DonCid, 1700, 24.6, 3262, 3004, 329, 6595
DonConchi, 1558, 25.2, 390, 270, 15, 675
dondst, 1649, 33.6, 2184, 2261, 246, 4691
donkeyjote, 1569, 44.7, 863, 323, 50, 1236
donkSTRIKER, 983, 84.0, 266, 474, 19, 759
donlorenzo, 1171, 35.5, 994, 2097, 41, 3132
Donnybrook, 884, 221.3, 110, 485, 9, 604
donomar, 1408, 31.8, 6929, 10750, 703, 18382
DoNotCheat, 1508, 92.1, 276, 253, 22, 551
donovanski, 1171, 40.3, 616, 704, 63, 1383
donpachi, 1948, 25.4, 4926, 1583, 530, 7039
DonPacifico, 1610, 38.5, 569, 716, 74, 1359
donshakespeare, 1033, 34.4, 214, 244, 38, 496
Donster, 1350, 38.8, 7064, 3158, 372, 10594
dontpanicarthur, 1077, 131.8, 294, 377, 11, 682
DonutHole, 1546, 94.0, 224, 181, 21, 426
DonValtr, 1229, 52.2, 128, 178, 8, 314
DonVito, 1342, 86.6, 1722, 1729, 124, 3575
donwood, 1314, 75.0, 695, 446, 68, 1209
Doodi, 882, 95.1, 155, 253, 5, 413
Doooovid, 1801, 25.1, 3191, 2246, 358, 5795
doosra, 1098, 66.7, 93, 183, 6, 282
dopeass, 1100, 135.0, 1, 10, 0, 11
Dorimyu, 1053, 127.9, 355, 493, 26, 874
doroodgar, 1226, 43.5, 57, 57, 9, 123
DorskNorsk, 1517, 19.6, 34405, 36777, 1635, 72817
Dorya, 808, 183.9, 159, 406, 13, 578
Dossilicious, 1075, 66.9, 144, 150, 11, 305
dost, 1378, 45.1, 7320, 10763, 606, 18689
dostoevsky, 1686, 107.9, 495, 625, 61, 1181
DoubleBogey, 1304, 22.8, 15893, 14648, 1382, 31923
doublelocked, 1307, 102.2, 256, 443, 51, 750
doublerook, 1442, 31.8, 2281, 4037, 221, 6539
doublexclam, 1970, 26.7, 1497, 1671, 111, 3279
doubtfulmid, 1272, 81.4, 194, 269, 29, 492
DouglasKanov, 1663, 61.0, 969, 987, 66, 2022
doulie, 1287, 70.0, 196, 137, 23, 356
douthy, 1263, 106.4, 5165, 4796, 539, 10500
douville, 1124, 121.1, 299, 373, 10, 682
dovijanic, 2084, 46.5, 2737, 3511, 299, 6547
downbutnotout, 1345, 32.5, 672, 600, 44, 1316
Downtube, 1414, 36.4, 1207, 1110, 119, 2436
doxa, 1214, 32.6, 5214, 11420, 504, 17138
Dozorov, 1397, 81.8, 717, 578, 51, 1346
dpakgtm, 1096, 39.2, 54, 55, 3, 112
dpchess, 1465, 34.6, 3700, 3151, 469, 7320
dphdsr, 1237, 26.6, 996, 1690, 95, 2781
dpilgrimway, 1069, 350.0, 0, 1, 0, 1
dpopovi, 1832, 34.6, 5383, 1847, 433, 7663
Dpouchy, 1076, 28.9, 8108, 11576, 294, 19978
DPR, 1238, 126.0, 608, 314, 19, 941
dprizoner, 1428, 94.5, 29, 29, 3, 61
dprjones, 876, 109.5, 36, 94, 3, 133
DPruitt, 1085, 36.5, 658, 789, 57, 1504
dpukkah, 1385, 34.4, 1581, 2283, 110, 3974
dpzen, 1513, 34.6, 335, 245, 22, 602
DraganGlas, 1430, 38.3, 2737, 4311, 167, 7215
draganj, 1711, 33.8, 2507, 3434, 460, 6401
dragans, 1138, 39.4, 1361, 1190, 57, 2608
draglion, 1351, 59.7, 263, 228, 43, 534
DragonAce, 1811, 23.3, 7197, 6087, 770, 14054
DRAGONdani, 1544, 35.2, 4460, 5687, 450, 10597
Dragonddt, 1441, 135.8, 21, 21, 3, 45
dragondemon, 982, 96.1, 63, 87, 1, 151
DragonflyKing, 1065, 38.1, 1164, 1356, 69, 2589
Dragonfool, 1013, 33.6, 684, 2109, 28, 2821
dragonhouse, 1445, 36.4, 4333, 3409, 267, 8009
dragonhrt, 1157, 32.6, 1678, 1872, 69, 3619
dragonindia, 1604, 125.0, 4272, 3846, 432, 8550
dragonmutt, 1818, 31.8, 1859, 544, 70, 2473
Dragonss, 1338, 176.6, 6, 6, 0, 12
DragonWasp, 1511, 39.5, 5599, 3631, 573, 9803
DragonWater, 1204, 45.1, 1097, 1155, 70, 2322
dragunflyorig, 1088, 34.4, 3532, 4591, 116, 8239
Drakem, 1709, 52.4, 4553, 5190, 466, 10209
DRAKES, 1267, 207.1, 8, 5, 0, 13
Draknils, 861, 107.6, 35, 116, 3, 154
drakorg, 1328, 150.4, 1861, 1836, 92, 3789
Draqnur, 1473, 29.9, 5911, 4755, 352, 11018
Dravenspawn, 1127, 102.2, 1476, 1856, 140, 3472, 1869, 40.3, 2889, 485, 147, 3521
drcaz, 957, 84.5, 47, 130, 3, 180
DrDoodles, 1345, 68.5, 186, 159, 21, 366
Dreadtower, 1126, 68.3, 1361, 1487, 173, 3021
Dreal, 904, 58.1, 146, 472, 2, 620
DreamBasher, 1074, 67.7, 308, 376, 24, 708
DreamerJen, 1509, 194.3, 2, 5, 0, 7
Dreamoonplayer, 1096, 81.3, 52, 145, 0, 197
dreamscometrue, 1274, 55.0, 3696, 3091, 219, 7006
DreamSoLD, 1736, 25.0, 9989, 12341, 927, 23257
Dreamtiger, 1480, 42.0, 328, 252, 26, 606
Dregandice, 853, 81.2, 40, 133, 1, 174
Dresah, 1532, 51.8, 639, 646, 48, 1333
drevilsrevenge, 1325, 80.1, 362, 322, 40, 724
drewchess, 1295, 24.9, 6511, 6328, 507, 13346
drewe, 1563, 89.7, 2638, 1296, 133, 4067
DrewM, 1240, 149.9, 1, 7, 0, 8
Drewskidog, 1066, 29.4, 5398, 13261, 491, 19150
drewwid, 1786, 91.5, 372, 287, 54, 713
Drfbel, 1992, 34.1, 7320, 5043, 661, 13024
DrFloyd, 1362, 57.2, 496, 416, 36, 948
DrFractal, 1565, 67.4, 327, 256, 48, 631
Dribbel, 1525, 52.7, 2482, 2106, 160, 4748
drinkingwater, 1383, 28.1, 2574, 2450, 233, 5257
DriveBy, 955, 145.4, 31, 47, 6, 84
drjineshm, 1285, 39.1, 278, 266, 16, 560
drknightley, 1629, 34.6, 2747, 2188, 154, 5089
drleper, 1450, 65.7, 278, 190, 35, 503
DrLivesey, 1643, 63.6, 1966, 847, 115, 2928
DrLx, 1533, 47.8, 1078, 931, 160, 2169
dropofahat, 947, 36.5, 67, 125, 2, 194
DropVolley, 1586, 24.9, 13475, 18756, 2243, 34474
drovosek, 935, 88.5, 13, 48, 0, 61
drowinbandung, 746, 50.2, 71, 247, 3, 321
DrOzark, 1037, 98.3, 12, 21, 0, 33
drpesic, 1297, 32.4, 1635, 874, 56, 2565
DrQuiteaFish, 1491, 39.2, 1114, 685, 74, 1873
DrRai, 1679, 72.4, 3133, 4226, 540, 7899
DRrenard, 1213, 127.4, 4, 14, 1, 19
DrRick, 1383, 306.5, 0, 1, 0, 1
drrob, 1000, 78.8, 126, 146, 9, 281
DrRoscoe, 1476, 45.3, 471, 330, 69, 870
drsoji, 1331, 256.8, 0, 2, 0, 2
DrStupp, 1260, 24.9, 6639, 6874, 462, 13975
drtarunmitra, 1393, 31.8, 1975, 3019, 177, 5171
drTiele, 1716, 121.6, 755, 482, 65, 1302
drtim, 1217, 27.8, 14588, 17616, 1228, 33432
DrToma, 1907, 34.7, 917, 440, 96, 1453
drumme, 1353, 28.0, 4662, 4098, 148, 8908
drummerforlife, 1242, 41.5, 34, 84, 4, 122
drumset, 1115, 42.3, 1075, 686, 66, 1827
drumstick, 1549, 35.9, 3969, 3550, 272, 7791
drunkenstudent, 692, 165.1, 0, 10, 0, 10
DrunkGangsta, 1405, 160.3, 96, 78, 15, 189
drunkhominind, 1303, 47.8, 310, 377, 26, 713
drusliphay, 1288, 51.2, 86, 49, 3, 138
druze, 1631, 157.7, 6, 4, 0, 10
drvallabhai, 1307, 78.8, 335, 241, 19, 595
DrVasarhelyi, 1570, 39.7, 1214, 891, 117, 2222
DrVenomKill, 1417, 48.2, 415, 235, 10, 660
drwil, 1337, 27.7, 3864, 6952, 417, 11233
Dryden, 1416, 71.5, 1460, 1542, 155, 3157
DrYnti, 1373, 31.1, 1954, 2193, 241, 4388
DrywallRickshaw, 1177, 40.5, 768, 1541, 108, 2417
drzach, 966, 71.2, 23, 66, 4, 93
dshorwich, 1516, 35.5, 11150, 5636, 490, 17276
DSJ, 908, 125.4, 76, 222, 14, 312
Dskjockey, 951, 88.0, 123, 181, 9, 313
DSLtec, 1479, 51.9, 1788, 749, 244, 2781
Dsmith, 1647, 184.1, 370, 334, 33, 737
dsmithuc, 1524, 45.9, 2541, 3234, 273, 6048
dsoneenc, 1286, 79.6, 191, 195, 13, 399
dstaplet, 880, 100.5, 23, 56, 1, 80
dstrout, 1522, 62.0, 1573, 1879, 353, 3805
Dszudszak, 1059, 44.2, 640, 2877, 94, 3611
Dtchess, 1487, 24.8, 612, 1262, 106, 1980
dth, 1339, 22.5, 2641, 2472, 181, 5294
dtm, 1492, 61.5, 2291, 1329, 118, 3738
dtorbo, 1287, 28.1, 3289, 3288, 286, 6863
DTower, 1377, 48.5, 2907, 2680, 347, 5934
DubbleD, 1434, 99.1, 320, 269, 17, 606
DUBBLEX, 1267, 83.3, 1418, 1878, 139, 3435
Dubforlife, 1736, 31.2, 1066, 774, 133, 1973
Dubina, 1578, 39.7, 9417, 10241, 941, 20599
dubiousfact, 1405, 136.2, 938, 626, 64, 1628
Duckcat, 1843, 90.8, 369, 240, 5, 614
Duckington, 1154, 99.6, 79, 123, 3, 205
Ducorguy, 1191, 27.5, 1972, 3521, 183, 5676
DudeDao, 1206, 126.4, 107, 125, 6, 238
dudemchungry, 1413, 118.0, 9, 25, 0, 34
Duf, 1737, 67.1, 23891, 9196, 1332, 34419
duhme, 1489, 22.5, 6866, 5987, 812, 13665
duigi, 1858, 65.3, 614, 216, 67, 897
Duin, 1689, 20.6, 2104, 1121, 115, 3340
DukeAlbertNYC, 1205, 177.0, 26, 62, 1, 89
DukeCity, 1477, 26.2, 673, 493, 38, 1204
dukelone, 1108, 40.7, 230, 390, 14, 634
Dumbhead, 1863, 27.5, 9682, 7765, 552, 17999
dumdidum, 1913, 23.9, 4405, 3367, 517, 8289
dunamos, 1389, 34.8, 4927, 4831, 193, 9951
dungcao, 1606, 115.5, 142, 57, 3, 202
duniel, 1522, 100.7, 42, 66, 6, 114
Dunking, 1639, 27.3, 3320, 2429, 321, 6070
duplica, 1286, 28.9, 1562, 1719, 221, 3502
DuPontDoc, 1465, 39.5, 11859, 6592, 713, 19164
Dupontel, 1183, 26.9, 745, 1651, 81, 2477
Duquesne, 1142, 30.1, 11212, 13619, 1132, 25963
Duraidm, 1034, 49.0, 128, 373, 9, 510
durantex, 1827, 163.0, 2851, 1595, 127, 4573
duraysteeus, 960, 45.0, 482, 1139, 28, 1649
Dureflame, 859, 81.6, 17, 73, 3, 93
DusanzD, 1835, 25.8, 3248, 1713, 232, 5193
dushes, 1572, 53.3, 5639, 6203, 377, 12219
dushesatchess, 1551, 26.5, 393, 328, 38, 759
dustey, 1112, 43.1, 3121, 3809, 309, 7239
dustineichelberge, 940, 84.1, 290, 525, 21, 836
DustinH, 1398, 98.2, 190, 175, 7, 372
Dustysky, 820, 102.4, 173, 424, 13, 610
DutchChessHustler, 1570, 32.6, 66, 74, 10, 150
dutchgeorge, 1539, 25.0, 13626, 23150, 2214, 38990
DutchStonewall, 1160, 46.9, 133, 185, 11, 329
dvaldez, 1580, 121.6, 109, 86, 7, 202
dvayntrub, 1867, 36.4, 6479, 3708, 725, 10912
DVDMASTER, 943, 125.1, 15, 27, 1, 43
dvdsansay, 1341, 36.1, 2699, 2931, 206, 5836
Dviet, 1263, 31.2, 613, 871, 47, 1531
Dvolkov, 1986, 33.8, 300, 205, 40, 545
Dwagner, 1413, 55.8, 906, 794, 151, 1851
dwilliams, 1039, 38.2, 674, 2139, 54, 2867
dwillnu, 1147, 33.5, 970, 1296, 62, 2328
dwit, 989, 60.4, 41, 102, 3, 146
dwsta, 1320, 35.6, 850, 1177, 37, 2064
Dxennu, 1366, 36.1, 1492, 2477, 197, 4166
dyingstar, 1609, 141.8, 245, 339, 62, 646
dylanchess, 1641, 40.7, 1121, 1954, 192, 3267
dylanger, 1596, 47.9, 787, 709, 43, 1539
dylar, 1198, 39.4, 2409, 2331, 223, 4963
dylly, 1575, 115.4, 49, 90, 6, 145
Dynamit, 1302, 27.3, 2646, 2153, 320, 5119
Dyskolatapramata, 1619, 116.2, 3194, 2712, 218, 6124
Dysnomia, 1491, 126.0, 307, 193, 29, 529
Dzeff, 1335, 25.7, 11683, 13490, 1224, 26397
dzeronimo, 1135, 48.9, 192, 271, 22, 485
dzhou, 1152, 197.1, 51, 57, 2, 110
dzomba, 1837, 41.7, 5641, 3724, 430, 9795
eaenki, 1426, 36.7, 1634, 1929, 248, 3811
eagly, 1087, 50.7, 172, 326, 11, 509
EAGW, 1069, 72.5, 37, 54, 6, 97
EamonGeorge, 870, 251.0, 4, 18, 0, 22
eamonnwalls, 1603, 102.0, 3543, 1527, 176, 5246
EarlthePearl, 1500, 34.7, 9218, 11384, 1174, 21776
earthhnut, 1661, 48.6, 350, 163, 17, 530
EarthSpirit, 1496, 80.4, 475, 216, 28, 719
earthtokevin, 986, 41.1, 1052, 1638, 46, 2736
easiest, 2110, 83.0, 673, 336, 50, 1059
eastbound, 1273, 68.4, 1242, 972, 71, 2285
easterndunkers, 1733, 96.8, 616, 444, 74, 1134
EastetdayJason, 1362, 55.3, 111, 87, 11, 209
Easybeat, 1590, 89.8, 680, 530, 38, 1248
easybreezy, 1413, 55.7, 273, 309, 21, 603
EasyG, 911, 99.9, 6, 14, 0, 20
easypawn, 1631, 96.5, 201, 97, 4, 302
Eatan, 1489, 100.4, 1609, 3789, 195, 5593
eatbacon, 1610, 66.5, 306, 245, 30, 581
eatingcake, 1428, 64.8, 999, 1098, 71, 2168
Eattheapple, 1269, 31.0, 491, 748, 14, 1253
eatwithafork, 1423, 39.5, 722, 592, 45, 1359
ebenezer, 1926, 73.9, 492, 156, 41, 689
ebermarco, 1281, 38.8, 1070, 475, 84, 1629
ebnflower, 796, 127.6, 5, 33, 0, 38
eburger, 1289, 27.6, 4692, 5728, 142, 10562
Ecgbert, 1280, 73.6, 2795, 3627, 181, 6603
ecirp, 1133, 33.5, 1895, 1404, 119, 3418
Eclectico, 1628, 31.2, 3022, 3064, 376, 6462
ecochallenge, 1113, 59.8, 18, 24, 4, 46
EColle, 1473, 34.9, 6470, 7464, 667, 14601
ecrvimun, 1635, 85.3, 488, 226, 44, 758
Ecstatic, 1307, 45.4, 772, 1558, 116, 2446
ECurtin, 1789, 32.7, 1365, 1794, 189, 3348
EDCE, 984, 42.7, 274, 160, 5, 439
EddieSG, 1192, 66.6, 679, 670, 62, 1411
eddievg, 1535, 55.8, 494, 556, 42, 1092
EddieWinslow, 1916, 28.7, 2042, 572, 75, 2689
eddyfactor, 977, 24.1, 1940, 2185, 188, 4313
edeserr, 1657, 28.2, 2496, 2256, 239, 4991
EdgarPoe, 1596, 22.4, 2705, 3075, 241, 6021
eDGECRUSHER, 1817, 63.4, 2043, 1936, 225, 4204
EdHoculi, 1669, 19.8, 3092, 4996, 860, 8948
edikm, 1562, 20.5, 13246, 25385, 2302, 40933
edilence, 1241, 37.7, 845, 1093, 55, 1993
edkardoso, 1189, 73.3, 155, 187, 9, 351
edkl, 1297, 26.7, 11016, 7153, 710, 18879
edl, 1661, 31.6, 11791, 18163, 1160, 31114
edluvrr, 979, 141.5, 37, 87, 4, 128
Ednett, 1475, 31.0, 11240, 7244, 965, 19449
EdoRahman, 1516, 25.8, 290, 419, 14, 723
edrobaza, 1021, 208.3, 1, 8, 0, 9
Edronax, 1636, 75.4, 985, 997, 142, 2124
edsuom, 1098, 65.3, 611, 928, 70, 1609
edt, 1511, 30.3, 2337, 1384, 261, 3982
eduitu, 1276, 42.6, 2702, 2808, 195, 5705
Edvardinho, 1171, 56.1, 625, 877, 90, 1592
EDVSR, 1061, 40.0, 4402, 6793, 690, 11885
edwardd, 1612, 26.0, 6002, 6303, 489, 12794
EeePCseries, 1447, 65.8, 1358, 1796, 200, 3354
eeerrr, 878, 84.6, 35, 120, 1, 156
eejl, 790, 170.2, 1, 5, 0, 6
eepee, 1645, 34.7, 21108, 28300, 2462, 51870
effour, 1656, 83.9, 12071, 10645, 1153, 23869
egana, 1232, 42.8, 137, 313, 14, 464
eggcellent, 1277, 31.6, 2457, 4648, 222, 7327
eggertol, 1382, 38.4, 386, 385, 34, 805
Eggie, 1224, 114.4, 833, 424, 73, 1330
eggplant, 1108, 118.9, 1158, 1527, 117, 2802
EgoKnight, 1489, 37.3, 1602, 1019, 168, 2789
EGRENY, 1721, 187.4, 598, 429, 36, 1063
Egygtt, 1079, 63.6, 51, 66, 2, 119
Egymas, 1174, 92.4, 1132, 2193, 121, 3446
Egyptology, 1599, 26.7, 6795, 7323, 522, 14640
Ehalperin, 1809, 42.8, 4146, 4137, 489, 8772
ehvmc, 1323, 90.3, 11, 18, 2, 31
Eichhoernchen, 1916, 31.8, 371, 200, 37, 608
Eightpointer, 1271, 93.5, 67, 148, 10, 225
EIKKO, 1111, 47.5, 2507, 2832, 178, 5517
eikku, 1706, 28.3, 2398, 3403, 526, 6327
EinerWieKeiner, 1739, 31.1, 10267, 15533, 1287, 27087
Einzelganger, 1741, 24.9, 1994, 2827, 273, 5094
eisaak, 1122, 28.0, 1948, 4018, 222, 6188
eisenfaust, 1659, 41.8, 11346, 7195, 862, 19403
Eisengrim, 1596, 73.6, 4325, 3642, 523, 8490
Eisfyre, 1161, 316.8, 0, 2, 0, 2
EJCONTRERAS, 1449, 47.5, 770, 984, 43, 1797
ejf, 1375, 31.0, 9907, 9621, 979, 20507
ejga, 1195, 73.9, 505, 657, 34, 1196
ejmcym, 1172, 348.2, 0, 1, 0, 1
Ejner, 1620, 34.2, 7794, 7449, 676, 15919
EKA, 1637, 21.7, 11996, 13888, 697, 26581
ekg, 1309, 24.2, 2510, 3467, 145, 6122
Ekibin, 1172, 113.0, 285, 334, 21, 640
eklavya, 1261, 38.4, 2647, 2858, 203, 5708
ekostem, 1129, 105.8, 898, 1147, 90, 2135
Elara, 1223, 127.8, 776, 1261, 69, 2106
Elargissor, 1333, 57.1, 1273, 1380, 74, 2727
elaser, 1402, 316.2, 197, 163, 19, 379
elaz, 1084, 73.9, 299, 261, 7, 567
ElBasstardo, 1197, 34.8, 1557, 2295, 143, 3995
elberra, 1723, 25.1, 29018, 7665, 934, 37617
elbolita, 1732, 26.5, 5077, 2615, 210, 7902
ElChapo, 1450, 56.8, 97, 179, 4, 280
elcuervo, 1461, 31.1, 6938, 6800, 753, 14491
elDestructor, 1394, 26.2, 2234, 1876, 171, 4281
eldom, 1396, 108.9, 8, 20, 1, 29
EldonTyrell, 1448, 61.8, 214, 133, 4, 351
ElDorado, 1555, 27.0, 9357, 8351, 425, 18133
EleanorM, 1220, 45.1, 290, 291, 17, 598
eleanorrigby, 1273, 29.0, 2417, 2499, 277, 5193
electioneer, 948, 45.7, 209, 296, 12, 517
electric, 1464, 48.9, 9385, 11010, 1234, 21629
electroJ, 1038, 22.9, 328, 484, 38, 850
Elery, 2150, 25.4, 9639, 5842, 1705, 17186
ElEspada, 1424, 48.3, 848, 822, 93, 1763
ElevatorJoe, 1227, 36.8, 495, 1100, 67, 1662
ElevenRonaldinhos, 1403, 34.2, 3102, 2986, 300, 6388
elexarp, 1260, 40.2, 5155, 6785, 530, 12470
ElFuriozo, 1531, 36.5, 400, 1224, 61, 1685
ElGourdo, 1073, 32.6, 3279, 3756, 446, 7481
elgrande, 1301, 37.2, 12720, 19483, 1062, 33265
elgrandepatzer, 1426, 34.5, 1360, 1143, 51, 2554
Elguapo, 1396, 59.0, 1409, 1275, 85, 2769
eliilia, 1288, 43.7, 5486, 4191, 555, 10232
eliotree, 1451, 30.9, 7494, 5793, 411, 13698
elisav, 1308, 264.5, 5, 3, 0, 8
elivija, 2026, 40.1, 7696, 5739, 466, 13901
eljack, 1383, 26.1, 4173, 4351, 505, 9029
ElJunio, 1444, 22.3, 6407, 5845, 537, 12789
elkeme, 1363, 29.9, 3875, 3682, 448, 8005
elkubano, 1381, 70.4, 45, 56, 5, 106
ElKzadorDeRey, 1198, 43.1, 1565, 2726, 136, 4427
ellababy, 1505, 34.7, 2855, 1191, 109, 4155
ellingzipp, 962, 130.3, 39, 72, 1, 112
elliot, 1170, 24.7, 8302, 9725, 775, 18802
elliottblatt, 1274, 104.5, 7625, 8832, 577, 17034
elliottwbrown, 1526, 63.8, 2515, 2151, 241, 4907
Ellmoernie, 722, 92.2, 22, 90, 3, 115
ElMagoVago, 1304, 30.9, 3305, 3258, 128, 6691
elman, 1878, 31.0, 9524, 8914, 945, 19383
elmartillodedios, 645, 85.1, 5, 42, 1, 48
ElMatatan, 716, 107.6, 5, 39, 1, 45, 2524, 187.2, 101, 4, 4, 109
Elmerson, 1408, 20.5, 40282, 37480, 4132, 81894
elmira, 1025, 41.0, 1131, 1301, 96, 2528
ElObservador, 1436, 71.8, 423, 348, 40, 811
Elpadawan, 1224, 28.4, 931, 829, 53, 1813
elpascoe, 995, 28.9, 1003, 2344, 26, 3373
elracoon, 1525, 36.0, 1106, 901, 74, 2081
elraschit, 1685, 29.8, 3666, 1762, 197, 5625
elrodtherocker, 1393, 35.1, 3176, 2163, 268, 5607
ElRoque, 952, 166.8, 2, 6, 1, 9
elsaguaro, 1681, 31.6, 3135, 1730, 362, 5227
elshaddai, 1262, 35.5, 434, 550, 30, 1014
Eltsuj, 998, 95.0, 146, 324, 9, 479
elucifer, 943, 226.5, 0, 3, 0, 3
elviejoperro, 1414, 31.9, 2066, 1694, 118, 3878
elvinclones, 1279, 29.3, 645, 948, 95, 1688
ElwynT, 1855, 121.1, 146, 110, 14, 270
elxgato, 1202, 163.7, 2, 4, 0, 6
elxiling, 1528, 117.8, 134, 36, 6, 176
elyaz, 1671, 137.5, 595, 530, 60, 1185
Elysine, 1655, 62.4, 767, 278, 35, 1080
emanasker, 1690, 114.2, 457, 504, 70, 1031
emaster, 1152, 64.7, 158, 333, 11, 502
embu, 1387, 23.4, 25247, 32279, 2687, 60213
Emie, 1784, 117.0, 2171, 1791, 172, 4134
emilcellier, 576, 157.4, 0, 11, 0, 11
Emilkin, 1250, 69.1, 23, 51, 3, 77
emmasam, 1520, 31.8, 18891, 12481, 1648, 33020
emohisi, 1452, 84.3, 4572, 3948, 295, 8815
emoho, 998, 37.7, 297, 250, 21, 568
emperor, 1810, 32.2, 4924, 4173, 613, 9710
EmpireCityRay, 1010, 87.8, 560, 336, 54, 950
empoulator, 1373, 60.3, 1212, 1122, 72, 2406
emptymate, 1452, 26.6, 5299, 5105, 719, 11123
enanito, 1517, 70.3, 4013, 3432, 195, 7640
Endangered, 1680, 165.1, 586, 732, 57, 1375
endar, 1432, 49.7, 71, 75, 7, 153
endir, 1192, 30.0, 5872, 7115, 228, 13215
EndlessKnights, 1179, 108.2, 846, 1593, 71, 2510
endon, 1252, 41.3, 4705, 5308, 246, 10259
endresjohn, 1140, 31.3, 3309, 5826, 380, 9515
eneg, 990, 129.8, 225, 1222, 24, 1471
Eneias, 1431, 77.8, 206, 179, 20, 405
Eneod, 1865, 29.8, 784, 539, 75, 1398
energon, 1378, 132.6, 92, 50, 4, 146
ENGAGEME, 881, 86.6, 6, 26, 0, 32
engineart, 1271, 24.9, 9017, 14363, 640, 24020
engineergndu, 1250, 95.1, 273, 351, 21, 645
eniacz, 860, 128.7, 30, 54, 2, 86
enigmarr, 1831, 74.5, 2265, 1582, 191, 4038
enik, 1163, 342.8, 0, 1, 0, 1
EnjoyMusic, 1117, 177.3, 2, 3, 1, 6
Enkhbaatar, 1076, 78.9, 852, 1630, 47, 2529
enkindu, 1218, 59.0, 607, 775, 35, 1417
EnnuiBugger, 1679, 101.7, 3289, 2090, 262, 5641
Enochian, 1846, 24.2, 14851, 16060, 1611, 32522
Enochthis, 1045, 192.2, 0, 4, 0, 4
enredoloco, 873, 54.1, 96, 157, 5, 258
enricopalazzo, 1988, 183.2, 57, 16, 8, 81
enriquech, 1395, 27.8, 3118, 2863, 290, 6271
ensoro, 1332, 35.1, 4396, 3349, 210, 7955
entrenamiento, 1210, 181.5, 19, 23, 0, 42
entrokey, 1055, 48.9, 714, 2503, 17, 3234
ENUX, 1270, 38.1, 1645, 1843, 170, 3658
Eoinie, 1558, 26.9, 1083, 2480, 234, 3797
eonion, 977, 50.6, 36, 75, 2, 113
EOSantonio, 1522, 16.3, 11262, 8289, 723, 20274
EowynFather, 1613, 31.6, 7524, 2029, 375, 9928
epaguag, 1230, 61.9, 2366, 3858, 175, 6399
Epals, 1556, 44.9, 378, 279, 26, 683
epil, 1001, 112.3, 17, 30, 0, 47
Epitaph, 1595, 23.5, 16841, 25106, 2287, 44234
Epitasis, 1926, 32.1, 81, 86, 3, 170
Epprecht, 1360, 26.4, 2724, 5381, 301, 8406
epsilonv, 1297, 99.5, 2180, 2058, 139, 4377
epsy, 1516, 25.8, 5991, 5880, 402, 12273
Eptama, 1279, 122.9, 3979, 5380, 428, 9787
epurd, 1124, 29.7, 3109, 3258, 172, 6539
equerre, 1165, 57.1, 1562, 1914, 144, 3620
ERACTUS, 1194, 73.8, 2913, 3966, 377, 7256
Eraihito, 1123, 106.8, 15, 14, 2, 31
eralash, 1311, 70.8, 36, 61, 6, 103
ERAZEM, 2021, 37.2, 2992, 2776, 429, 6197
erazorhead, 1415, 29.0, 7391, 6316, 954, 14661
ERBO, 1540, 34.0, 1342, 2062, 110, 3514
ercsi, 1986, 125.0, 1175, 585, 126, 1886
erdem, 891, 31.8, 115, 538, 4, 657
erdene, 1577, 210.5, 6749, 9190, 1292, 17231
Ereshkigal, 1123, 30.8, 922, 1375, 31, 2328
ergs, 1466, 48.7, 1454, 2156, 101, 3711
erhard, 1738, 24.0, 7185, 5153, 951, 13289
ericbwoo, 1602, 29.3, 764, 825, 66, 1655
ericericlm, 1557, 37.0, 352, 203, 31, 586
ErickSantos, 1157, 112.6, 536, 767, 53, 1356
ericnovik, 1558, 293.2, 0, 1, 0, 1
EricNYC, 1427, 61.8, 556, 704, 56, 1316
ericwong, 1474, 101.2, 1327, 1094, 181, 2602
eridu, 1501, 26.1, 6851, 5969, 462, 13282
erihan, 1613, 26.7, 1563, 1863, 177, 3603
erikj, 1502, 34.9, 6085, 3328, 623, 10036
erikm, 1213, 105.7, 2411, 2736, 167, 5314
erista, 1334, 24.1, 5837, 10684, 451, 16972
ErkanY, 1140, 46.8, 925, 1417, 110, 2452
Erkin, 1301, 54.9, 494, 435, 32, 961
ErnestHemingway, 1196, 27.3, 2667, 3346, 254, 6267
ErnestoTobar, 1458, 75.8, 243, 441, 45, 729
ErnSoo, 745, 183.6, 0, 9, 0, 9
erokk, 1224, 40.5, 2234, 1896, 165, 4295
eroma, 1417, 23.8, 2987, 2559, 120, 5666
eronald, 1084, 31.4, 3123, 4373, 220, 7716
ErrareHumanumEst, 1516, 41.9, 4510, 2836, 515, 7861
errejp, 1446, 39.9, 747, 1200, 136, 2083
Erron, 1587, 98.7, 3736, 3397, 446, 7579
ersantos, 1384, 232.8, 772, 873, 81, 1726
ersurajkumar, 1225, 222.3, 0, 3, 0, 3
Erujeje, 1457, 161.4, 10, 7, 1, 18
erven, 1633, 33.0, 9907, 6291, 724, 16922
esb, 1475, 27.2, 4819, 4392, 506, 9717
escapade, 1198, 44.3, 99, 86, 5, 190
EscapeMSN, 1316, 82.4, 6097, 8869, 296, 15262
eschneie, 1204, 30.5, 280, 339, 14, 633, 1088, 141.5, 1135, 2199, 78, 3412
eshrgk, 875, 51.1, 64, 511, 3, 578
Esistes, 1143, 50.0, 2186, 1978, 124, 4288
EskimoJoe, 1271, 106.7, 14, 34, 2, 50
esklam, 978, 77.1, 560, 766, 21, 1347
eskrimakaliarnis, 983, 41.2, 762, 864, 40, 1666
ESofy, 1532, 119.3, 16, 16, 0, 32
esorciccio, 1545, 68.7, 238, 343, 15, 596
Espartero, 1053, 29.3, 2232, 2691, 72, 4995
Especulador, 1362, 44.2, 1818, 1681, 196, 3695
Esperax, 1355, 70.5, 1146, 924, 145, 2215
esperthirteen, 1572, 148.4, 11, 5, 1, 17
espinosac, 1473, 56.8, 94, 70, 9, 173
Esprityou, 1919, 94.9, 905, 331, 53, 1289
Estanyol, 1149, 39.8, 421, 633, 27, 1081
estebano, 1410, 122.9, 693, 684, 44, 1421
esticles, 1321, 48.3, 695, 637, 70, 1402
Estranger, 1476, 29.6, 1478, 1235, 167, 2880
Estrass, 1521, 94.2, 1461, 1155, 101, 2717
estroncio, 1517, 28.4, 5732, 7111, 584, 13427
Esturgeon, 797, 126.8, 44, 218, 3, 265
estusa, 1432, 70.0, 132, 174, 22, 328
etarak, 968, 93.9, 332, 468, 41, 841
EternalLooser, 824, 72.4, 195, 652, 6, 853
ethicalRascal, 1600, 20.8, 17524, 16603, 1144, 35271
Etligier, 1446, 52.9, 364, 448, 37, 849
etor, 1667, 30.0, 13410, 13146, 1740, 28296
etrain, 1061, 121.0, 30, 41, 3, 74
etsberg, 1244, 73.5, 231, 150, 12, 393
Etts, 1047, 93.9, 146, 244, 16, 406
EtueShuni, 1308, 33.7, 272, 366, 35, 673
eudo, 1497, 27.5, 12368, 16439, 1170, 29977
eugenechess, 1259, 82.4, 623, 537, 59, 1219
eugenek, 1196, 52.5, 175, 123, 22, 320
eugeniusjr, 1804, 42.0, 2935, 2752, 304, 5991
eurus, 1666, 30.7, 405, 199, 21, 625
Eutanasia, 1083, 350.0, 0, 1, 0, 1
Evaldas, 1236, 71.4, 289, 276, 18, 583
evanfd, 1510, 33.3, 5007, 4807, 385, 10199
EvanJunior, 1127, 58.4, 325, 430, 21, 776
EvanSauce, 923, 49.0, 370, 914, 10, 1294
evanyoseph, 1590, 70.8, 252, 366, 31, 649
eventhorizen, 826, 151.4, 1, 11, 0, 12
everaldo, 1570, 43.0, 1216, 1360, 100, 2676
evergreen, 1659, 24.5, 3984, 3302, 255, 7541
everkill, 986, 272.3, 12, 26, 0, 38
EvilCheeseMan, 947, 72.9, 6, 32, 2, 40
Evilclowntime, 1091, 41.7, 174, 246, 25, 445
evilcoyote, 1900, 29.4, 2362, 2059, 371, 4792
EvilEcstasy, 1433, 102.5, 295, 251, 36, 582
evilmike, 1584, 26.0, 4132, 3713, 329, 8174
Evsiukov, 1650, 21.5, 7817, 10558, 885, 19260
Ewen, 1393, 39.6, 3081, 1910, 250, 5241
exactement, 1239, 48.2, 188, 98, 6, 292
Exageemelo, 774, 84.7, 143, 245, 11, 399
EXASPEROV, 1531, 272.9, 1, 1, 0, 2
excelinexile, 1723, 350.0, 1, 0, 0, 1
Excelsius, 1715, 37.8, 4704, 2084, 573, 7361
exclam, 1606, 104.4, 7707, 4158, 495, 12360
exfishing, 1139, 115.9, 152, 218, 12, 382
ExiledSaint, 1661, 55.1, 278, 193, 17, 488
Exilfriese, 1659, 25.3, 335, 362, 27, 724
ExirK, 1265, 46.7, 514, 851, 108, 1473
Exotec, 1442, 19.7, 1269, 1439, 90, 2798
expchess, 1140, 88.2, 149, 188, 6, 343
expertharsh, 878, 92.8, 29, 112, 1, 142
expertmarss, 1415, 125.9, 1539, 2393, 89, 4021
ExpertPlay, 1430, 30.4, 4112, 3273, 224, 7609
Experttmars, 1367, 58.6, 727, 1056, 30, 1813
expiredninja, 1069, 76.2, 464, 621, 21, 1106
ExplodingPulses, 1430, 44.7, 1419, 1253, 151, 2823
Extermi, 1366, 47.5, 6753, 6264, 823, 13840
Extermini, 1333, 58.8, 4997, 4565, 539, 10101
extortionist, 1721, 67.5, 34, 25, 2, 61
ExtremeWays, 1380, 96.9, 146, 110, 9, 265
exzoideajedrez, 1511, 127.0, 161, 247, 23, 431
eyalszafran, 1376, 41.8, 1216, 808, 84, 2108
eydrix, 1012, 90.4, 715, 1373, 41, 2129
Eyechess, 1342, 26.8, 4087, 4195, 384, 8666
EyeLikePie, 1029, 32.7, 88, 222, 14, 324
eyessack, 1118, 41.9, 92, 135, 4, 231
eyestiger, 1744, 329.7, 1, 0, 0, 1
Eyewink, 1209, 37.6, 406, 371, 30, 807
Eykca, 1176, 148.4, 7, 16, 1, 24
ezekarl, 1471, 28.6, 516, 640, 76, 1232
ezekialsrage, 875, 93.8, 2, 44, 0, 46
EZoto, 1446, 50.4, 1845, 1889, 192, 3926
eZseven, 1066, 38.9, 2194, 2975, 113, 5282
fabianopoa, 1474, 93.3, 566, 605, 46, 1217
fabianoprimo, 1643, 52.8, 696, 637, 76, 1409
fabim, 1574, 46.3, 409, 508, 18, 935
FabricioF, 1031, 26.3, 741, 1466, 51, 2258
Facade, 1599, 57.5, 1186, 925, 197, 2308
facetious, 1264, 97.8, 1505, 1188, 36, 2729
Facundomyh, 1707, 49.1, 544, 266, 31, 841
fadaga, 1638, 27.6, 2339, 3078, 598, 6015
FADEDGIANT, 1174, 42.0, 116, 142, 10, 268
Faernal, 1242, 56.7, 3222, 6132, 118, 9472
fafamanga, 1370, 93.8, 232, 241, 25, 498
FahadDUBAIman, 927, 49.2, 149, 279, 12, 440
FahQwiseguy, 2025, 101.4, 376, 163, 20, 559
faisalAKKAL, 1399, 32.8, 792, 968, 51, 1811
faithfullove, 1390, 21.8, 2007, 4291, 161, 6459
fajchess, 1524, 31.6, 3250, 3932, 330, 7512
fakhrul, 1217, 50.3, 925, 984, 37, 1946
Fakler, 1047, 28.4, 1016, 2086, 63, 3165
falak, 1346, 58.4, 6392, 6991, 822, 14205
falbaek, 1055, 128.5, 14, 28, 1, 43
Falkentyne, 1161, 333.6, 0, 1, 0, 1
fallback, 1261, 59.1, 1212, 1902, 90, 3204
fallenaune, 1154, 56.6, 349, 356, 28, 733
faltorpan, 1072, 69.2, 534, 705, 39, 1278
famicucci, 1247, 64.7, 100, 68, 6, 174
fanachess, 1417, 25.0, 12923, 16940, 1495, 31358
Fanaticist, 1712, 41.1, 445, 203, 19, 667
fanghorn, 1509, 67.8, 260, 226, 19, 505
fanmail, 893, 38.8, 148, 218, 15, 381
FantasmaNinja, 1737, 38.8, 2987, 2420, 233, 5640
fantasticfour, 1157, 39.0, 1960, 2224, 141, 4325
Fante, 1215, 96.2, 2263, 2913, 250, 5426
fantonio, 1112, 122.0, 70, 90, 5, 165
Fantorax, 1532, 48.6, 1210, 835, 108, 2153
FargoBear, 1372, 55.3, 198, 170, 16, 384
farhadk, 1516, 37.6, 5114, 3667, 323, 9104
Farlif, 1266, 30.6, 2757, 3955, 147, 6859
farlo, 1406, 76.6, 284, 238, 17, 539
farmerX, 1101, 42.7, 396, 1024, 29, 1449
farnham, 1492, 24.3, 14407, 12142, 1417, 27966
FARQU, 982, 42.1, 1930, 2417, 90, 4437
farsichess, 1095, 215.5, 1, 4, 0, 5
Farsyd, 1582, 28.9, 5318, 3119, 350, 8787
farusu, 1202, 99.0, 626, 218, 14, 858
Fashion, 2168, 124.0, 56, 4, 3, 63
fassbinder, 1139, 35.4, 6570, 4297, 274, 11141
fastbilly, 1109, 33.1, 301, 351, 25, 677
fastbutsloppy, 1774, 36.2, 627, 395, 69, 1091
fastglass, 1135, 34.6, 825, 1704, 41, 2570
Fateh, 1414, 40.6, 5295, 7180, 305, 12780
fathimasaq, 1190, 115.3, 1000, 871, 69, 1940
fatimus, 1346, 33.0, 2660, 2830, 284, 5774
fatjodos, 1112, 25.9, 1331, 1090, 88, 2509
Fatnakedguyrunnin, 1391, 47.1, 1550, 407, 96, 2053
FatSchemer, 1262, 29.9, 425, 571, 49, 1045
fatserg, 1451, 33.3, 2995, 3924, 110, 7029
fatsloppydriver, 1244, 143.3, 878, 1509, 82, 2469
fattyMcghee, 757, 122.3, 3, 19, 0, 22
FaughABallagh, 1233, 131.3, 673, 793, 56, 1522
Faunus, 1130, 46.9, 591, 1580, 99, 2270
fawltytowers, 1177, 29.2, 152, 299, 20, 471
Faydogg, 1230, 28.4, 3463, 6643, 549, 10655
FAZEKAS, 1368, 79.6, 1486, 602, 44, 2132
fazt, 1812, 24.4, 3322, 3494, 425, 7241
fbafelipe, 1238, 87.8, 72, 154, 6, 232
FBGHooper, 1327, 27.7, 3709, 3968, 639, 8316
fbust, 946, 41.4, 261, 336, 9, 606
fcetina, 1279, 162.5, 3, 12, 0, 15
fcspartak, 1683, 43.4, 204, 61, 22, 287
FCTI, 1226, 71.4, 183, 324, 5, 512
FDiAncoya, 1266, 67.9, 1510, 3253, 217, 4980
fdmazzone, 1262, 55.8, 2161, 2305, 146, 4612
FDog, 1738, 31.5, 3730, 2455, 221, 6406
fedayin, 889, 32.5, 287, 391, 16, 694
fedemos, 1051, 119.3, 14, 40, 0, 54
Federalist, 850, 176.3, 2, 7, 0, 9
fedore, 1003, 42.0, 2042, 4045, 112, 6199
feelm, 882, 39.2, 1363, 4741, 102, 6206
feenixknight, 1027, 52.0, 334, 646, 16, 996
feenom, 1132, 150.9, 5, 11, 0, 16
Feestt, 1119, 32.1, 993, 962, 71, 2026
Feiticeiro, 1601, 122.2, 1997, 1584, 161, 3742
feld, 1050, 112.8, 4894, 6763, 314, 11971
felipedj, 1497, 65.1, 14061, 15795, 1021, 30877
felixfelix, 1139, 127.7, 5, 6, 1, 12
FelixTheCat, 1719, 24.9, 15337, 11153, 1092, 27582
felko, 1057, 52.0, 2959, 2601, 142, 5702
felosj, 997, 131.7, 9, 12, 1, 22
Fenanze, 1632, 126.8, 839, 927, 74, 1840
fendermac, 1256, 39.1, 478, 411, 60, 949
fenerlive, 1020, 130.3, 16, 53, 0, 69
fengzheng, 1387, 132.7, 8, 12, 2, 22
Fenkoff, 802, 137.0, 1, 11, 0, 12
Ferad, 1728, 39.3, 3742, 3554, 321, 7617
ferdig, 1736, 28.2, 6190, 8648, 730, 15568
ferhatama, 1550, 28.6, 671, 1641, 118, 2430
feriandri, 1078, 60.3, 185, 349, 25, 559
ferik, 1497, 72.9, 259, 175, 13, 447
ferleo, 1767, 104.1, 221, 293, 23, 537
Ferna, 1713, 62.0, 1079, 629, 90, 1798
Fernando, 1329, 132.8, 1140, 2294, 161, 3595
fernanevyn, 1354, 35.1, 2155, 2012, 88, 4255
Ferose, 1102, 114.9, 12, 43, 1, 56
ferri, 1245, 29.3, 2917, 2668, 176, 5761
ferupe, 1355, 20.8, 10805, 18994, 1240, 31039
Feuplayer, 1491, 169.8, 8, 11, 0, 19
feust, 1027, 80.0, 38, 48, 1, 87
fewe, 1418, 26.1, 8272, 9884, 309, 18465
Feyn, 1160, 34.6, 330, 346, 31, 707
fezzjr, 1273, 90.1, 185, 232, 20, 437
ffdallagnol, 1359, 29.2, 3183, 2138, 207, 5528
FFELON, 1353, 36.5, 2635, 2781, 305, 5721
FFLOYD, 1123, 44.3, 519, 377, 92, 988
ffmusicdj, 616, 129.7, 3, 27, 0, 30
ffuunnyy, 1174, 98.7, 5, 17, 1, 23
ffvaan, 1267, 72.4, 441, 417, 28, 886
FGPinget, 1695, 128.0, 531, 403, 45, 979
fhctyfk, 1537, 36.8, 465, 248, 17, 730
fhjais, 1876, 60.6, 153, 27, 0, 180
fianchettochess, 1627, 99.4, 376, 275, 35, 686
fianchettosstorm, 1291, 27.5, 1893, 5402, 226, 7521
fianchettous, 1304, 57.6, 1054, 1035, 98, 2187
Fibonaccie, 1470, 24.2, 2717, 3043, 327, 6087
ficcapowa, 1391, 63.0, 190, 331, 16, 537
FickleMars, 1130, 85.9, 558, 777, 24, 1359
ficsficsfan, 1398, 34.0, 2221, 4012, 128, 6361
ficsid, 943, 29.1, 129, 289, 6, 424
ficsPlayerHandle, 790, 261.7, 0, 7, 0, 7
ficsserver, 1248, 52.6, 236, 556, 34, 826
ficsun, 1653, 42.5, 873, 866, 90, 1829
ficuest, 1348, 29.4, 3219, 2233, 233, 5685
fiddlinggeorge, 1796, 47.8, 3767, 2992, 310, 7069
FidelCastro, 1547, 35.4, 17913, 19049, 2437, 39399
fideplayer, 1368, 78.2, 286, 316, 23, 625
fidodog, 1397, 30.2, 1185, 621, 70, 1876
fidotopdog, 1226, 230.5, 0, 24, 0, 24
fidou, 1309, 54.9, 228, 190, 17, 435
fieldmaster, 1162, 41.0, 612, 357, 23, 992
FieryHydra, 1544, 110.0, 4084, 4204, 716, 9004
fifthavenue, 1326, 21.9, 7756, 8207, 550, 16513
fightclutch, 1203, 67.6, 300, 284, 22, 606
FightingAtheist, 1001, 142.8, 3, 9, 0, 12
FightingIrishfan, 1259, 45.0, 3000, 2474, 154, 5628
FigureOfLife, 1884, 50.1, 1249, 604, 87, 1940
FIHTies, 1206, 37.2, 4636, 7002, 283, 11921
fijichess, 1401, 56.7, 1195, 876, 60, 2131
Fik, 2050, 28.5, 20761, 16702, 4037, 41500
fikipaldi, 1356, 38.7, 832, 892, 43, 1767
fileelena, 1229, 26.1, 3156, 3567, 225, 6948
filigiuli, 1307, 37.7, 1643, 875, 91, 2609
filiperafaeli, 1034, 183.5, 41, 138, 9, 188
FilipinoSteve, 1254, 152.2, 2, 15, 0, 17
FilthyHenry, 954, 106.3, 18, 82, 2, 102
fimarez, 1310, 60.3, 605, 775, 68, 1448
finalprodigy, 1297, 30.9, 334, 400, 22, 756
finbaaa, 1408, 226.9, 0, 2, 0, 2
finechess, 1726, 55.5, 2556, 1078, 284, 3918
finewine, 1106, 40.1, 1389, 1482, 92, 2963
fingchessmate, 1399, 75.3, 113, 94, 9, 216
fingerslip, 1374, 61.7, 1091, 742, 88, 1921
Finishhim, 936, 63.0, 390, 688, 6, 1084
FINLANDIA, 1668, 60.1, 1311, 1305, 186, 2802, 1261, 36.4, 296, 314, 28, 638
finnian, 1583, 84.9, 17259, 12726, 1157, 31142
Finno, 1072, 31.1, 2368, 4471, 213, 7052
fiphty, 1042, 98.3, 16, 22, 1, 39
FireAlex, 1549, 59.8, 2001, 1032, 121, 3154
fireandflames, 985, 55.4, 649, 1079, 26, 1754
FireDragg, 2033, 138.1, 227, 76, 9, 312
FireFics, 1751, 68.9, 634, 510, 46, 1190
firenight, 1375, 49.4, 105, 104, 6, 215
fireONmaui, 1138, 87.4, 2964, 3496, 257, 6717
firerico, 1311, 33.7, 1869, 2174, 114, 4157
fireslash, 1033, 56.0, 100, 115, 16, 231
firov, 1442, 36.5, 163, 228, 6, 397
FirstOboe, 1057, 24.2, 2152, 3423, 188, 5763
firusvg, 1159, 75.8, 786, 1095, 137, 2018
fischerism, 1188, 31.9, 561, 1085, 13, 1659
fischerja, 1454, 91.5, 802, 1412, 96, 2310
Fischeur, 1545, 61.1, 968, 638, 104, 1710
fishegg, 1351, 36.1, 2784, 3109, 224, 6117
fishermania, 1408, 26.0, 1944, 1592, 149, 3685
fishflakes, 1724, 24.0, 6012, 6327, 428, 12767
fishier, 1414, 73.3, 1991, 2293, 203, 4487
fishlens, 1682, 46.6, 4975, 3396, 205, 8576
FishRunner, 1686, 67.4, 375, 307, 28, 710
Fishstar, 1309, 25.6, 2911, 2455, 258, 5624
FishWhistler, 1552, 47.8, 317, 143, 24, 484
FishysAvenger, 1285, 144.2, 176, 90, 18, 284
fisted, 884, 135.1, 53, 117, 2, 172
Fitchess, 1978, 120.0, 171, 143, 19, 333
fitzkelly, 1063, 116.9, 2664, 4254, 251, 7169
fivedogs, 1384, 32.6, 3176, 5293, 189, 8658
fivemingame, 1329, 61.5, 316, 130, 12, 458
fivemovsahead, 1437, 56.0, 150, 162, 11, 323
FiveRings, 1360, 122.1, 9, 95, 0, 104
fivewood, 951, 45.9, 2496, 5028, 166, 7690
fixerator, 1004, 43.5, 832, 1518, 62, 2412
fizzmaster, 1161, 45.1, 840, 311, 30, 1181
fjoskrakk, 1352, 92.2, 27, 43, 6, 76
Flabellina, 1586, 63.4, 626, 773, 62, 1461
Flameraider, 1115, 33.5, 302, 686, 30, 1018
Flamingnerd, 1201, 153.6, 4, 15, 2, 21
flatman, 1425, 60.7, 439, 433, 73, 945
flatzflutz, 1220, 38.1, 2650, 5196, 218, 8064
flavo, 1369, 28.9, 6470, 8607, 374, 15451
Flduckhunter, 776, 146.9, 4, 24, 0, 28
Flegmeth, 1436, 40.7, 1403, 1212, 132, 2747
flekica, 1514, 212.0, 1, 3, 0, 4
Flicflac, 1918, 20.6, 2041, 2330, 238, 4609
FlightsOFAntasy, 971, 60.5, 106, 199, 9, 314
flinthard, 1059, 87.3, 9, 29, 1, 39
flitz, 1743, 74.4, 1139, 1127, 133, 2399
flitzzzz, 1143, 27.5, 1887, 2345, 80, 4312
floare, 1494, 71.3, 244, 151, 55, 450
FloatingPoint, 1237, 41.9, 3202, 2491, 167, 5860
Flodelarab, 1244, 34.1, 1856, 899, 36, 2791
FloriE, 1414, 35.5, 1504, 2106, 136, 3746
flortje, 1743, 27.1, 1124, 1078, 136, 2338
Flourish, 1816, 53.1, 5993, 2867, 399, 9259
FloydSpender, 1009, 30.5, 637, 1401, 81, 2119
Fludae, 913, 81.7, 31, 128, 5, 164
FlukeSpb, 865, 52.5, 205, 335, 13, 553
Flupkes, 1026, 37.8, 1430, 1878, 60, 3368
Flurpip, 1591, 36.4, 5354, 4083, 545, 9982
fluters, 1573, 24.5, 25553, 33798, 1811, 61162
fluxcat, 1476, 161.7, 18, 8, 0, 26
fluxtendu, 1165, 105.5, 468, 692, 32, 1192
flyingfeats, 1013, 27.6, 890, 779, 72, 1741
Flyinghooves, 1140, 43.9, 4516, 7175, 230, 11921
flyingpawn, 1567, 23.6, 9516, 7497, 920, 17933
flyingsaucerpilot, 970, 32.4, 4672, 3043, 170, 7885
flyingTriangle, 1502, 294.3, 0, 1, 0, 1
flyjuice, 1392, 28.0, 4424, 3647, 192, 8263
flykiller, 2028, 98.8, 12877, 8166, 2957, 24000
fmacmpua, 1195, 30.0, 752, 958, 54, 1764
fmarius, 999, 33.5, 1303, 3712, 30, 5045
fmdroper, 1940, 39.8, 2600, 858, 192, 3650
fmlc, 1550, 36.5, 1628, 1487, 197, 3312
FMmanyak, 2055, 66.0, 4199, 3377, 529, 8105
fmmaster, 1320, 60.0, 64, 97, 9, 170
fnogatz, 1640, 29.7, 3848, 2657, 315, 6820
foduck, 1329, 33.6, 1705, 3713, 70, 5488
fofate, 1588, 25.1, 3507, 4905, 546, 8958
fogmay, 1195, 30.4, 7407, 10929, 800, 19136
folderol, 1661, 34.3, 5867, 4710, 646, 11223
FollowYourHeart, 1283, 63.7, 168, 167, 11, 346
fonefun, 995, 89.2, 452, 564, 22, 1038
fonsj, 1259, 42.1, 4837, 6530, 341, 11708
foobaer, 1693, 46.6, 3124, 3379, 201, 6704
Foodstamp, 1541, 37.9, 978, 929, 121, 2028
fooio, 1297, 47.7, 1188, 1993, 183, 3364
fooledya, 1017, 97.9, 103, 147, 3, 253
foolsh, 1325, 41.6, 655, 492, 35, 1182
footballcoach, 1380, 54.2, 2784, 1654, 234, 4672
footsoldier, 1118, 42.7, 2773, 5128, 219, 8120
Forcanys, 1611, 25.8, 1424, 1827, 228, 3479
Forester, 1754, 21.0, 20706, 15366, 1398, 37470
forethoughtwins, 1354, 34.6, 610, 669, 47, 1326
foreverash, 1105, 65.1, 18, 42, 1, 61
foreverblackman, 976, 51.4, 416, 614, 16, 1046
forevergreen, 1369, 47.3, 1204, 1309, 58, 2571
forfar, 1708, 43.0, 14845, 14382, 1514, 30741, 1810, 24.7, 12657, 8850, 1575, 23082
ForgottenEchoes, 1408, 56.6, 3728, 2584, 288, 6600
forkUU, 1521, 350.0, 40, 33, 7, 80
ForkUup, 946, 33.8, 147, 274, 8, 429
formalcause, 1335, 144.9, 8, 4, 1, 13
formulaforce, 1282, 37.9, 2831, 2387, 137, 5355
Forniespm, 1327, 51.1, 676, 578, 37, 1291
FornodiZoldo, 1207, 75.9, 954, 1438, 71, 2463
forpfics, 1471, 129.1, 23, 24, 1, 48
forrest, 1407, 30.6, 23867, 9029, 1507, 34403
forrestx, 1172, 116.7, 677, 870, 36, 1583
fortchess, 1092, 60.7, 995, 1353, 69, 2417
FortressAB, 1448, 50.6, 46, 28, 5, 79
fortu, 1548, 61.4, 6584, 9027, 732, 16343
FortunaChess, 1696, 115.4, 1430, 635, 74, 2139
FortWonny, 1203, 38.0, 775, 795, 34, 1604
fortytwooz, 1227, 28.7, 1156, 771, 32, 1959
ForzaASRoma, 1311, 62.2, 289, 321, 33, 643
fossgly, 1630, 72.9, 887, 543, 84, 1514
fossle, 1920, 26.5, 2082, 1664, 433, 4179
foti, 1189, 29.6, 5728, 6004, 502, 12234
fou, 1203, 51.1, 4092, 4318, 296, 8706
Foucault, 1188, 43.5, 761, 1191, 61, 2013
Foupoilu, 1580, 24.0, 6920, 8787, 604, 16311
FourBishops, 1242, 57.1, 188, 330, 20, 538
fourElements, 1353, 32.6, 1331, 1330, 124, 2785
FourPointOh, 1356, 50.3, 3114, 2497, 244, 5855
FOWARDL, 1013, 28.5, 652, 1672, 68, 2392, 1749, 31.6, 17016, 11446, 2217, 30679
foxchaseii, 1361, 43.5, 2475, 3368, 250, 6093
foxone, 1148, 42.8, 6109, 8395, 283, 14787
FOXPETER, 1403, 32.4, 2066, 1487, 143, 3696
foytik, 1850, 30.5, 354, 413, 27, 794
Fozzy, 1962, 22.6, 10709, 8777, 957, 20443
FPep, 803, 120.0, 3, 11, 1, 15
fpster, 1237, 32.0, 941, 898, 74, 1913
Fqitz, 1633, 40.0, 1209, 1215, 108, 2532
fractalclouds, 1131, 55.8, 1663, 1881, 87, 3631
frad, 1455, 32.8, 2784, 1649, 239, 4672
FRAHE, 1841, 35.5, 7406, 2595, 403, 10404
frakinyov, 1306, 24.0, 4839, 5281, 272, 10392
Francescoandrio, 1080, 50.6, 31, 67, 1, 99
francescovolpe, 1084, 35.0, 1381, 3041, 98, 4520
franciscoedv, 1275, 87.5, 393, 474, 31, 898
Francocappa, 994, 103.1, 11, 39, 0, 50
Francofon, 1423, 52.7, 95, 71, 1, 167
francoishaha, 1442, 45.0, 3626, 4125, 366, 8117
francoso, 1533, 33.1, 3276, 7519, 300, 11095
FranekSpacecheck, 1301, 22.7, 1945, 2957, 84, 4986
frankbascombe, 1379, 114.3, 212, 280, 21, 513
Frankee, 1363, 34.3, 25153, 6393, 1011, 32557
FrankEG, 1357, 42.9, 2699, 2320, 318, 5337
Frankendawn, 1164, 78.6, 729, 2489, 109, 3327
Frankhallgreen, 799, 68.3, 110, 643, 6, 759
FrankHeller, 1590, 29.6, 3632, 1506, 310, 5448
Frankiemh, 1202, 91.6, 909, 1025, 41, 1975
FrankMuller, 1296, 120.9, 339, 364, 48, 751
FrankQu, 1580, 114.2, 4138, 2672, 487, 7297
franksama, 1636, 23.9, 6272, 6158, 517, 12947
FrankTheFirst, 1440, 30.5, 3088, 2621, 199, 5908
FranzB, 1301, 28.8, 2858, 2628, 147, 5633
franzgabo, 1648, 38.6, 2567, 3121, 208, 5896
franzgotsis, 1644, 43.2, 1757, 685, 80, 2522
franzk, 1651, 143.3, 9000, 8659, 1082, 18741
fraperr, 1381, 50.0, 1527, 1162, 124, 2813
FrasierCrane, 1473, 107.5, 370, 179, 26, 575
frauber, 1521, 64.5, 1317, 1105, 142, 2564
Frco, 1472, 68.5, 2560, 3389, 287, 6236
FreakHead, 1105, 36.5, 185, 186, 16, 387
freddiethefrog, 1213, 70.5, 18, 16, 0, 34
freddyigbinosa, 1300, 53.4, 2690, 3340, 449, 6479
FreddyReinfeld, 1727, 175.6, 11, 3, 0, 14
FredGambit, 1280, 106.9, 61, 76, 4, 141
FredNietzsche, 1527, 47.4, 1625, 1091, 63, 2779
FredNorris, 1132, 38.1, 582, 822, 48, 1452
FredrikJ, 1731, 34.9, 2270, 1706, 244, 4220
Fredthewolf, 1402, 35.3, 3834, 3231, 323, 7388
Fredyco, 1191, 76.1, 70, 126, 6, 202
FreeBillStickers, 1355, 33.1, 116, 83, 5, 204
freeboot, 1621, 38.2, 2686, 5153, 343, 8182
freefal, 992, 63.9, 26, 53, 2, 81
freefallfreddy, 1140, 32.4, 300, 430, 8, 738
freegan, 1223, 327.1, 0, 1, 0, 1
Freegman, 1105, 39.6, 202, 287, 24, 513
Freeki, 1026, 65.8, 404, 767, 31, 1202
freese, 1511, 46.8, 897, 613, 39, 1549
freesok, 1279, 64.9, 9240, 9331, 787, 19358
freestylattitude, 1041, 195.2, 17, 31, 0, 48
freestylechess, 1267, 46.1, 1954, 2187, 96, 4237
Freethinkin, 1437, 79.5, 597, 594, 22, 1213
fregen, 1599, 47.3, 4731, 3228, 472, 8431
Freilos, 1505, 32.5, 8307, 4832, 734, 13873
frekhike, 1333, 28.8, 5836, 5720, 371, 11927
Frele, 1189, 37.6, 1040, 985, 66, 2091
frencheng, 972, 66.7, 718, 680, 65, 1463
frenchguy, 1768, 49.6, 2060, 612, 76, 2748
FrenchPitch, 1087, 66.5, 559, 731, 25, 1315
frenez, 1620, 128.5, 332, 135, 30, 497
frenk, 1656, 20.6, 14332, 12048, 2318, 28698
FreoDockers, 1106, 32.9, 6382, 7181, 631, 14194
freqrider, 1008, 43.9, 557, 852, 17, 1426
FreshGreens, 1441, 19.1, 806, 1007, 102, 1915
FreshyFresh, 1229, 239.8, 1, 2, 0, 3
fridayknights, 1108, 27.1, 4788, 8494, 530, 13812
FriendOfTheKing, 2064, 48.6, 2174, 1722, 252, 4148
FriendshipFighter, 1901, 35.1, 2560, 2001, 224, 4785
Friendzy, 1093, 73.8, 17, 42, 2, 61
FrierTuck, 1773, 26.5, 1376, 1492, 43, 2911
FRIGHTFIGHT, 1059, 56.8, 22, 58, 0, 80
frigybeer, 1230, 126.4, 456, 574, 16, 1046
friky, 1722, 92.5, 7220, 5071, 470, 12761
fritzilgatto, 1154, 42.9, 1027, 616, 58, 1701
fritzjf, 1263, 23.8, 5527, 6439, 567, 12533
FrmKerala, 1588, 45.0, 345, 201, 13, 559
frmstechlin, 1302, 52.1, 214, 143, 5, 362
frncs, 1191, 59.6, 272, 395, 33, 700
frodriguez, 1440, 43.4, 1012, 844, 70, 1926
FrogC, 1260, 59.2, 1111, 678, 105, 1894
frogers, 1341, 123.0, 69, 60, 7, 136
froggydave, 1436, 28.9, 2635, 3073, 338, 6046
fromMjolnir, 1269, 32.5, 1464, 1346, 146, 2956
fronald, 604, 162.3, 1, 20, 0, 21
FRONTEYES, 820, 112.1, 38, 133, 3, 174
frostedsnowman, 1272, 309.4, 0, 1, 0, 1
frostmourne, 1557, 41.5, 3906, 5094, 620, 9620
FrozenPawn, 1158, 45.9, 1139, 2300, 234, 3673
frtipik, 1021, 60.0, 103, 170, 8, 281
frufala, 1615, 45.2, 2304, 2040, 183, 4527
Fruito, 1246, 139.2, 7, 20, 1, 28
FrumPilot, 1346, 40.0, 2333, 2533, 125, 4991
frunze, 1741, 20.2, 31407, 25334, 2597, 59338
fsanyi, 1336, 29.2, 2744, 3056, 280, 6080
ftdavies, 1346, 31.2, 1117, 4485, 179, 5781
fttbrain, 1102, 46.9, 977, 753, 56, 1786
ftuteleers, 1480, 28.0, 1856, 2545, 140, 4541
Ftvkun, 1281, 51.6, 1192, 1672, 83, 2947
Fuat, 1069, 44.2, 730, 1819, 90, 2639
Fudpucker, 1803, 20.3, 1500, 1311, 87, 2898
fuentele, 902, 176.3, 3, 6, 0, 9
FueR, 1329, 31.4, 4841, 5415, 626, 10882
Fugitiv, 1378, 144.1, 16, 20, 1, 37
Fujamoto, 1093, 41.8, 134, 160, 6, 300
fujin, 1382, 38.6, 1750, 2740, 254, 4744
fujingyuan, 1457, 39.7, 897, 1478, 140, 2515
fulanman, 762, 98.9, 1, 51, 0, 52
fullb, 1040, 146.1, 6, 14, 1, 21
Fullminster, 2139, 106.3, 469, 337, 68, 874
fung, 1419, 103.4, 847, 1145, 63, 2055
fungiat, 1791, 22.1, 3982, 5840, 907, 10729
funinthemorgue, 1329, 35.2, 759, 480, 34, 1273
funked, 1061, 170.5, 2, 7, 0, 9
funker, 1551, 28.8, 963, 431, 77, 1471
funkonfusion, 1303, 35.4, 2518, 1487, 56, 4061
Funkwecker, 1519, 27.3, 6162, 7376, 460, 13998
Funplay, 1457, 103.7, 5519, 6178, 308, 12005
furry, 914, 178.1, 3, 11, 0, 14
Futhark, 1503, 60.9, 36, 38, 3, 77
FutureMaster, 1720, 62.4, 1229, 845, 94, 2168
fuzzybuzzy, 1231, 167.5, 4, 9, 1, 14
fuzzykingjames, 967, 49.6, 169, 368, 16, 553
fvesely, 1333, 37.0, 1448, 1171, 98, 2717
Fwaka, 1100, 137.3, 4, 8, 1, 13
fwenkey, 1414, 39.3, 2721, 1543, 172, 4436
fwm, 1397, 29.1, 1562, 1984, 133, 3679
fyrer, 1306, 36.5, 2573, 2076, 205, 4854
FZAP, 1357, 38.0, 1066, 1658, 50, 2774
FZi, 1606, 23.7, 8858, 6094, 1328, 16280
Fzoozle, 1508, 33.2, 10309, 5414, 687, 16410
Gabebro, 1291, 28.1, 4041, 3388, 182, 7611
Gabej, 563, 119.4, 2, 22, 0, 24
gabrielag, 1167, 44.2, 1354, 1672, 79, 3105
GabrielChime, 855, 101.8, 3813, 7452, 165, 11430
GabrielH, 1115, 30.4, 3776, 3267, 211, 7254
gabrielpergola, 1515, 40.3, 1594, 1908, 193, 3695
GabrielRajamin, 1046, 24.8, 1567, 2202, 134, 3903
Gabrielrw, 1509, 26.2, 6464, 4343, 633, 11440
Gabryan, 1495, 32.9, 3987, 6755, 585, 11327
gadam, 1322, 68.9, 1620, 1235, 111, 2966
gaejangsoo, 1317, 76.3, 157, 146, 5, 308
Gaettan, 1175, 28.3, 4599, 5260, 187, 10046
Gaigin, 1156, 31.6, 6401, 6988, 416, 13805
gailsmithwa, 1287, 35.0, 538, 999, 45, 1582
Gainesvillelover, 1192, 323.0, 0, 1, 0, 1
GairahGila, 1292, 28.0, 344, 434, 15, 793
gaj, 1640, 24.4, 10969, 6369, 774, 18112
GAlam, 1159, 41.8, 979, 948, 116, 2043
Galileo, 1544, 27.7, 9624, 11528, 1356, 22508
Galleta, 1439, 43.9, 6298, 5946, 721, 12965
gallileo, 1462, 25.5, 16130, 16551, 805, 33486
Galningen, 1545, 45.9, 1528, 1297, 128, 2953
galoisgr, 1632, 38.4, 2899, 2947, 269, 6115
GALTEE, 1748, 52.7, 1130, 357, 82, 1569
galyts, 1308, 115.1, 230, 412, 46, 688
Gambitbuster, 1075, 159.7, 3, 7, 0, 10
GambitGangsta, 1583, 37.8, 219, 227, 20, 466
gambitguyx, 1465, 146.6, 7, 8, 0, 15
GambitScott, 1602, 62.9, 371, 247, 28, 646
gambm, 1392, 26.0, 9112, 12447, 745, 22304
gamboot, 1335, 51.5, 1329, 1595, 68, 2992
gambord, 885, 35.2, 708, 1795, 25, 2528
gameboyking, 790, 150.5, 2, 11, 0, 13
gamefowl, 1595, 25.5, 2785, 4713, 329, 7827
gamesmanXVIV, 1345, 34.4, 7077, 1958, 330, 9365
ganbare, 674, 152.7, 2, 21, 0, 23
Gancey, 872, 74.0, 13, 66, 0, 79
gandalfmp, 1149, 35.5, 1457, 1697, 68, 3222
gandalfwizard, 1608, 59.3, 2779, 3172, 381, 6332
gankandspank, 1342, 55.9, 171, 70, 5, 246
ganstaman, 1398, 69.4, 152, 115, 14, 281
Gantzpwn, 1109, 66.2, 31, 53, 3, 87
ganzgut, 1304, 27.2, 3826, 5061, 771, 9658
gapbob, 1538, 31.1, 12808, 12890, 1016, 26714
Garak, 1764, 104.0, 1969, 1677, 239, 3885
garandou, 1283, 148.0, 32, 66, 3, 101
GarbageHead, 1456, 29.2, 2434, 1883, 298, 4615
GarbagiB, 1573, 37.5, 1657, 626, 105, 2388
garbagio, 1303, 50.5, 1508, 813, 115, 2436
Garciagutierrez, 1424, 52.8, 912, 908, 102, 1922
Gards, 1091, 49.9, 265, 357, 43, 665
garfio, 2131, 119.5, 1798, 1616, 218, 3632
gargomel, 857, 100.6, 391, 741, 20, 1152
garmin, 1150, 31.5, 3281, 4242, 254, 7777
garryc, 1704, 43.9, 3562, 1714, 377, 5653
GarryH, 1194, 96.4, 4032, 5213, 412, 9657
Garwood, 942, 84.8, 212, 359, 11, 582
garyHO, 1379, 100.0, 909, 1171, 42, 2122
garymitchellFICS, 1574, 92.0, 57, 66, 6, 129
garysa, 1260, 27.1, 9104, 18043, 677, 27824
garysteel, 1608, 151.4, 13, 11, 0, 24
garyzhang, 1025, 70.9, 384, 421, 22, 827
gasbag, 1352, 235.7, 0, 2, 0, 2
gaskell, 1350, 35.7, 4059, 3698, 355, 8112
gaspard, 1673, 43.5, 3501, 2750, 259, 6510
gasparegg, 1225, 28.9, 588, 5240, 106, 5934
gatomatias, 1227, 74.3, 1858, 3121, 181, 5160
gatortaxguy, 1320, 29.4, 78, 90, 8, 176
Gatsu, 1460, 28.0, 5889, 5565, 729, 12183
gauf, 1432, 37.6, 26460, 15626, 2282, 44368
GaurH, 1352, 85.0, 506, 438, 43, 987
GauSal, 1723, 50.9, 1034, 1047, 93, 2174
GautamaBuddha, 1162, 78.7, 494, 921, 43, 1458
gavalenzuela, 857, 175.7, 4, 27, 0, 31
gaven, 1121, 169.7, 1, 4, 1, 6
gavpell, 1233, 31.9, 1684, 1674, 138, 3496
GBarberton, 1086, 211.8, 3, 3, 0, 6
gbarrios, 1279, 35.2, 678, 780, 40, 1498
GBen, 974, 44.6, 128, 88, 0, 216
gboz, 1215, 122.9, 181, 236, 29, 446
gcam, 1306, 79.2, 8316, 11921, 548, 20785
gccUser, 1142, 126.6, 134, 201, 12, 347
GCE, 1623, 78.1, 1204, 1220, 139, 2563
gcolen, 1524, 62.2, 2048, 1739, 279, 4066
gdagostino, 1371, 27.6, 2993, 4401, 242, 7636
gdmaicc, 1501, 110.9, 1182, 883, 79, 2144
gdmaster, 1595, 80.6, 54, 9, 2, 65
gdmcgregor, 1322, 62.7, 2622, 4186, 385, 7193
Gdot, 1170, 54.2, 4806, 4327, 209, 9342
GEC, 1096, 39.4, 2414, 3044, 169, 5627
gedeon, 1270, 36.0, 6078, 5815, 758, 12651
gedimar, 1448, 244.1, 0, 4, 0, 4
geeniuus, 1962, 25.8, 8325, 4812, 930, 14067
geezerly, 1242, 44.6, 3698, 1554, 162, 5414
Gegitor, 2001, 51.5, 2208, 1463, 241, 3912
Geigenheimer, 685, 136.0, 1, 51, 1, 53
geilebeer, 1327, 29.2, 9897, 12340, 633, 22870
gejo, 1070, 43.6, 425, 670, 23, 1118
Gely, 2003, 51.8, 254, 94, 30, 378
GeminiKid, 1009, 227.6, 10, 108, 0, 118
Gendalf, 1675, 44.6, 4313, 3338, 214, 7865
genehdrake, 1298, 106.1, 212, 301, 19, 532
GeneralPickett, 1495, 54.1, 254, 130, 27, 411
GeneralVP, 1285, 25.4, 781, 1264, 90, 2135
generatie, 1337, 31.6, 3339, 2493, 180, 6012
GenghisHushai, 1758, 23.9, 2394, 2570, 222, 5186
geninv, 1707, 33.2, 3535, 2277, 392, 6204
Gennadyx, 1373, 106.8, 85, 1161, 20, 1266
GENRI, 1847, 40.8, 10674, 11262, 921, 22857
Genthoal, 1339, 39.4, 4295, 5402, 285, 9982
GentlemanJoe, 1225, 72.9, 5168, 5514, 354, 11036
geographic, 1486, 44.6, 871, 754, 96, 1721
geojim, 1331, 22.3, 5916, 9212, 351, 15479
geolore, 1441, 44.8, 997, 907, 99, 2003
GeorgeCool, 1327, 126.8, 2588, 3737, 352, 6677
georgehaha, 1302, 56.0, 167, 138, 10, 315
GeorgeLarsen, 1174, 31.9, 715, 895, 47, 1657
georgelu, 1269, 134.8, 24, 120, 7, 151
georgesudakov, 1214, 88.2, 21, 76, 2, 99
georgethegiant, 1349, 38.7, 3223, 3554, 154, 6931
GeorgeV, 1563, 27.6, 8428, 3630, 185, 12243
geosah, 1463, 25.3, 8124, 7962, 1066, 17152
geosahar, 1423, 70.0, 9310, 8596, 1106, 19012
geosynchronous, 1199, 46.8, 685, 1325, 52, 2062
Gepetto, 1510, 25.5, 7800, 9858, 648, 18306
Gepman, 1112, 114.2, 105, 181, 16, 302
geppoz, 1409, 39.0, 3638, 3764, 410, 7812
geqy, 1086, 47.6, 1799, 2890, 113, 4802
GeraldOne, 950, 166.7, 16, 53, 0, 69
gerarddesuresnes, 1810, 29.1, 528, 307, 48, 883
gerardo, 1504, 23.6, 10110, 10383, 1180, 21673
GerardT, 1382, 64.4, 134, 154, 11, 299
GermanF, 1351, 30.4, 906, 1864, 76, 2846
germanFM, 1412, 18.3, 4963, 6094, 449, 11506
germinax, 1449, 28.6, 3259, 4158, 238, 7655, 1880, 40.9, 10710, 8686, 1581, 20977
Gerona, 1576, 38.0, 3158, 2188, 175, 5521
gerontos, 1295, 43.9, 2029, 2184, 133, 4346
GerryLeeds, 1626, 112.6, 7, 6, 3, 16
GerryScott, 1596, 71.4, 6661, 4505, 1225, 12391
gershony, 826, 78.0, 145, 1729, 23, 1897
GertrudeHiggins, 1134, 42.8, 219, 284, 6, 509
geshakov, 1525, 19.2, 15629, 18844, 1987, 36460
gesterby, 1818, 130.4, 519, 290, 57, 866
getfunky, 1115, 39.8, 137, 189, 8, 334
gewoonbert, 1506, 25.8, 5715, 2589, 636, 8940
gfaulks, 1199, 33.8, 1164, 918, 63, 2145
GFchess, 1937, 34.9, 1123, 880, 203, 2206
gfin, 841, 171.3, 61, 89, 4, 154
GFlam, 1496, 43.9, 2653, 1879, 184, 4716
gfNYC, 1579, 36.9, 1782, 1507, 155, 3444
gforce, 1619, 33.1, 8116, 5285, 386, 13787
GFrege, 1441, 28.9, 1701, 1152, 99, 2952
GGekko, 1501, 97.3, 842, 838, 79, 1759
gggm, 1172, 43.3, 2535, 2055, 139, 4729
gglimer, 973, 267.0, 125, 358, 27, 510
ggll, 1368, 47.7, 1422, 1132, 71, 2625
GgPlay, 1261, 32.5, 682, 721, 38, 1441
gGrungean, 1508, 32.9, 7885, 9414, 544, 17843
GGspeedo, 1464, 37.9, 1667, 2301, 122, 4090
Ghajini, 1366, 29.7, 2442, 3478, 142, 6062
ghbdtn, 1132, 85.1, 164, 336, 11, 511
gheiss, 1367, 43.7, 2182, 1810, 305, 4297
GhengusFungus, 1217, 168.5, 21, 32, 3, 56
GHH, 1858, 45.4, 1227, 1236, 224, 2687
ghita, 1448, 38.7, 5920, 2159, 438, 8517
Ghmcadams, 940, 32.0, 87, 150, 7, 244
ghostcastlehunter, 1092, 84.8, 177, 215, 14, 406
GhostDogZZ, 1492, 66.0, 137, 64, 15, 216
GhostDragon, 1028, 64.4, 148, 238, 4, 390
ghostegy, 890, 87.3, 22, 64, 3, 89
GhostInTheShell, 1650, 95.3, 5922, 15080, 525, 21527
GhostOfValedictor, 996, 42.6, 33, 77, 1, 111
GhostVII, 993, 206.6, 7, 7, 0, 14
GHSFP, 1305, 48.9, 6306, 5407, 419, 12132
giaber, 1427, 45.0, 4454, 5091, 541, 10086
GiantFall, 1239, 27.9, 179, 205, 9, 393
gianti, 1613, 17.5, 36037, 62199, 4193, 102429
giantlizard, 1860, 34.9, 710, 537, 66, 1313
gianutio, 1602, 27.0, 12743, 13379, 1506, 27628
GibletGrey, 1792, 30.3, 7127, 5744, 612, 13483
Gibounet, 1293, 51.3, 801, 913, 77, 1791
GibsonSantos, 1564, 29.7, 2615, 1813, 163, 4591
gibzeez, 1512, 74.9, 2134, 1869, 238, 4241
Gidgiddoni, 1301, 42.4, 625, 498, 79, 1202
Gidjabolgo, 1680, 64.9, 5294, 2428, 352, 8074
giemmea, 1222, 78.0, 528, 454, 60, 1042
gieppetto, 1035, 27.4, 1002, 2432, 92, 3526
gigal, 919, 350.0, 0, 3, 0, 3
giggregor, 1813, 34.2, 858, 960, 74, 1892
gigiosky, 1036, 111.5, 26, 33, 7, 66
gigistroia, 1059, 117.1, 9, 14, 0, 23
gigu, 1424, 103.6, 416, 1235, 34, 1685
gilberg, 1374, 38.4, 5596, 4864, 350, 10810
gilbygundy, 1260, 37.0, 390, 460, 42, 892
gile, 1279, 66.4, 1692, 1821, 130, 3643
Gilgri, 1358, 28.7, 12654, 16120, 1467, 30241
giljermols, 1945, 52.0, 705, 314, 93, 1112
giljohn, 1575, 30.9, 6871, 8269, 981, 16121
GillesD, 1122, 29.9, 215, 284, 9, 508
gillimot, 1638, 32.9, 1719, 1170, 204, 3093
gilmarglover, 909, 27.6, 816, 889, 51, 1756
Gilun, 1755, 181.5, 3329, 3011, 229, 6569
gilw, 1265, 63.3, 14277, 16575, 999, 31851
Gilyth, 1355, 133.6, 252, 261, 23, 536
gimnazijalac, 1559, 39.5, 830, 1102, 62, 1994
Gimpneck, 1254, 63.2, 1690, 1455, 208, 3353
gincoolness, 1146, 163.3, 3, 8, 0, 11
gingerbreadman, 1446, 83.1, 3594, 3791, 273, 7658
GinofromLamar, 1552, 103.3, 52, 16, 3, 71
GInseki, 1411, 49.6, 2072, 2019, 299, 4390
giocatoreAA, 965, 116.0, 2, 16, 1, 19
gipp, 1445, 21.5, 7067, 7277, 451, 14795
Girafa, 1472, 116.3, 957, 1034, 112, 2103
giswinger, 1233, 37.7, 345, 445, 41, 831
giupacc, 963, 46.9, 583, 698, 23, 1304
giupeppe, 1339, 85.2, 2212, 3588, 443, 6243
giuscora, 1900, 37.2, 2708, 3108, 390, 6206
Giusjchess, 1530, 35.3, 5008, 6577, 661, 12246
givemeabreak, 1288, 22.0, 5334, 3011, 370, 8715
giwaabaj, 1412, 28.8, 686, 1006, 52, 1744
gjmata, 1104, 33.5, 4880, 5552, 323, 10755
gjohnson, 1615, 69.5, 117, 73, 6, 196
gkarpov, 1322, 42.1, 317, 295, 21, 633
gknmgc, 1811, 88.2, 172, 20, 2, 194
gkowalczyk, 1613, 30.7, 2153, 2541, 410, 5104
glasses, 1423, 140.2, 3677, 3514, 193, 7384
glaucokoltz, 1256, 29.3, 3109, 3362, 405, 6876
gleangleam, 1583, 134.4, 1756, 898, 89, 2743
Gleeson, 837, 202.5, 1, 6, 0, 7
glengarriff, 1281, 27.7, 3982, 2822, 287, 7091
glengarry, 1291, 116.1, 1702, 1139, 100, 2941
glenpean, 1199, 42.0, 1871, 1093, 124, 3088
glevett, 1172, 129.5, 91, 126, 3, 220
Globen, 1506, 28.2, 3314, 2105, 335, 5754
Globito, 1367, 116.0, 34, 30, 4, 68
globules, 1382, 84.0, 2172, 1202, 477, 3851
gloftus, 1141, 76.0, 294, 348, 19, 661
GlorytoGod, 1011, 48.7, 143, 291, 15, 449
glukas, 1339, 52.0, 1800, 1822, 214, 3836
gmadam, 1268, 111.0, 279, 495, 27, 801
gmagician, 1809, 51.1, 424, 371, 34, 829
gmann, 1172, 28.8, 6109, 8928, 921, 15958
gmartinp, 1243, 37.0, 2204, 2284, 191, 4679
GMayer, 1313, 66.3, 362, 462, 44, 868
GMFIKIL, 1276, 69.5, 712, 636, 33, 1381
GMgavin, 1647, 30.6, 9013, 4849, 555, 14417
GMggomez, 1629, 93.5, 5376, 4933, 647, 10956
GMIAG, 1548, 54.6, 838, 592, 35, 1465
Gmoneyxxx, 1399, 92.7, 992, 1474, 74, 2540
gmonkey, 1038, 90.0, 191, 275, 14, 480
gmoraesn, 1276, 92.8, 1230, 1553, 117, 2900
gmorgan, 916, 65.3, 38, 165, 7, 210
GMRainer, 1894, 38.3, 3029, 1109, 439, 4577
GMsFall, 2037, 71.0, 51, 28, 2, 81
gmuli, 1559, 36.7, 1685, 894, 105, 2684
GMZarko, 1606, 62.0, 72, 58, 5, 135
gnafrof, 1404, 31.9, 5897, 2163, 338, 8398
gnober, 1157, 47.8, 1540, 2001, 99, 3640
gnp, 1415, 41.2, 3753, 5308, 462, 9523
gnuosphere, 1406, 60.9, 1749, 1098, 137, 2984
Goac, 1766, 112.9, 1023, 1184, 112, 2319
goalscorer, 1344, 33.9, 2110, 3063, 271, 5444
GoAstros, 1268, 39.0, 624, 664, 53, 1341
gobemouche, 577, 164.9, 11, 77, 1, 89
GOBL, 1139, 59.3, 213, 776, 72, 1061
gobluebv, 1313, 36.5, 496, 477, 56, 1029
GodelEscherBach, 1402, 42.6, 881, 638, 43, 1562
GodEvil, 1609, 84.9, 187, 112, 18, 317
godisnumberone, 747, 100.2, 11, 46, 0, 57
godom, 1051, 90.0, 50, 62, 2, 114
GodsaveyourQueen, 846, 132.8, 3, 13, 0, 16
GodSentMe, 1068, 41.5, 1625, 1969, 175, 3769
godspeed, 1369, 104.0, 469, 741, 25, 1235
GodsSon, 1262, 115.6, 104, 132, 9, 245
goeffe, 1031, 87.2, 1796, 2688, 163, 4647
Goegler, 1902, 27.3, 8763, 4300, 931, 13994
gogoflorianchess, 801, 69.6, 195, 516, 5, 716
gogolov, 1585, 32.7, 4925, 3176, 424, 8525
gogora, 1156, 46.6, 959, 451, 42, 1452
GOH, 1517, 27.1, 14474, 18073, 919, 33466
gohoyas, 938, 46.1, 269, 472, 17, 758
goindian, 1666, 95.7, 82, 47, 8, 137
gojas, 828, 168.6, 3, 14, 1, 18
gojets, 1412, 25.6, 10803, 10493, 915, 22211
golab, 1840, 48.2, 13782, 10572, 1054, 25408
goldcrown, 1609, 72.9, 1126, 3048, 345, 4519
golddancer, 1334, 25.4, 3918, 3015, 296, 7229
goldenco, 932, 126.1, 85, 141, 4, 230
goldenhorse, 993, 100.9, 19, 41, 0, 60
goldstrike, 1620, 104.7, 512, 633, 92, 1237
GoLeafs, 1128, 27.1, 297, 242, 21, 560
golfdiamond, 1300, 97.6, 2834, 2729, 225, 5788
golfingfool, 1163, 38.4, 3310, 2295, 136, 5741
golfsailor, 1711, 25.4, 8835, 8891, 693, 18419
golllum, 1978, 126.7, 54, 56, 3, 113
goltrpoat, 1528, 126.9, 857, 837, 92, 1786
gomanish, 945, 84.9, 1, 37, 1, 39
GonnaForkYouUp, 1004, 237.3, 0, 2, 0, 2
gonzalvo, 1149, 33.4, 1509, 581, 46, 2136
GoodDerf, 777, 159.2, 5, 23, 1, 29
GoodFormJack, 1226, 39.2, 280, 314, 27, 621
goodgamefriend, 1612, 31.5, 2429, 3046, 176, 5651
goodharvest, 1423, 145.5, 203, 160, 24, 387
GoodKnightSoldier, 1145, 92.6, 129, 235, 2, 366
GoodOverEvil, 1041, 43.1, 112, 147, 7, 266
goodsacs, 1299, 56.7, 505, 501, 79, 1085
goodsports, 1423, 59.6, 2252, 3151, 235, 5638
googlefics, 841, 198.6, 5, 37, 0, 42
Gopisaas, 760, 124.4, 17, 90, 1, 108
GoranII, 1855, 29.1, 16422, 12430, 2156, 31008
gorbyr, 1429, 52.5, 2282, 1748, 95, 4125
gordonbaker, 1549, 32.6, 3732, 4158, 511, 8401
gorek, 1439, 31.4, 2517, 2837, 193, 5547
Gorix, 806, 91.7, 154, 614, 7, 775
goroka, 802, 115.4, 9, 66, 0, 75
GoRookYourself, 1240, 135.4, 14, 25, 1, 40
Gorovich, 1409, 118.7, 5035, 3703, 470, 9208
Gosseyn, 1473, 30.6, 6117, 7078, 654, 13849
Gotanesss, 1503, 48.0, 396, 237, 63, 696
GoteMaster, 1279, 94.3, 1355, 1097, 45, 2497
goterpaws, 933, 163.4, 98, 166, 10, 274
GothicSavior, 2039, 55.3, 944, 761, 104, 1809
GotsosAE, 1904, 25.0, 2193, 1826, 143, 4162
GotThatFire, 902, 31.8, 364, 491, 21, 876
goujonan, 1480, 54.7, 158, 112, 20, 290
GoUp, 1353, 41.3, 3156, 1706, 287, 5149
GOUPY, 1668, 179.4, 353, 313, 56, 722
gouthammr, 1403, 45.8, 77, 78, 5, 160
govekar, 1000, 246.5, 111, 138, 6, 255
Goz, 1270, 62.2, 1558, 2616, 194, 4368
GOZZLN, 1053, 85.9, 144, 166, 6, 316
gpbhat, 1218, 39.3, 1480, 1474, 195, 3149
grabapawn, 1220, 71.2, 1084, 1275, 96, 2455
gracchi, 1720, 84.1, 15324, 15791, 897, 32012
GracchusB, 1403, 35.5, 1832, 1936, 248, 4016
graceland, 1101, 55.6, 2912, 5131, 149, 8192
graceout, 1448, 37.7, 299, 512, 16, 827
grackle, 1389, 58.1, 3205, 1738, 259, 5202
grad, 1446, 55.4, 517, 360, 45, 922
gradgrinder, 1607, 27.0, 2373, 2900, 368, 5641
graemechess, 1509, 47.4, 527, 496, 66, 1089
GrainMaster, 2065, 84.6, 1145, 1024, 124, 2293
granata, 1627, 23.9, 17691, 30497, 1768, 49956
GrandLapin, 1975, 84.2, 118, 90, 9, 217
GrandmasterTako, 1512, 31.0, 3074, 2896, 513, 6483
Grandmeister, 2046, 100.5, 81, 58, 16, 155
grandpawn, 1359, 78.6, 21, 44, 2, 67
GrandUnified, 1176, 33.3, 418, 528, 34, 980
grantaylor, 1305, 31.7, 607, 789, 70, 1466
grantoncon, 955, 30.0, 1310, 3492, 52, 4854
grantrice, 1230, 60.6, 542, 479, 49, 1070
Graono, 1306, 23.3, 2433, 3705, 140, 6278
grapebro, 1307, 47.1, 686, 915, 93, 1694
Graphirah, 1795, 58.9, 1694, 319, 51, 2064
grasm, 1334, 85.7, 336, 589, 40, 965
gratis, 1768, 25.8, 9312, 3302, 579, 13193
Gravitation, 1346, 70.5, 4412, 5332, 683, 10427
GRC, 1136, 114.1, 162, 242, 1, 405
greatatothergames, 1462, 18.0, 1890, 2807, 284, 4981
greatcafe, 1426, 21.7, 8921, 14881, 1073, 24875
GreatChess, 1710, 92.3, 3345, 1978, 163, 5486
greatchessfight, 1798, 41.9, 1248, 1756, 132, 3136
GreatDayToday, 870, 146.0, 226, 196, 20, 442, 1315, 71.0, 2562, 3261, 248, 6071
greatfighter, 1498, 29.8, 5890, 5560, 778, 12228
greatideas, 1426, 69.2, 1054, 1201, 114, 2369
greatlion, 1210, 56.6, 964, 2320, 115, 3399
Greatmind, 1179, 109.9, 799, 840, 57, 1696
greatone, 1235, 70.8, 2629, 2720, 190, 5539
GreatSachin, 1424, 76.4, 2901, 3498, 323, 6722
Greavette, 1299, 34.8, 474, 607, 65, 1146
GreekHill, 1062, 152.0, 1, 14, 0, 15
greekwizard, 1901, 29.8, 10215, 8911, 1638, 20764
GreenArtifex, 1520, 219.5, 24, 15, 1, 40
GreenBlueGreen, 1237, 52.3, 564, 633, 60, 1257
Greenbrainz, 945, 193.2, 1, 7, 0, 8
GreenEnigma, 938, 258.8, 0, 2, 0, 2
greennose, 1196, 40.3, 2445, 4396, 268, 7109
GreenVb, 1375, 37.3, 2029, 881, 102, 3012
greenwoodpond, 911, 117.9, 1, 19, 0, 20
GregJohnstone, 1281, 35.1, 2920, 3627, 187, 6734
gregmcnew, 1443, 77.3, 838, 406, 73, 1317
GregOakPark, 1130, 34.3, 3448, 3336, 231, 7015
gregorious, 1259, 31.2, 6646, 5238, 607, 12491
Gregorymelville, 1220, 58.3, 2926, 4060, 253, 7239
gregorywilson, 1289, 30.7, 520, 762, 81, 1363
gregsboard, 1656, 26.9, 5950, 2638, 757, 9345
gregsh, 1514, 23.3, 3771, 4745, 319, 8835
Grendelbrood, 1329, 183.8, 3, 9, 3, 15
grenflier, 1099, 152.6, 2, 4, 0, 6
Greshlyr, 1676, 43.8, 1219, 1508, 203, 2930
gressergsumsum, 1242, 28.5, 4839, 4147, 256, 9242
GretchenisHere, 1120, 106.8, 3202, 2308, 231, 5741
greyghosst, 1127, 160.8, 2, 19, 0, 21
GreyGuru, 1241, 38.4, 1589, 1765, 170, 3524
greyhorse, 1525, 26.9, 14873, 20217, 2369, 37459
greypeace, 1239, 35.9, 1199, 1635, 97, 2931
greyseal, 1718, 32.4, 218, 267, 34, 519
GreySquare, 979, 237.9, 0, 5, 0, 5
Greystoke, 1335, 33.8, 11870, 14414, 928, 27212
grhd, 1418, 33.0, 40457, 42241, 3662, 86360
griegman, 1119, 39.8, 289, 572, 5, 866
griffone, 1574, 33.5, 1765, 1501, 161, 3427
grillmaster, 960, 61.6, 17, 27, 0, 44
grimberg, 1307, 28.8, 1569, 3133, 193, 4895
Grimbold, 1202, 36.9, 2376, 1048, 172, 3596
Grimfatale, 1068, 105.8, 184, 214, 4, 402
grimm, 1485, 90.4, 6976, 2683, 367, 10026
grizzgambit, 942, 66.1, 36, 267, 5, 308
grmpetz, 1098, 127.4, 7, 17, 1, 25
grocko, 1269, 32.1, 5655, 6320, 286, 12261
groentje, 1416, 60.1, 8674, 9304, 1199, 19177
groovyhassle, 951, 30.0, 1109, 1915, 85, 3109
GroundhogDay, 1727, 22.2, 10886, 10011, 1256, 22153
Grovel, 1430, 46.7, 15250, 14444, 1804, 31498
grubor, 1470, 97.7, 729, 498, 39, 1266
gruebi, 1745, 55.0, 2602, 1808, 281, 4691
grynte, 1182, 40.1, 2288, 3101, 79, 5468
grzdyl, 1204, 26.0, 5897, 5466, 341, 11704
gsbaker, 1540, 22.0, 4506, 3455, 297, 8258
gservat, 1713, 53.7, 4611, 3776, 375, 8762
gsfoote, 1620, 25.0, 18500, 12018, 1082, 31600
gskearse, 1723, 146.5, 2469, 1160, 165, 3794
gskolnic, 1116, 52.0, 118, 174, 10, 302
gssrikanth, 1431, 30.4, 1152, 1463, 160, 2775
gtalum, 1623, 35.6, 885, 775, 73, 1733
gterun, 881, 94.8, 57, 202, 4, 263
GTFColossus, 885, 165.4, 3, 20, 0, 23
gtn, 1478, 85.9, 172, 119, 11, 302
gtomlinson, 1133, 39.5, 2141, 1332, 105, 3578
gtvu, 1316, 43.7, 3942, 6730, 632, 11304
Guacafla, 1273, 198.5, 1, 5, 0, 6
guapomedyobastos, 1680, 42.6, 561, 560, 94, 1215
Guardoz, 1098, 63.4, 2525, 3279, 239, 6043
guarionex, 1373, 52.6, 97, 69, 7, 173
gubera, 1560, 76.5, 105, 60, 9, 174
guede, 1153, 239.6, 1, 2, 0, 3
guefegi, 1394, 23.8, 16146, 13047, 2097, 31290
Guerrero, 1740, 33.3, 1169, 1280, 227, 2676
guessbetter, 1988, 146.9, 6, 3, 0, 9
guez, 994, 68.7, 765, 1122, 32, 1919
guidepost, 1487, 36.5, 382, 459, 44, 885
guidost, 1172, 34.5, 4706, 11726, 597, 17029
guilhesas, 1010, 63.9, 526, 1191, 37, 1754
guillatta, 1257, 79.0, 367, 257, 7, 631
guillerazo, 1209, 42.6, 1176, 1343, 91, 2610
Guillochess, 1314, 38.3, 519, 488, 9, 1016
Guimasbec, 1872, 34.6, 10219, 936, 142, 11297
Guiscard, 1430, 27.8, 2304, 2343, 331, 4978
guisepp, 1819, 23.7, 2507, 1182, 151, 3840
GUITAR, 1023, 67.2, 596, 676, 38, 1310
guitardude, 1280, 40.2, 3627, 3425, 220, 7272
guitarguymark, 1181, 37.4, 535, 658, 84, 1277
guitarspider, 1577, 30.8, 4157, 2863, 405, 7425
gulpiyuri, 1947, 26.2, 1782, 2560, 313, 4655
Gumhead, 1137, 47.3, 47, 34, 1, 82
GundalaPutraPetir, 1567, 42.7, 162, 184, 13, 359
gundamz, 1402, 66.0, 982, 865, 107, 1954
GunJackz, 938, 59.8, 12, 649, 2, 663
guntheriks, 1318, 38.8, 754, 1211, 68, 2033
guoxianglei, 1504, 232.9, 0, 3, 0, 3
gupadhye, 1132, 74.0, 52, 73, 3, 128
Gurcan, 1465, 80.5, 2913, 2793, 265, 5971
Gusboss, 1684, 168.0, 823, 710, 50, 1583
guset, 1080, 58.5, 520, 953, 53, 1526
Guster, 1357, 28.8, 6046, 5917, 466, 12429
gustikiller, 1459, 37.0, 4028, 2520, 292, 6840
Gustl, 1652, 145.9, 71, 73, 13, 157
Gusu, 934, 128.2, 90, 164, 18, 272
Guther, 778, 49.6, 148, 793, 10, 951
gutshot, 1655, 58.3, 657, 437, 44, 1138
GuyMoss, 1675, 94.2, 359, 265, 25, 649
guynstpetefl, 1524, 42.7, 1565, 892, 164, 2621
Guyonne, 986, 52.5, 53, 147, 2, 202
GuyRingoir, 1606, 49.6, 1460, 1155, 164, 2779
guztuz, 1518, 35.1, 4978, 6028, 247, 11253
Gvd, 1516, 52.5, 3110, 2382, 314, 5806
gwarp, 1186, 46.4, 5862, 8406, 718, 14986
gwerking, 927, 211.2, 12, 18, 0, 30
gwhit, 1302, 40.7, 17475, 12974, 1291, 31740
gwoya, 1818, 35.5, 10136, 7223, 1113, 18472
gwsinger, 934, 122.1, 80, 258, 9, 347
gypsyjkr, 1388, 111.6, 8, 11, 2, 21
gzachess, 1636, 29.8, 620, 421, 32, 1073
gzhhz, 1600, 53.2, 2334, 1658, 80, 4072
gzoek, 1303, 139.5, 713, 244, 20, 977
haafiz, 1367, 52.5, 2798, 2261, 219, 5278
haavasoja, 1411, 31.2, 3537, 3628, 310, 7475
haberdashery, 1535, 37.7, 5660, 4387, 289, 10336
Habit, 1293, 84.2, 5642, 6541, 514, 12697
Hachiman, 1130, 38.5, 2339, 1575, 84, 3998
Hackyy, 1353, 45.2, 350, 316, 21, 687
hacx, 851, 140.6, 11, 93, 1, 105
Haderlump, 1877, 27.4, 11892, 7070, 1141, 20103
HADIOF, 1234, 41.0, 1506, 3431, 97, 5034
hafiyhazmi, 1238, 104.4, 6, 16, 3, 25
hafizhasan, 2035, 70.3, 110, 30, 5, 145
hagar, 1342, 91.9, 226, 202, 5, 433
HaGe, 1229, 73.3, 256, 205, 49, 510
HaHaYouWin, 1163, 98.2, 170, 147, 12, 329
hahblah, 1077, 119.3, 11, 12, 0, 23
haibaer, 1233, 51.0, 3166, 2618, 425, 6209
HailtotheKIng, 1080, 36.1, 348, 576, 12, 936
haine, 1322, 29.3, 760, 738, 38, 1536
haiou, 1604, 82.6, 39, 34, 5, 78
Hairsear, 1068, 77.9, 5677, 7786, 198, 13661
Hakim, 1434, 116.3, 3807, 2795, 283, 6885
Halastra, 1303, 52.8, 1197, 1379, 69, 2645
Hale, 1520, 100.3, 3845, 3079, 257, 7181
halette, 1556, 28.3, 3351, 3168, 260, 6779
halfdollar, 1308, 76.9, 613, 646, 28, 1287
halfevil, 1357, 28.3, 168, 253, 13, 434
halfie, 1183, 54.8, 605, 1031, 67, 1703
Halfman, 469, 244.8, 25, 511, 3, 539
HalfTiger, 1004, 44.4, 383, 787, 32, 1202
halheinrich, 1579, 35.5, 8141, 4919, 1150, 14210
Halibo, 1599, 140.7, 712, 593, 54, 1359
halil, 2288, 30.2, 2856, 4476, 271, 7603
hallijo, 910, 34.0, 309, 738, 8, 1055
hallywood, 1296, 34.4, 4467, 1762, 292, 6521
Halogenic, 1099, 93.5, 52, 76, 0, 128
haloperidole, 1771, 35.6, 141, 125, 32, 298
halverson, 1461, 101.3, 4213, 2054, 140, 6407
hamasaki, 1347, 28.6, 3148, 1617, 141, 4906
hameem, 765, 112.2, 2, 24, 1, 27
HamerMC, 1134, 169.1, 2, 6, 0, 8
HammandClov, 984, 84.1, 1226, 974, 62, 2262
Hammerking, 1153, 88.7, 160, 351, 5, 516
hamra, 1403, 86.4, 500, 260, 24, 784
hamrays, 1028, 25.6, 4843, 9486, 280, 14609
hamstartype, 1069, 116.5, 1357, 904, 60, 2321
Hamtam, 909, 260.1, 0, 2, 0, 2
hanamontana, 1113, 58.2, 1258, 1212, 47, 2517
hananamar, 1210, 39.8, 345, 210, 8, 563
handaxe, 1743, 51.8, 642, 820, 46, 1508
handbook, 934, 79.5, 21, 15, 6, 42
hande, 1497, 31.9, 7633, 9348, 440, 17421
HandkerchiefWaver, 1502, 71.9, 8065, 8337, 513, 16915
handyguy, 1205, 32.4, 5276, 1304, 224, 6804
HangChung, 1278, 31.2, 1659, 2386, 186, 4231
HangedMan, 1753, 33.8, 8093, 3187, 470, 11750
HangmanLE, 1471, 34.7, 904, 718, 39, 1661
Hangtime, 1584, 23.7, 2440, 2084, 214, 4738
hanifidurak, 1192, 59.5, 353, 368, 36, 757
hankypoo, 1169, 133.4, 11, 19, 0, 30
hankytime, 808, 65.2, 85, 181, 15, 281
hannder, 1321, 85.0, 25, 13, 2, 40
hanoy, 660, 191.3, 0, 6, 0, 6
HanselAndGretle, 1226, 52.5, 513, 446, 26, 985
hansk, 1222, 26.8, 5808, 4077, 261, 10146
hanss, 1364, 87.0, 791, 407, 86, 1284
hanumatha, 1207, 58.2, 383, 889, 16, 1288
HapaHaole, 1054, 50.3, 31, 43, 1, 75
hapahauli, 1304, 87.9, 274, 301, 15, 590
happycookie, 1599, 45.3, 5427, 2487, 238, 8152
happyfly, 1461, 49.0, 163, 276, 25, 464
happyholligan, 1586, 99.0, 3131, 3376, 245, 6752
happymonkey, 1029, 39.0, 1990, 2442, 106, 4538
happypaddock, 1434, 37.8, 408, 228, 33, 669
HappyTiger, 1236, 148.0, 13, 20, 0, 33
HappyTrails, 1085, 36.5, 1833, 1318, 172, 3323
HappyTurtle, 1268, 178.5, 1, 6, 0, 7
happyvutter, 1206, 41.0, 2490, 4084, 196, 6770
haquitraveis, 1395, 33.6, 6271, 5620, 318, 12209
haraldw, 1669, 32.9, 1009, 311, 28, 1348
hardcorps, 1493, 28.8, 4477, 3689, 341, 8507
Harders, 1088, 95.3, 162, 133, 13, 308
HardGravity, 1126, 101.6, 487, 540, 32, 1059
hardihardi, 1444, 63.1, 4904, 2815, 345, 8064
HardikCFA, 873, 186.7, 1, 4, 0, 5
hardinge, 1190, 33.4, 5403, 9716, 432, 15551
haredank, 1265, 34.7, 3163, 3780, 81, 7024
harikrishnan, 931, 253.8, 0, 2, 0, 2
HariniCh, 1482, 171.4, 3, 6, 0, 9
harkji, 1184, 179.0, 1, 7, 0, 8
Harkonnen, 1448, 38.8, 7803, 7854, 807, 16464
HarleyBob, 1058, 29.8, 2729, 2735, 177, 5641
harly, 820, 146.7, 3, 26, 0, 29
Harm, 1758, 29.4, 6946, 7499, 659, 15104
Harmonicus, 1503, 71.9, 166, 180, 24, 370
Harpov, 1653, 30.0, 2082, 1467, 149, 3698
Harriekov, 2161, 107.9, 144, 53, 15, 212
harrybella, 1061, 122.7, 5, 8, 1, 14
harryhenderson, 1293, 71.4, 432, 538, 22, 992
HarryP, 1385, 114.5, 5191, 4830, 815, 10836
HarryPatzer, 1551, 98.5, 7769, 3792, 570, 12131
HarryPaul, 1614, 32.8, 17205, 16468, 1385, 35058
HarryTikos, 1308, 38.5, 1098, 1506, 102, 2706
harshad, 1270, 60.8, 1772, 1907, 70, 3749
Hartford, 1012, 87.7, 1555, 908, 177, 2640
hashioka, 1535, 91.6, 1427, 1415, 208, 3050
Hashisheen, 1596, 33.3, 783, 589, 44, 1416
hasi, 1602, 69.0, 3435, 3421, 443, 7299
Hatarik, 1801, 26.3, 13976, 9104, 856, 23936
hatesminion, 1341, 94.5, 46, 193, 11, 250
Hattusil, 2070, 40.9, 1885, 1173, 186, 3244
HaveFunLosing, 1221, 51.3, 64, 60, 6, 130
Havermeyer, 1192, 33.0, 1301, 1289, 63, 2653
hawaiiseaturtle, 1391, 29.0, 1433, 1244, 186, 2863
hawkdriver, 1331, 32.4, 5016, 7134, 486, 12636
hawksnest, 890, 76.5, 487, 494, 42, 1023
HawkX, 913, 102.7, 35, 71, 3, 109
Hawxs, 1023, 34.4, 337, 531, 22, 890
hax, 1223, 36.9, 2748, 4252, 258, 7258
HAXEP, 1196, 63.7, 131, 100, 8, 239
haybail, 1086, 196.6, 7, 83, 0, 90
hazepawn, 1440, 22.8, 1762, 3520, 177, 5459
hazeyjane, 1468, 24.9, 1855, 1717, 170, 3742
hbarisic, 1171, 65.1, 434, 632, 35, 1101
hbeach, 1571, 41.7, 867, 910, 121, 1898
HBMystery, 2055, 52.0, 123, 45, 11, 179
hcth, 1918, 70.2, 1662, 1058, 164, 2884
hcuque, 1419, 31.6, 1667, 2132, 96, 3895
hdieu, 1849, 134.2, 410, 193, 26, 629
hdivine, 1635, 72.1, 2238, 1565, 120, 3923
hdreithaug, 836, 158.4, 163, 197, 12, 372, 1463, 81.8, 5008, 3390, 488, 8886
Headhunterz, 1928, 28.7, 1843, 1912, 232, 3987
HealyHlohlo, 1744, 339.2, 1, 0, 0, 1
heathcliff, 1374, 26.5, 15808, 13687, 1222, 30717
heatmiser, 1542, 49.4, 1037, 1661, 107, 2805
HebertoPrieto, 1337, 32.1, 1292, 1029, 107, 2428
HeckleTheComic, 1777, 93.2, 144, 168, 27, 339
heckubiss, 938, 74.2, 541, 661, 35, 1237
hecticone, 1150, 81.6, 54, 123, 1, 178
heelcatcher, 1112, 133.7, 11, 38, 0, 49
Hefaracci, 1015, 39.4, 181, 261, 8, 450
Heffay, 1343, 21.4, 2678, 2535, 187, 5400
hehehaha, 1192, 80.7, 22, 223, 4, 249
hehehpro, 1355, 24.8, 1546, 1803, 175, 3524
Heidrun, 1573, 35.4, 26606, 14492, 1303, 42401
heijdenrijk, 1469, 164.9, 25, 15, 4, 44
Heim, 1448, 28.2, 24257, 23074, 2883, 50214
heinshi, 1035, 56.4, 41, 47, 6, 94
Heisenberg, 1687, 101.3, 913, 653, 69, 1635
hejo, 1436, 35.7, 3637, 3384, 286, 7307
HeldRichthofen, 1405, 35.7, 561, 911, 72, 1544
Helfi, 746, 55.4, 11, 63, 1, 75
HelioMagalhaes, 1169, 46.3, 337, 632, 17, 986
HeliosGOA, 1932, 113.8, 29, 9, 0, 38
HELLOOOO, 798, 159.2, 2, 8, 0, 10
helmsknight, 1583, 142.5, 320, 1265, 31, 1616
HelmutAustria, 1178, 32.9, 7459, 7341, 922, 15722
helpless, 1733, 48.8, 4344, 5046, 521, 9911
helsquiades, 1014, 95.7, 50, 129, 14, 193
Helten, 1555, 44.9, 2103, 1379, 141, 3623
hemantdhawan, 876, 157.0, 0, 43, 0, 43
hemantunde, 1089, 89.6, 14, 26, 1, 41
hemoglobin, 1677, 200.6, 200, 127, 10, 337
Hena, 1199, 29.5, 1231, 2163, 116, 3510
Henderb, 1408, 51.1, 245, 282, 29, 556
hendocmk, 1114, 31.2, 686, 582, 39, 1307
HengusMengus, 1412, 37.5, 900, 787, 88, 1775
hennessychen, 1262, 55.5, 50, 61, 4, 115
HenriM, 1621, 25.2, 5046, 7199, 491, 12736
henrydeadlift, 968, 146.3, 39, 40, 3, 82
henryharfo, 1278, 40.0, 1646, 1814, 90, 3550
HenryTheCat, 1540, 88.3, 673, 752, 82, 1507
HeoCon, 1791, 124.1, 1248, 1265, 108, 2621
Hepha, 1382, 70.0, 416, 682, 45, 1143
Hepi, 1449, 33.1, 8128, 11725, 497, 20350
Herach, 2113, 71.3, 853, 262, 53, 1168
Herbtea, 1479, 45.8, 678, 1062, 86, 1826
hereisgone, 932, 121.2, 9, 31, 0, 40
herethere, 1094, 118.8, 74, 153, 7, 234
Hermanho, 1664, 37.8, 876, 773, 83, 1732
Hermannlfri, 1383, 33.6, 2615, 4107, 205, 6927
Hernekeitto, 1294, 25.9, 3391, 3185, 186, 6762
HeroHua, 1056, 160.4, 2, 9, 0, 11
Heroicos, 1616, 48.3, 528, 727, 100, 1355
herrahuu, 1276, 40.5, 2589, 2832, 252, 5673
HerrSnibbens, 1123, 139.0, 20, 27, 3, 50
HerryPur, 1252, 124.9, 2, 22, 0, 24
hersla, 1558, 35.6, 15214, 10973, 1061, 27248
Hessy, 1345, 74.1, 11, 19, 1, 31
hest, 1249, 37.7, 3637, 4303, 139, 8079
HeWhoCan, 1561, 30.4, 3111, 4502, 415, 8028
Hewhohasnofear, 1330, 32.6, 1230, 1102, 87, 2419
Hexatetra, 1622, 29.5, 8019, 7171, 610, 15800
heybo, 1072, 41.3, 226, 229, 21, 476
heywhat, 1006, 200.1, 6, 10, 0, 16
heyzee, 1128, 111.2, 952, 1030, 56, 2038
HFel, 1273, 134.4, 241, 187, 11, 439
HFinn, 1500, 39.6, 548, 670, 46, 1264
hgamez, 1075, 44.5, 521, 843, 19, 1383
Hghg, 1773, 25.5, 5532, 4518, 334, 10384
hgir, 1292, 27.0, 1228, 1428, 41, 2697
hguella, 948, 97.1, 43, 111, 6, 160
HHagen, 1712, 26.1, 804, 571, 80, 1455
HHavelock, 1212, 110.9, 2478, 2538, 145, 5161
HHSHornet, 1473, 80.1, 61, 70, 14, 145
hicos, 1249, 29.0, 2755, 2991, 84, 5830
Hidabhu, 1191, 118.0, 6, 5, 2, 13
hidayat, 1678, 22.5, 1398, 1498, 135, 3031
HiddenPro, 2029, 54.0, 1763, 1143, 219, 3125
Hidenori, 1141, 350.0, 0, 1, 0, 1
Hierbabuena, 1648, 63.8, 6210, 5821, 669, 12700
Hieronaut, 1127, 49.9, 29, 58, 2, 89
Hieronimous, 1661, 50.9, 758, 449, 28, 1235
HiFi, 1590, 98.6, 115, 70, 0, 185
HighAspirations, 1475, 30.8, 2488, 1531, 140, 4159
highevif, 1247, 46.1, 1050, 1012, 73, 2135
highhattif, 983, 136.4, 3, 13, 0, 16
highjump, 949, 127.0, 9, 27, 0, 36
highlanderuscav, 758, 138.2, 5, 23, 1, 29
Highstakes, 1527, 82.6, 599, 155, 18, 772
highwayhealer, 793, 65.5, 677, 1548, 81, 2306
highwayroamer, 586, 70.3, 6, 64, 1, 71
hihowareyou, 1042, 53.7, 56, 102, 5, 163
Hiippo, 988, 127.7, 64, 121, 1, 186
hilflos, 1409, 96.8, 1939, 2162, 156, 4257
Hillex, 1232, 47.1, 1067, 1106, 228, 2401
Hilratio, 1298, 104.1, 2411, 2252, 268, 4931
Hindoo, 1521, 69.2, 32918, 32336, 4597, 69851
hinoon, 1549, 27.1, 2297, 1875, 227, 4399
Hinrik, 1651, 65.7, 1310, 1077, 125, 2512
HiPatzer, 1343, 31.3, 1134, 2048, 63, 3245
hiperbaton, 1212, 41.0, 561, 653, 40, 1254
HIPOSTASIS, 1401, 36.4, 4712, 5654, 194, 10560
hipparchos, 1393, 41.7, 6725, 4063, 404, 11192
HippieLove, 1711, 39.1, 180, 112, 9, 301
Hiroller, 1134, 34.1, 85, 122, 5, 212
HirschEA, 1140, 69.8, 695, 707, 82, 1484
hirudo, 1244, 64.2, 225, 258, 16, 499
Hisrook, 987, 78.4, 2460, 2996, 232, 5688
hissmajesty, 1200, 46.2, 1610, 3053, 191, 4854
hitchiker, 1581, 60.2, 2307, 1091, 163, 3561
hitosyura, 1055, 196.0, 2, 3, 0, 5
Hiuz, 1078, 44.7, 142, 258, 16, 416
hiway, 1358, 52.6, 3296, 2972, 275, 6543
Hizakigp, 1107, 29.0, 448, 244, 19, 711
hjeand, 949, 30.8, 364, 415, 31, 810
hjuarezv, 1360, 147.2, 10, 10, 2, 22
hkbhkb, 1158, 83.0, 113, 289, 22, 424
hkragelund, 1199, 34.1, 1905, 1624, 105, 3634
hlacko, 1507, 34.9, 2316, 3355, 337, 6008
hllyrck, 1397, 77.4, 2821, 2741, 200, 5762
HLM, 1264, 46.8, 1395, 991, 117, 2503
hman, 1229, 31.4, 10028, 6875, 488, 17391
hmb, 1701, 28.0, 3811, 3520, 214, 7545
HMr, 1261, 65.5, 1906, 2046, 157, 4109
hnikkl, 1470, 35.2, 4981, 3920, 307, 9208
hoabinh, 1582, 70.6, 849, 1072, 70, 1991
Hoboslobo, 1186, 106.1, 4400, 2420, 331, 7151
hochelaga, 1309, 32.4, 1147, 1159, 114, 2420
HoChiMihn, 793, 130.0, 8, 55, 1, 64
hoffenheimer, 1239, 116.5, 251, 372, 24, 647
Hogeye, 1632, 55.1, 1811, 740, 144, 2695
hogoapen, 1371, 23.5, 10674, 11499, 1103, 23276
hokazak, 1305, 79.6, 175, 191, 11, 377
hokieman, 1215, 335.2, 1, 1, 0, 2
Holgate, 864, 118.8, 6, 15, 0, 21
hollandais, 1326, 222.9, 3, 3, 0, 6
HologramSeven, 1090, 31.3, 137, 333, 7, 477
Holtzy, 1056, 118.5, 74, 286, 10, 370
HolyGodlovaMan, 861, 119.0, 15, 61, 2, 78
HolyHolcomb, 846, 214.3, 0, 5, 0, 5
holynoise, 1494, 44.5, 3826, 2383, 171, 6380
HolzSchieber, 1280, 38.2, 1327, 1438, 14, 2779
homeomorphism, 1677, 68.9, 1291, 2187, 216, 3694
homerg, 1237, 24.8, 8476, 9984, 368, 18828
homerun, 1255, 43.2, 6189, 4015, 373, 10577
hominoid, 1310, 81.1, 473, 601, 65, 1139
HomogenousMass, 920, 82.3, 1214, 2899, 54, 4167
Homorobo, 1332, 53.3, 1623, 3670, 210, 5503
hongdae, 1161, 58.1, 217, 214, 14, 445
Hono, 1305, 262.4, 828, 572, 64, 1464
honorablemanfj, 1013, 84.6, 171, 288, 12, 471
hoogan, 1431, 39.4, 1665, 1335, 157, 3157
hooleehootoo, 1132, 40.1, 740, 794, 37, 1571
Hooplehead, 1328, 37.5, 1159, 1304, 197, 2660
HOOTERHUNTER, 1178, 56.4, 124, 193, 9, 326
hopeloze, 1575, 52.0, 249, 298, 30, 577
HopHopHop, 1183, 37.1, 211, 234, 21, 466
HopingToLearn, 967, 76.4, 66, 195, 6, 267
Hoplyte, 1393, 113.6, 202, 180, 33, 415
Hopsa, 1825, 43.6, 16119, 7261, 1006, 24386
horizonSeven, 1110, 345.4, 0, 1, 0, 1
horreh, 847, 46.7, 195, 504, 29, 728
HorseBadorties, 1607, 40.0, 2023, 1455, 243, 3721
Horseknight, 1050, 171.8, 2, 5, 0, 7
Horselikesmerlot, 923, 137.4, 2, 27, 0, 29
horseloser, 995, 59.7, 2234, 4884, 201, 7319
HorseMove, 1408, 33.4, 891, 988, 114, 1993
horsens, 1074, 35.8, 2774, 6876, 326, 9976
horst, 1496, 60.6, 9620, 9845, 1107, 20572
Hosed, 808, 123.5, 34, 172, 0, 206
hoself, 1002, 101.5, 36, 67, 4, 107
hoshiboshi, 1592, 64.3, 418, 470, 33, 921
hossamegypt, 724, 116.6, 0, 25, 0, 25
hosstheboss, 1016, 48.1, 146, 267, 15, 428
HotBoxResident, 1866, 32.6, 3783, 2072, 215, 6070
HotCaldron, 1065, 25.9, 6931, 18536, 696, 26163
hotchicken, 1710, 80.4, 848, 160, 40, 1048
Hotheadyoung, 1591, 37.0, 1640, 1641, 253, 3534
hotintheshade, 1173, 56.8, 612, 949, 56, 1617
HotSocks, 1113, 39.8, 1140, 1240, 49, 2429
hottboy, 1202, 25.0, 536, 1195, 28, 1759
Hottybumbalottie, 1222, 23.9, 2868, 5131, 166, 8165
housegecko, 1537, 35.1, 790, 424, 47, 1261
housetm, 688, 105.0, 16, 61, 0, 77
HovD, 1202, 308.7, 2, 2, 0, 4
howardd, 1058, 41.1, 1393, 1629, 104, 3126
howdyfolks, 1507, 55.9, 2876, 2485, 218, 5579
hoyasaxa, 1319, 60.9, 4316, 3221, 260, 7797
HPdrifter, 1158, 42.8, 2386, 3585, 225, 6196
hperalta, 990, 35.8, 464, 670, 38, 1172
hpexpansion, 1128, 71.3, 369, 1368, 13, 1750
HPotzerWizard, 1642, 40.1, 344, 234, 42, 620
Hreinn, 1133, 25.1, 4026, 5919, 280, 10225
hreyes, 1283, 67.5, 131, 439, 16, 586
HRoark, 1128, 47.2, 1037, 1524, 89, 2650
hrobhen, 2026, 92.5, 219, 39, 22, 280
hrogers, 1298, 66.4, 1391, 968, 108, 2467
HrvEngay, 1104, 147.6, 7, 21, 1, 29
hsejar, 1211, 45.6, 1957, 2835, 126, 4918
HsiangLin, 1403, 24.4, 2167, 2152, 138, 4457
HSteach, 957, 62.1, 330, 659, 40, 1029
hthen, 1506, 38.7, 4591, 1840, 211, 6642
hubbles, 1602, 116.9, 22779, 20371, 1668, 44818
hudders, 1210, 44.0, 5297, 5594, 535, 11426
hudy, 1257, 34.0, 78, 122, 5, 205
Huey, 1512, 343.2, 3075, 2726, 415, 6216
Hugi, 1355, 28.2, 12061, 12118, 1218, 25397
HUGOABEL, 1907, 19.5, 5624, 10219, 997, 16840
hugore, 1428, 29.2, 1771, 1849, 90, 3710
Hulky, 1129, 67.9, 687, 1018, 52, 1757
huluky, 1384, 46.1, 11295, 12570, 643, 24508
humblepreacher, 1036, 107.8, 465, 699, 35, 1199
Hummeress, 1750, 40.1, 1660, 1130, 120, 2910
humohr, 1261, 58.9, 9006, 10529, 808, 20343
humphy, 1481, 35.4, 1934, 2403, 157, 4494
hunathry, 1168, 171.9, 5, 4, 1, 10
Hunchie, 1268, 43.3, 700, 614, 53, 1367
HungarianBassoon, 1258, 139.2, 108, 74, 4, 186
HungerArtists, 1735, 31.4, 279, 314, 50, 643
hungrylion, 1257, 86.3, 578, 781, 30, 1389
HunGuard, 1344, 57.7, 77, 80, 5, 162
Hunkacsa, 1243, 54.1, 519, 458, 38, 1015
HUNriderrr, 1179, 27.3, 3512, 4325, 268, 8105
huntedx, 1289, 41.3, 5508, 4692, 262, 10462
HunterRose, 1201, 36.8, 4222, 3788, 238, 8248
Hupernikao, 1587, 125.9, 1287, 572, 62, 1921
HuPhardid, 1344, 66.6, 66, 76, 2, 144
Hurikai, 1157, 57.7, 440, 719, 43, 1202
HurtedKing, 1455, 36.4, 4121, 5663, 303, 10087
HurtU, 1281, 31.7, 4984, 4698, 375, 10057
HustlaTHEgreat, 1845, 32.9, 366, 400, 36, 802
huuma, 1388, 39.9, 5444, 4401, 385, 10230
Hvdsqr, 1555, 55.2, 4262, 4195, 392, 8849
Hvergang, 1318, 42.0, 1294, 1201, 378, 2873
hvutrong, 1385, 30.5, 1138, 1365, 96, 2599
hwcbn, 1501, 33.8, 1654, 1445, 170, 3269
hwhoffmanx, 967, 32.9, 714, 654, 50, 1418
hxl, 1201, 34.7, 4214, 3639, 405, 8258
hxtnwdlr, 1782, 32.1, 1215, 1227, 173, 2615
hyderabadiguy, 798, 75.3, 7, 26, 1, 34
hydril, 1009, 130.4, 23, 66, 3, 92
hyenaman, 1364, 39.3, 1124, 748, 45, 1917
HyllusDiardi, 2007, 124.9, 365, 249, 32, 646
hypercypher, 938, 99.9, 27, 79, 2, 108
HyperionIp, 864, 276.5, 4, 12, 0, 16
hypermode, 1607, 49.1, 1476, 752, 115, 2343
hyperspace, 1404, 28.6, 3985, 6395, 241, 10621
Hyperwolf, 1326, 50.1, 60, 45, 0, 105
hyvohra, 1307, 284.2, 0, 2, 0, 2
hyvpiv, 1445, 20.7, 5073, 5762, 302, 11137
hzandras, 1394, 24.1, 10993, 9896, 1363, 22252
iaalic, 1407, 58.5, 1910, 1768, 99, 3777
IagainstI, 1401, 39.3, 10080, 13489, 995, 24564
IagoPrytherch, 1400, 48.4, 1453, 948, 130, 2531
iaguete, 1553, 37.3, 1112, 1234, 152, 2498
iaguila, 1412, 113.5, 307, 288, 17, 612
iallip, 1486, 25.9, 5394, 6338, 884, 12616
iamanigeeit, 1218, 87.2, 817, 795, 76, 1688
IamCurio, 930, 74.5, 42, 228, 5, 275
iameatingmyself, 1582, 31.0, 869, 630, 65, 1564
IamJa, 1544, 81.4, 565, 423, 41, 1029
iammark, 1526, 53.5, 1222, 1635, 185, 3042
iamredeemed, 1151, 30.8, 284, 483, 33, 800
IAmSolInvictus, 1027, 231.2, 0, 3, 0, 3
iamthatguyyousee, 1537, 57.1, 170, 212, 27, 409
IamTHEworst, 1019, 235.6, 0, 2, 0, 2
iamwinner, 943, 96.7, 5, 19, 0, 24
iangoth, 1602, 80.7, 95, 70, 20, 185
iann, 1071, 34.6, 3712, 4118, 269, 8099
IanW, 1303, 32.8, 3322, 1688, 143, 5153
iatrowvw, 1256, 100.7, 357, 325, 18, 700
IattackU, 1695, 108.5, 865, 150, 32, 1047
ibeachessnut, 1328, 50.3, 1087, 763, 117, 1967
IBfrisker, 1569, 113.9, 129, 60, 6, 195
ibkomega, 1472, 157.8, 2545, 2123, 142, 4810
ibraheem, 1344, 28.2, 3458, 3894, 144, 7496
Icaras, 1464, 42.2, 2432, 1376, 136, 3944
iCarly, 1807, 119.3, 86, 70, 17, 173
ICCTheorist, 1663, 102.6, 249, 124, 17, 390
iceblastor, 1822, 74.7, 510, 381, 26, 917
icefive, 1387, 25.7, 5330, 3542, 133, 9005
Icejacket, 1324, 146.1, 4, 3, 0, 7
Icekimo, 1541, 41.7, 971, 519, 75, 1565
icemaniran, 1482, 76.7, 3440, 5665, 342, 9447
iceninejkw, 1791, 34.1, 11069, 11481, 1616, 24166
icewizard, 1319, 122.2, 862, 417, 54, 1333
IchaAja, 1054, 40.2, 50, 178, 5, 233
IchiTatami, 1499, 51.4, 63, 57, 9, 129
IchSpieleSchach, 1624, 67.9, 39, 22, 2, 63
icinko, 1290, 36.7, 3678, 2455, 220, 6353
ickeidol, 1275, 121.6, 118, 121, 11, 250
IcProz, 960, 143.9, 2, 6, 0, 8
ICROKIS, 1053, 50.1, 843, 649, 43, 1535
icyy, 1206, 31.7, 1534, 2017, 118, 3669
IdahoPlayers, 1140, 56.8, 319, 279, 32, 630
idareyou, 1364, 36.9, 254, 260, 18, 532
idmon, 1605, 29.1, 5885, 7098, 439, 13422
idmyomy, 1408, 36.6, 4578, 4697, 399, 9674
idontgetpaid, 965, 223.0, 3, 13, 1, 17
idontthink, 1719, 30.1, 574, 461, 62, 1097
IdrisHunt, 1111, 76.8, 40, 111, 5, 156
idvoiris, 1178, 27.1, 2111, 3522, 137, 5770
Idyia, 1467, 21.1, 15337, 20555, 857, 36749
Idylapple, 1603, 27.7, 4458, 4051, 371, 8880
ieeewiz, 1186, 123.2, 33, 153, 3, 189
ifconfig, 1534, 25.0, 1949, 2083, 150, 4182
iff, 1383, 43.6, 3372, 2797, 233, 6402
iffy, 1392, 108.3, 12, 9, 1, 22
IForkedYourQueen, 1355, 37.2, 1383, 1662, 154, 3199
Ifrit, 1779, 24.9, 7740, 6145, 921, 14806
igdav, 1703, 34.2, 1636, 547, 154, 2337
iggman, 1248, 74.4, 749, 1181, 105, 2035
Ignac, 1554, 99.1, 3087, 3779, 437, 7303
Ignis, 1410, 83.8, 802, 540, 34, 1376
igor, 1679, 25.6, 11965, 16342, 1748, 30055
igorbur, 1438, 102.2, 10, 10, 0, 20
igorerin, 1491, 24.1, 5460, 4356, 508, 10324
igorfm, 1230, 37.9, 3795, 3569, 193, 7557
IgorOK, 1703, 114.1, 29, 43, 1, 73
igorwolf, 1156, 128.2, 19, 72, 1, 92
IGotJediKnightsYo, 871, 33.2, 192, 556, 33, 781
ihabjazi, 1289, 198.1, 998, 1693, 102, 2793
ihadita, 999, 44.0, 166, 346, 8, 520
ihgeo, 1208, 38.0, 1474, 2742, 114, 4330
ihme, 1266, 28.1, 5538, 10133, 654, 16325
ihopetowin, 1084, 117.2, 241, 219, 12, 472
IHorn, 1243, 128.3, 5, 4, 0, 9
IHUBOHILLXIT, 1378, 66.4, 245, 115, 13, 373
ihusain, 1680, 55.9, 1571, 1679, 165, 3415
IIbrahim, 1728, 41.0, 4273, 4646, 581, 9500
IiroRantala, 2022, 43.4, 1403, 1494, 161, 3058
iischydro, 1637, 26.7, 7634, 7226, 1687, 16547
iiznutme, 1067, 39.1, 3029, 5343, 374, 8746
IjonTichy, 1693, 90.6, 3543, 2881, 180, 6604
ikab, 1427, 32.2, 2221, 2818, 216, 5255
Ikarus, 1381, 23.1, 11222, 16782, 973, 28977
ikey, 2000, 31.0, 12611, 6087, 1422, 20120
ikolay, 1167, 83.7, 66, 76, 5, 147
Ikos, 1440, 54.2, 2230, 1656, 140, 4026
ilankuni, 1799, 27.1, 7085, 6812, 917, 14814
ilaocsic, 1030, 146.9, 50, 63, 1, 114
ilcavaliere, 1171, 41.9, 1324, 1578, 99, 3001
Ildsborg, 610, 115.0, 3, 34, 0, 37
ilia, 1203, 346.8, 404, 575, 50, 1029
iliapana, 1584, 65.0, 2977, 2311, 212, 5500
ILIASSSK, 1776, 124.4, 76, 50, 8, 134
iLinx, 1534, 94.0, 879, 639, 39, 1557
IlllllllllllllllI, 1800, 28.2, 4862, 5413, 526, 10801
illplayblack, 1151, 162.3, 2, 8, 0, 10
illuminatipiss, 719, 30.2, 68, 413, 9, 490
illus, 964, 153.2, 9, 24, 1, 34
ilmi, 1106, 53.6, 732, 1548, 51, 2331
ilohmar, 1739, 27.9, 11020, 11705, 1170, 23895
ilovecynthia, 1445, 85.9, 259, 178, 23, 460
ilovemydog, 1282, 40.1, 135, 53, 5, 193
ilovemyson, 1025, 50.5, 81, 181, 7, 269
ILoveUButUBoring, 1769, 108.2, 5537, 4478, 625, 10640
ilpakk, 1609, 82.2, 14963, 14571, 1294, 30828
ilster, 1297, 63.4, 53, 110, 2, 165
ilsto, 1328, 27.2, 7896, 10999, 1412, 20307
ilvspad, 938, 138.3, 146, 332, 16, 494
ilyabalto, 1608, 35.4, 19237, 8209, 1829, 29275
ilyachess, 1264, 174.9, 3, 16, 1, 20
ilyash, 1606, 60.5, 711, 674, 96, 1481
Ilyeria, 1434, 76.5, 660, 708, 67, 1435
ImaGumby, 1337, 167.8, 107, 102, 8, 217
IMAKETHEPACE, 1082, 96.8, 349, 322, 13, 684
Imbalancer, 1513, 66.1, 989, 812, 80, 1881
imello, 1257, 33.0, 1501, 1511, 85, 3097
Imen, 1329, 41.9, 4065, 3730, 336, 8131
imennoharm, 1015, 102.6, 17, 39, 1, 57
imerio, 1221, 44.2, 972, 1586, 92, 2650
imgoodrooking, 1132, 75.7, 184, 270, 27, 481
IMgooeyjim, 1989, 83.8, 751, 759, 136, 1646
IMJR, 1037, 81.9, 162, 391, 8, 561
ImJustAKId, 1204, 29.6, 4294, 4955, 277, 9526
imlap, 1267, 35.0, 268, 212, 11, 491
imnotthewalrus, 1201, 43.7, 398, 361, 8, 767
Imox, 1591, 31.4, 3099, 3390, 435, 6924
impe, 1295, 57.4, 6855, 6553, 500, 13908
Imperador, 1469, 31.8, 19419, 31623, 1803, 52845
Imperator, 1396, 37.6, 4706, 5247, 384, 10337
implacabile, 1638, 23.5, 16538, 14064, 1320, 31922
impossibilist, 965, 36.5, 668, 782, 60, 1510
impossiblepawn, 1325, 71.9, 33, 29, 6, 68
impress, 1591, 24.7, 10626, 8061, 1042, 19729
ImprezaWRX, 1880, 327.3, 2, 0, 0, 2
ImProbablyLost, 1442, 31.3, 2814, 3306, 214, 6334
imrankhan, 727, 65.3, 53, 150, 3, 206
ImranSheth, 1016, 93.8, 21, 39, 0, 60
imreoir, 1508, 55.3, 2321, 1587, 221, 4129
imsaboy, 1556, 48.8, 2838, 2161, 126, 5125
imseriousabtchess, 1312, 69.1, 198, 316, 13, 527
imsttirol, 1488, 95.9, 5467, 7828, 583, 13878
IMTheRealDeal, 2172, 53.4, 372, 194, 32, 598
imusashi, 887, 99.6, 31, 57, 4, 92
inahmias, 1407, 43.1, 1391, 1141, 90, 2622
Inaste, 1192, 54.2, 528, 460, 40, 1028
inbox, 1269, 103.0, 107, 113, 0, 220
inco, 1275, 50.7, 376, 356, 27, 759
Incogneato, 1281, 57.4, 551, 566, 53, 1170
InControl, 1359, 40.4, 5659, 7543, 605, 13807
incucu, 1543, 38.8, 2279, 2145, 176, 4600
indahouse, 1334, 26.6, 11453, 13172, 1219, 25844
indecente, 653, 76.1, 6, 41, 1, 48
IndianFischer, 1231, 139.2, 2, 40, 0, 42
IndianMonk, 827, 65.0, 19, 52, 0, 71
Indianpoint, 1222, 29.5, 3051, 4305, 332, 7688
IndianReaper, 1558, 35.3, 1678, 1967, 151, 3796
indiawins, 1206, 32.1, 1312, 2175, 170, 3657
indiumas, 1188, 136.8, 191, 157, 24, 372
Indomobil, 1124, 50.6, 124, 283, 9, 416
indralord, 1650, 76.9, 12569, 10262, 996, 23827
indrianto, 1068, 72.8, 66, 224, 2, 292
InduMMS, 1317, 39.2, 2676, 3255, 207, 6138
industrialMuffin, 1143, 32.6, 3057, 2827, 115, 5999
Ineverdraw, 1423, 40.9, 792, 380, 53, 1225
Infamity, 1303, 92.6, 7, 15, 0, 22
infinatum, 999, 297.4, 17, 85, 1, 103
InflictPain, 1585, 86.6, 4748, 9546, 951, 15245
informeddissent, 1153, 89.2, 293, 715, 20, 1028
ingenierodos, 1364, 40.1, 895, 1277, 114, 2286
InigoM, 1192, 45.1, 446, 642, 22, 1110
INIS, 1470, 44.5, 2134, 810, 219, 3163
injustice, 1378, 35.9, 520, 1154, 21, 1695
inkling, 1295, 28.8, 6895, 5964, 623, 13482
inomneparatus, 1278, 35.0, 1061, 1748, 50, 2859
InParis, 1660, 36.2, 141, 109, 12, 262
InsaneManiac, 1828, 39.0, 4830, 2093, 427, 7350
Inschipupa, 1708, 31.8, 2565, 1625, 356, 4546
insidetrip, 1075, 122.9, 121, 184, 9, 314
Insomniak, 1336, 30.8, 1303, 1197, 104, 2604
Inspektor, 1777, 71.8, 1236, 1377, 343, 2956
Inspektorn, 1267, 108.9, 5723, 7862, 424, 14009
InstantPoison, 1685, 27.6, 9037, 4439, 541, 14017
instrumental, 926, 82.3, 70, 207, 3, 280
IntegratorDx, 871, 69.5, 35, 81, 6, 122
intellow, 723, 119.9, 41, 373, 1, 415
Intentional, 1651, 36.0, 549, 603, 44, 1196
Interaction, 1270, 60.3, 13096, 10369, 436, 23901
intermezzo, 1374, 73.5, 740, 912, 24, 1676
IntKrauz, 1176, 32.8, 74, 93, 4, 171
intotheblue, 1321, 110.4, 491, 368, 24, 883
intpusa, 1673, 49.9, 88, 57, 14, 159
Intuitif, 1680, 54.0, 1789, 1228, 65, 3082
intuitionme, 889, 146.5, 13, 16, 0, 29
invecast, 1246, 120.1, 2415, 4256, 248, 6919
invocative, 2033, 21.1, 5384, 3958, 808, 10150
Ionic, 892, 105.3, 4062, 2913, 230, 7205
IONUTNEDEA, 1196, 70.3, 2202, 3028, 100, 5330
IOOOOOWelcomesWeb, 685, 163.8, 42, 270, 3, 315
iosonoale, 1299, 38.5, 3915, 3873, 216, 8004
IoTol, 766, 56.2, 20, 124, 4, 148
ipodvideo, 1429, 138.4, 29, 33, 5, 67
IPooOnIAU, 1374, 89.1, 2917, 1048, 129, 4094
Ippos, 1385, 59.7, 1861, 3524, 298, 5683
Iqui, 1325, 34.5, 1104, 948, 54, 2106
ira, 1619, 24.9, 7751, 4193, 721, 12665
irak, 1077, 57.8, 144, 160, 16, 320
irankish, 1787, 58.1, 542, 782, 109, 1433
irdi, 1126, 53.1, 333, 528, 48, 909
irishluck, 1113, 350.0, 2, 1, 0, 3
IrishPirate, 1422, 54.7, 1577, 594, 84, 2255
irisht, 1040, 113.9, 45, 52, 1, 98
IrishVevette, 1546, 29.9, 1721, 2171, 138, 4030
IrmaSeriDiana, 1387, 78.1, 38, 148, 4, 190
IronBalls, 1254, 34.4, 2569, 2980, 160, 5709
IronChris, 1531, 31.8, 7570, 1233, 144, 8947
ironclownfish, 952, 116.8, 4, 25, 0, 29
IronFelixx, 1355, 28.5, 6920, 5701, 558, 13179
Ironheadjohn, 1087, 158.8, 28, 49, 4, 81
IronJaw, 1202, 27.2, 1656, 1849, 98, 3603
IronKiwi, 1647, 32.9, 533, 319, 46, 898
Ironman, 1238, 91.8, 3566, 3858, 283, 7707
ironpillar, 1408, 36.9, 2562, 2082, 94, 4738
IronTigran, 1479, 52.2, 496, 283, 35, 814
IronXavi, 1537, 114.4, 612, 560, 60, 1232
irvingdlt, 1134, 114.1, 18, 39, 2, 59
Irwana, 1439, 56.7, 442, 650, 97, 1189
isaaclev, 1486, 71.3, 859, 882, 75, 1816
isaacsheff, 944, 77.4, 14, 51, 4, 69
isaacwood, 1412, 44.9, 3982, 2009, 392, 6383
IsaiaGev, 1175, 41.7, 1990, 1622, 147, 3759
isamax, 1048, 103.7, 840, 1291, 53, 2184
isami, 1625, 138.7, 2371, 1234, 122, 3727
ISavant, 1409, 31.1, 927, 1011, 82, 2020
isclus, 1187, 99.6, 4, 21, 1, 26
isdash, 1288, 40.4, 1984, 2825, 284, 5093
ISeeTheRain, 1027, 30.4, 69, 96, 5, 170
Isfen, 1912, 73.6, 14544, 6876, 1039, 22459
Ishfie, 1058, 131.8, 116, 219, 10, 345
Ishotthedeputy, 1198, 224.5, 2, 2, 2, 6
Ishtaire, 1422, 25.5, 280, 445, 15, 740
isidorito, 913, 60.4, 367, 732, 28, 1127
IsmailN, 822, 133.5, 23, 122, 2, 147
Ismarck, 1630, 43.6, 318, 410, 50, 778
ISmiteThemAll, 1565, 132.9, 1083, 611, 43, 1737
isochronus, 1672, 46.1, 1222, 678, 107, 2007
Isofix, 1457, 88.0, 4283, 2234, 301, 6818
isoprene, 903, 232.5, 8, 24, 0, 32
isopropyl, 1373, 24.1, 1776, 2670, 96, 4542
Ispanico, 1308, 30.9, 618, 820, 41, 1479
ispie, 1641, 105.8, 525, 652, 47, 1224
israelrt, 1029, 36.3, 2776, 3945, 205, 6926
israfox, 1143, 34.5, 866, 1664, 60, 2590
issoss, 1402, 38.8, 4019, 3688, 190, 7897
istan, 1388, 180.1, 11, 6, 0, 17
istarob, 1803, 22.2, 30877, 30853, 3516, 65246
Istefel, 1585, 29.1, 10637, 6606, 726, 17969
isthmuses, 1469, 56.9, 850, 691, 76, 1617
istnichtgut, 1265, 69.4, 449, 402, 35, 886
istvanka, 1655, 83.9, 1654, 438, 101, 2193
Isuckovik, 1249, 78.7, 844, 805, 65, 1714
itajuba, 1390, 42.7, 3305, 3413, 254, 6972
ItalianBoy, 809, 66.3, 16, 72, 2, 90
ITDarkCrypt, 1521, 132.7, 145, 33, 18, 196
Ithilien, 1890, 23.3, 4771, 3911, 398, 9080
ITILT, 1667, 168.2, 281, 203, 26, 510
itsamee, 1261, 100.2, 4159, 4364, 379, 8902
itsapodictic, 1869, 26.3, 1305, 1226, 121, 2652
ItsNotMe, 1360, 235.1, 21, 41, 2, 64
itsnotoveryet, 1652, 21.0, 5358, 8036, 554, 13948
itsthebill, 763, 93.3, 9, 229, 1, 239
itsthebishop, 1529, 38.6, 2240, 2612, 268, 5120
ittogami, 1619, 33.8, 1974, 2172, 376, 4522
Ittram, 1450, 29.1, 610, 365, 66, 1041
ivamoto, 1663, 143.9, 26, 9, 0, 35
ivanivanivan, 1103, 60.8, 45, 85, 5, 135
ivanjob, 1177, 67.2, 629, 599, 43, 1271
Ivantchouklover, 1556, 25.5, 8055, 4976, 558, 13589
Ivanuk, 1457, 39.2, 3592, 3780, 196, 7568
ivanw, 1498, 34.6, 4919, 4936, 593, 10448
iviacava, 1113, 101.0, 90, 121, 6, 217
ivickvv, 1461, 34.2, 1800, 1764, 164, 3728
ivoire, 1478, 54.8, 3062, 2417, 376, 5855
iwantsexyladyz, 783, 69.2, 9, 44, 0, 53
IWantYourQueen, 1493, 57.7, 1567, 2025, 83, 3675
iWidget, 1334, 38.8, 1962, 782, 69, 2813
iwillwinhaha, 791, 83.9, 4, 26, 1, 31
IWinYouLoese, 2009, 113.7, 445, 51, 9, 505
iwtgbtp, 1645, 103.9, 660, 497, 54, 1211
IWW, 1655, 30.7, 444, 596, 45, 1085
iXiao, 1414, 40.5, 1654, 1587, 126, 3367
Izackstern, 1056, 42.3, 35, 66, 3, 104
Izera, 1281, 43.5, 2447, 5279, 251, 7977
izicik, 1747, 75.0, 1793, 2418, 246, 4457
IZinc, 1021, 37.2, 4057, 4685, 293, 9035
Izis, 1135, 30.2, 907, 2184, 64, 3155
izze, 1606, 36.8, 10999, 12657, 1074, 24730
izzey, 1117, 37.0, 10086, 10145, 1107, 21338
IZZZZ, 1362, 59.3, 389, 318, 22, 729
JaackCamel, 1753, 27.3, 4317, 5157, 415, 9889
jaanji, 972, 38.2, 105, 440, 5, 550
jaapvo, 1584, 29.2, 6592, 7396, 896, 14884
jaaugusto, 1458, 37.7, 10352, 3629, 705, 14686
JABAJABA, 872, 122.7, 53, 121, 7, 181
jabara, 1533, 22.0, 5876, 4668, 396, 10940
JabaraM, 1149, 52.3, 86, 162, 17, 265
jabeda, 1289, 28.3, 854, 1415, 84, 2353
jaberer, 1230, 91.1, 300, 219, 15, 534
jabirali, 1291, 39.2, 1201, 1202, 80, 2483
jabONE, 1347, 91.6, 2497, 3027, 399, 5923
JABSF, 1141, 39.8, 1527, 1250, 91, 2868
JaBurdon, 1484, 33.7, 4338, 2021, 282, 6641
jabustyerman, 1233, 33.4, 632, 730, 19, 1381
jacab, 1624, 96.8, 3820, 7096, 1362, 12278
jacartier, 1201, 25.7, 1872, 2627, 210, 4709
Jaceczko, 1234, 40.5, 1121, 888, 89, 2098
jacejerms, 1030, 174.4, 0, 6, 0, 6
JAChessHobbyist, 1290, 77.9, 94, 126, 12, 232
jackalon, 1219, 42.2, 247, 332, 10, 589
JackBlood, 1010, 254.6, 0, 2, 0, 2
jackcrimson, 1467, 33.2, 1637, 1251, 161, 3049
jackdmartin, 1277, 27.6, 1715, 1512, 103, 3330
JackElb, 1230, 78.7, 1027, 1020, 61, 2108
JACKGO, 891, 85.7, 542, 538, 30, 1110
JackGoff, 1726, 24.6, 1748, 1694, 100, 3542
jackhammerjones, 1148, 24.7, 4483, 7032, 239, 11754
JackInBox, 1651, 31.9, 530, 724, 79, 1333
jackla, 1218, 29.7, 5498, 7515, 499, 13512
jacknight, 1395, 104.7, 56, 41, 8, 105
jackoconnor, 639, 119.3, 22, 191, 2, 215
Jackq, 1081, 84.6, 2194, 2858, 119, 5171
jackshrack, 965, 33.3, 229, 314, 16, 559
JackUnet, 1430, 25.0, 2236, 2217, 163, 4616
Jacobious, 759, 94.1, 42, 125, 2, 169
jacobisateddybear, 1202, 87.0, 391, 1617, 24, 2032
JacopoBelbo, 1543, 36.9, 10208, 8166, 1006, 19380
jacoputz, 1819, 45.3, 13575, 13167, 1245, 27987
Jadad, 1116, 40.0, 1195, 2034, 86, 3315
jadaw, 1923, 22.7, 11986, 7707, 1110, 20803
jadro, 1818, 32.6, 3124, 3138, 249, 6511
Jaerr, 954, 139.8, 2, 10, 0, 12
jagawar, 1016, 86.7, 292, 400, 7, 699
Jagga, 1496, 29.6, 6704, 6175, 565, 13444
Jahdragon, 1624, 56.4, 269, 164, 13, 446
JAHKING, 1310, 123.3, 4, 22, 0, 26
jahknight, 1750, 101.6, 1254, 3363, 143, 4760
JahnTeig, 1742, 22.7, 11160, 12298, 1143, 24601
jailhouserock, 1132, 38.3, 3624, 3217, 236, 7077
JaiMan, 1555, 22.3, 23834, 34183, 3096, 61113
jainam, 1570, 112.8, 377, 402, 15, 794
Jainath, 1324, 72.4, 1401, 1722, 77, 3200
jajogluck, 1468, 22.3, 5978, 3785, 392, 10155
jajusaal, 1116, 76.4, 32, 134, 2, 168
Jakc, 1171, 127.6, 81, 74, 5, 160
JakeJames, 1038, 53.5, 126, 418, 10, 554
Jaketure, 801, 77.2, 67, 165, 2, 234
JAKEzz, 1354, 27.1, 9876, 14939, 828, 25643
jakobmankel, 1858, 33.6, 4332, 3911, 404, 8647
jakor, 2070, 27.3, 5101, 6384, 941, 12426
jalbert, 1479, 91.8, 7355, 7725, 1381, 16461
jaleel, 1287, 28.2, 2533, 2206, 185, 4924
JalenBeatty, 1117, 107.4, 10, 19, 0, 29
jaliscience, 1323, 36.8, 287, 328, 20, 635
jambi, 790, 117.1, 20, 105, 0, 125
Jambonneau, 1531, 44.7, 6282, 3585, 737, 10604
jamemu, 1449, 30.3, 2791, 2882, 221, 5894
jamesarro, 1081, 117.4, 28, 72, 2, 102
jamesbar, 1497, 39.3, 526, 328, 24, 878
JamesChiang, 1560, 54.2, 3449, 1668, 183, 5300
jamesfreddy, 1547, 113.1, 567, 412, 43, 1022
jamesma, 1329, 55.7, 197, 204, 12, 413
JamesRing, 1469, 35.9, 3214, 3913, 349, 7476
jamesrmoore, 1536, 39.3, 631, 744, 75, 1450
JamieFunnell, 1392, 84.4, 1141, 922, 98, 2161
jamiepiolin, 1770, 28.9, 6650, 2132, 203, 8985
jammasterlee, 1295, 98.5, 3329, 4097, 228, 7654
Jammes, 1589, 53.5, 5557, 4790, 659, 11006
jamreynolds, 1385, 95.9, 1015, 614, 92, 1721
jamson, 1000, 126.4, 466, 780, 22, 1268
Janbaz, 1402, 68.1, 1513, 2447, 207, 4167
jancha, 1509, 30.7, 5340, 5490, 364, 11194
JanitorJim, 1614, 90.9, 323, 208, 23, 554
jankowce, 1700, 28.2, 14970, 12235, 1286, 28491
JanneKejo, 1517, 27.2, 2882, 1243, 255, 4380
janok, 1494, 25.2, 12651, 11917, 1023, 25591
janovskj, 1469, 22.1, 7284, 5713, 261, 13258
janq, 1330, 102.8, 1263, 1162, 99, 2524
JansAraknidVI, 1163, 184.7, 4, 5, 0, 9
janstefanov, 731, 153.4, 0, 9, 0, 9
jantonacci, 1201, 36.6, 2443, 2878, 236, 5557
januszk, 1191, 131.3, 441, 401, 20, 862
JapaRJ, 1532, 50.7, 1516, 1856, 139, 3511
japatur, 1468, 68.1, 694, 906, 70, 1670
Jaque, 1831, 39.6, 4742, 4722, 501, 9965
Jaqueperpetuo, 1311, 19.2, 3363, 3393, 154, 6910
JaredStarTrek, 1301, 35.7, 736, 471, 55, 1262
JareteH, 1273, 33.0, 428, 611, 57, 1096
jariv, 1171, 42.4, 1273, 1600, 210, 3083
JarrettJames, 922, 100.9, 229, 452, 24, 705
jaruga, 1583, 42.7, 1256, 1136, 112, 2504
jasonbales, 1372, 32.2, 8837, 9179, 678, 18694
jasonbryan, 1624, 29.8, 4205, 3565, 425, 8195
JasonFreelance, 996, 59.7, 317, 348, 19, 684
JasonFrost, 1612, 49.5, 519, 392, 45, 956
JasonKap, 826, 88.4, 62, 148, 3, 213
jasontang, 908, 107.5, 113, 438, 12, 563
jasperino, 964, 100.9, 12, 28, 3, 43
jassch, 1805, 169.3, 16, 2, 0, 18
jasuusknox, 1360, 37.0, 3488, 3597, 330, 7415
JavaKnight, 1628, 30.6, 4549, 1911, 205, 6665
javasox, 1445, 33.6, 3131, 3902, 266, 7299
javazac, 1111, 338.0, 0, 1, 0, 1
javelinos, 1492, 28.8, 17284, 14679, 1728, 33691
javester, 1453, 100.5, 552, 711, 27, 1290
javierlopez, 1327, 28.4, 232, 139, 34, 405
jawadyy, 698, 153.9, 2, 24, 1, 27
Jay, 1770, 24.5, 30133, 19360, 2981, 52474
JayBoogie, 1022, 31.9, 267, 398, 10, 675
jaydadaone, 1497, 114.7, 789, 578, 73, 1440
jayeon, 929, 146.1, 13, 28, 1, 42
jayeshbi, 1146, 32.6, 3482, 3505, 203, 7190
jayfanstone, 1358, 49.1, 2958, 3956, 132, 7046
JayGatsbyTwo, 932, 82.3, 1314, 2133, 70, 3517
jaygrayone, 1336, 29.6, 1554, 707, 65, 2326
Jayhs, 1467, 29.4, 1088, 1640, 93, 2821
jayJAYjayJAY, 1457, 92.3, 244, 203, 14, 461
jaymuhlendorf, 1040, 279.1, 2, 9, 0, 11
Jaynesian, 1937, 28.2, 6879, 2412, 435, 9726
Jaypawn, 927, 125.9, 226, 682, 3, 911
Jayseki, 1235, 44.1, 2529, 3253, 156, 5938
jaysonrickel, 930, 168.3, 1, 12, 2, 15
jazzpianist, 1862, 71.0, 758, 821, 117, 1696
jazzybiker, 895, 61.0, 170, 284, 13, 467
JazzyRick, 1260, 47.4, 2827, 3255, 219, 6301
jbackes, 1428, 40.6, 2667, 3544, 205, 6416
JBaked, 976, 76.6, 108, 127, 11, 246
jbaslon, 1462, 26.4, 6116, 5473, 498, 12087
jbergara, 1306, 69.8, 322, 367, 32, 721
JBFelo, 1842, 104.6, 4605, 2284, 242, 7131
jbilll, 1256, 35.8, 2198, 1603, 178, 3979
jbock, 1226, 172.5, 5, 19, 0, 24
JBShepherd, 1143, 29.4, 2084, 3372, 167, 5623
jbutzu, 1073, 33.1, 187, 409, 8, 604
Jcastle, 1606, 23.5, 44276, 28747, 3022, 76045
jcdl, 1367, 141.7, 119, 95, 31, 245
jcgabi, 1641, 80.3, 5776, 8168, 395, 14339
jcgeujon, 1604, 26.6, 5561, 6225, 589, 12375
jciha, 1176, 65.1, 114, 205, 22, 341
jclanton, 1240, 63.2, 226, 267, 14, 507
jcmcobra, 1380, 27.1, 5641, 9569, 638, 15848
jcmontenegro, 841, 220.2, 0, 5, 0, 5
JCurtisFM, 1985, 98.3, 3093, 1459, 300, 4852
jdejesus, 1201, 40.7, 2154, 2793, 154, 5101
jdek, 1170, 52.8, 399, 744, 45, 1188
jdoggdfl, 1332, 160.3, 54, 89, 5, 148
jdokl, 1275, 28.4, 6557, 5982, 541, 13080
JDPBCP, 1393, 22.1, 12135, 15580, 1324, 29039
JDresch, 1149, 47.7, 2062, 1803, 137, 4002
jdseemoreglass, 1557, 63.4, 3621, 2326, 247, 6194
JDSnake, 1317, 37.0, 3945, 3583, 308, 7836
jdvatty, 1288, 46.2, 1785, 1392, 91, 3268
jdwyn, 1229, 53.8, 1512, 2294, 389, 4195
JeanGiskan, 1495, 31.8, 2404, 1862, 192, 4458
jeaok, 2169, 34.5, 291, 79, 17, 387
jebchesswiz, 1195, 53.2, 104, 220, 12, 336
jebenihendl, 1019, 102.8, 18, 34, 5, 57
jedijulian, 1130, 76.3, 598, 873, 60, 1531
jedlehman, 1146, 81.9, 154, 335, 19, 508
JedTed, 749, 99.6, 77, 268, 3, 348
jedtoo, 949, 43.6, 2671, 5104, 143, 7918
jeeba, 1067, 78.3, 346, 502, 24, 872
jeegrobotdacciaio, 1118, 33.5, 1202, 2410, 116, 3728
JEEPSTER, 1507, 255.1, 13, 13, 5, 31
jeetdragon, 1129, 127.7, 47, 79, 2, 128
JEFEJOMBI, 1225, 34.7, 1687, 1592, 88, 3367
jefferwocky, 748, 73.0, 8, 63, 2, 73
JeffMS, 584, 103.6, 2, 25, 0, 27
Jeffreylam, 1263, 124.9, 60, 47, 7, 114
JeffreyX, 1111, 39.1, 281, 327, 44, 652
jefftxelp, 1312, 31.5, 3560, 5091, 397, 9048
Jefz, 1006, 86.7, 92, 128, 5, 225
jegarcialainez, 1708, 106.8, 295, 262, 35, 592
JEJEJO, 1470, 46.7, 4179, 5446, 294, 9919
jeliazkobrusev, 1638, 36.1, 444, 457, 15, 916
jelito, 1535, 26.5, 8604, 5564, 542, 14710
JelloOz, 996, 126.9, 46, 80, 0, 126
jellybearberlin, 1820, 91.7, 34, 6, 2, 42
JellyRoll, 1703, 37.7, 2328, 1543, 167, 4038
jemerson, 1165, 49.9, 270, 423, 20, 713
jemyezz, 645, 70.0, 4, 81, 1, 86
jenarsan, 2015, 234.3, 369, 248, 31, 648
Jenggo, 1594, 109.1, 133, 88, 14, 235
jenkons, 1568, 36.8, 6143, 3333, 434, 9910
jenmaxius, 1684, 42.7, 875, 1608, 143, 2626
jenme, 1055, 189.4, 126, 90, 5, 221
jensonbutton, 1363, 41.8, 585, 651, 70, 1306
JenSpeed, 2186, 25.1, 24350, 13332, 1500, 39182
Jeopar, 1511, 19.7, 2137, 2016, 102, 4255
JEQABA, 1491, 66.7, 215, 147, 12, 374
Jeralddwilson, 1347, 199.6, 2, 4, 0, 6
JeremiahBlack, 884, 89.9, 19, 37, 1, 57
JerkyKhanh, 1555, 28.9, 6803, 7536, 528, 14867
jermels, 1069, 37.8, 122, 155, 1, 278
jeseo, 1522, 38.1, 3203, 3606, 286, 7095
jesoalm, 1078, 67.8, 234, 692, 41, 967
jesperbb, 1625, 30.1, 5352, 5726, 419, 11497
jesserocks, 1536, 51.0, 95, 72, 8, 175
jesses, 1214, 56.4, 55, 63, 3, 121
jesterinarms, 1141, 71.5, 78, 202, 6, 286
jestrada, 1566, 36.4, 4718, 4694, 461, 9873
jestsahist, 1375, 33.2, 8819, 10938, 973, 20730
Jesuhecr, 1049, 65.4, 75, 106, 13, 194
JesusChesser, 1068, 62.8, 19, 23, 1, 43
jesusisblack, 984, 155.1, 2, 18, 0, 20
jesusramon, 1349, 42.3, 3331, 4450, 312, 8093
Jeterook, 1037, 36.2, 491, 535, 11, 1037
jetix, 1878, 74.8, 2077, 3044, 267, 5388
Jettrider, 1256, 83.9, 80, 99, 11, 190
JeversonM, 1103, 93.8, 481, 578, 23, 1082
jfameys, 703, 88.7, 3, 18, 0, 21
jfhumphrey, 1167, 32.1, 11364, 10899, 531, 22794
Jflowers, 957, 42.8, 356, 1216, 30, 1602
JFMichael, 1051, 74.1, 371, 455, 25, 851
jfnx, 1308, 133.1, 145, 103, 1, 249
jfreewater, 1124, 28.2, 1021, 1348, 51, 2420
jgarces, 1254, 135.8, 179, 199, 10, 388
jgrvm, 1500, 25.9, 6736, 6252, 844, 13832
jhanson, 1236, 114.0, 393, 298, 44, 735
jharbaugh, 966, 44.6, 531, 516, 32, 1079
JHchesser, 1188, 49.3, 612, 642, 40, 1294
JHCraig, 1100, 187.2, 1, 4, 0, 5
jhetchess, 1385, 26.0, 1271, 963, 97, 2331
jhgezrz, 1281, 32.9, 724, 776, 27, 1527
JHicks, 1498, 35.7, 3468, 3931, 265, 7664
JHillis, 1261, 252.0, 2, 2, 0, 4
JHLD, 904, 31.2, 3729, 4421, 273, 8423
jhoel, 1711, 35.6, 4958, 7002, 483, 12443
jholland, 1034, 93.8, 18, 43, 1, 62
JhonXX, 1230, 63.6, 296, 381, 10, 687
JHPWash, 1116, 122.0, 60, 54, 6, 120
jhunzarragosa, 1023, 78.0, 106, 225, 9, 340
jibun, 1360, 46.3, 5006, 5008, 353, 10367
jibwoo, 1465, 30.0, 312, 289, 43, 644
jidetwotime, 1538, 43.0, 7590, 6718, 680, 14988
jigando, 1293, 51.4, 731, 840, 45, 1616
jiggaman, 1916, 106.8, 199, 146, 13, 358
jihadpawn, 1321, 34.8, 2699, 1404, 154, 4257
jikes, 1126, 49.9, 1588, 2128, 97, 3813
jimbothigpen, 1293, 24.2, 2373, 2980, 193, 5546
jimboydy, 2009, 44.4, 7949, 5011, 627, 13587
JimDLCH, 1335, 39.6, 69, 104, 9, 182
jiminnh, 1224, 58.2, 712, 536, 27, 1275
jiminyhcricket, 646, 66.3, 16, 710, 10, 736
jimjamg, 1257, 62.4, 2823, 3994, 366, 7183
jimmis, 1236, 76.3, 763, 828, 46, 1637
jimmybadger, 1661, 49.0, 4681, 3913, 277, 8871
JimmyDaGrunt, 1361, 24.6, 8036, 11923, 963, 20922
jimmykay, 1457, 99.2, 8, 6, 3, 17
jimmysrvng, 738, 66.6, 48, 143, 2, 193
jimmytheg, 1098, 31.4, 4909, 6838, 456, 12203
JimmyTwoFaces, 1312, 30.5, 3180, 2564, 209, 5953
jimsan, 1289, 32.9, 3284, 3864, 378, 7526
jimswarthou, 1164, 142.1, 7, 16, 0, 23
jimyourknightmare, 874, 93.9, 50, 169, 7, 226
jinggoy, 1300, 121.1, 21, 32, 3, 56
Jinjax, 1361, 40.2, 602, 1074, 76, 1752
jippikaijee, 1418, 27.3, 1503, 1023, 122, 2648
Jiracek, 1703, 294.4, 1, 1, 0, 2
jirap, 1342, 34.4, 5232, 5170, 219, 10621
Jirayu, 1359, 45.0, 2728, 2314, 200, 5242
jirikb, 1328, 31.6, 13574, 6739, 893, 21206
Jirovsky, 1521, 51.6, 777, 1053, 78, 1908
jisunjay, 997, 159.1, 2, 4, 0, 6
jitmuh, 1212, 37.0, 248, 334, 15, 597
Jiyann, 1866, 117.8, 396, 589, 43, 1028
JIyHTuK, 1307, 201.2, 3, 3, 0, 6
jJackFlash, 1191, 33.1, 5238, 6641, 310, 12189
jjdoit, 1104, 32.9, 3239, 7908, 205, 11352
JJeeva, 1199, 103.4, 329, 751, 18, 1098
JJHUP, 1719, 31.8, 2678, 2688, 321, 5687
JJJA, 1211, 23.8, 2109, 3046, 310, 5465
jjmichael, 779, 259.4, 0, 2, 0, 2
jjneto, 1958, 55.5, 704, 497, 65, 1266
JJokr, 910, 128.7, 0, 11, 0, 11
jjpregler, 1118, 108.9, 18, 26, 2, 46
jjtimberwood, 968, 86.4, 282, 316, 13, 611
jjwoo, 1306, 119.9, 42, 41, 7, 90
jjzijlstra, 1473, 32.1, 378, 346, 38, 762
jkcarp, 1059, 191.3, 12, 40, 1, 53
jkelws, 1667, 88.3, 1863, 1690, 265, 3818
JKheidegg, 1641, 29.7, 3855, 2078, 280, 6213
jkhjohn, 557, 258.0, 1, 13, 0, 14
JKiller, 1969, 40.7, 1579, 1112, 139, 2830
jkjones, 851, 40.8, 422, 1181, 16, 1619
jkpasanen, 1228, 37.9, 2729, 2396, 178, 5303
jkprabu, 775, 52.7, 13, 85, 1, 99
jkyardgoat, 1109, 118.4, 993, 848, 72, 1913
JLDagenais, 1064, 67.3, 27, 51, 2, 80
JLDRUDRU, 1090, 34.2, 5934, 11811, 436, 18181
jlewer, 905, 168.0, 2, 17, 0, 19
jlgarza, 838, 350.0, 1, 7, 0, 8
JLGimeno, 1033, 88.8, 9, 14, 2, 25
JloClau, 1134, 79.1, 748, 557, 22, 1327
jmacnab, 1602, 108.2, 2306, 2274, 292, 4872
jmag, 1516, 38.2, 1801, 1237, 175, 3213
jmarchetti, 1423, 45.1, 4020, 3393, 373, 7786
JMarsaCZ, 1819, 36.9, 10929, 7096, 1016, 19041
jmass, 1749, 63.6, 10904, 5746, 727, 17377
jmaximel, 1078, 32.8, 136, 163, 9, 308
JMCooper, 1519, 36.7, 96, 104, 2, 202
jmcr, 994, 66.3, 56, 69, 3, 128
jmed, 1196, 107.7, 69, 34, 2, 105
jmfeanor, 1229, 62.7, 42, 58, 6, 106
JMGarcia, 1149, 71.4, 141, 120, 8, 269
jmgk, 1202, 111.0, 447, 510, 28, 985
JMGuerra, 1045, 58.6, 1512, 2590, 180, 4282
jmiphone, 1538, 84.1, 138, 59, 6, 203
jmlagueux, 1306, 47.9, 1717, 2216, 239, 4172
JMLin, 1090, 211.8, 4, 7, 1, 12
jmmarduk, 1273, 113.4, 2591, 1800, 136, 4527
jmmycab, 1001, 92.5, 861, 1351, 66, 2278
jmnovff, 1446, 210.3, 192, 456, 28, 676
jmod, 1140, 53.7, 294, 935, 47, 1276
JMonson, 1605, 20.9, 5549, 4204, 571, 10324
jmooreoo, 1415, 38.6, 774, 1052, 51, 1877
JMorphy, 1221, 37.7, 742, 2092, 35, 2869
jmsfe, 1883, 111.0, 32779, 16943, 1432, 51154
jmveron, 1506, 237.6, 0, 3, 0, 3
Jneazy, 1805, 51.4, 108, 133, 4, 245
jneid, 1046, 33.6, 101, 153, 6, 260
jnilson, 1769, 41.5, 2415, 1293, 352, 4060
jnine, 1037, 43.7, 57, 142, 7, 206
JNowell, 1797, 75.1, 729, 776, 46, 1551
jnugget, 1063, 47.9, 29, 46, 2, 77
jnxlh, 944, 87.5, 13, 17, 2, 32
joarch, 1425, 21.0, 5484, 6012, 425, 11921
Jobby, 1328, 35.2, 2022, 3424, 182, 5628
jobinnthomas, 1083, 164.0, 3, 5, 0, 8
jobtastic, 1216, 92.7, 121, 142, 1, 264
JocokaCM, 1948, 70.7, 4262, 1026, 288, 5576
joddle, 1793, 43.0, 1180, 1163, 207, 2550
jode, 1186, 33.2, 1858, 1908, 178, 3944
jodella, 1124, 55.6, 1111, 643, 30, 1784
Joeans, 1065, 204.8, 1, 4, 0, 5
JoeBanks, 2079, 45.9, 2026, 1284, 108, 3418
JoeCJK, 1480, 40.0, 2844, 1931, 319, 5094
JoeDemir, 1113, 38.2, 435, 637, 24, 1096
joedman, 1318, 25.5, 12343, 8783, 754, 21880
joedt, 927, 50.4, 2522, 2940, 124, 5586
joeg, 1732, 44.0, 6277, 3095, 377, 9749
joehoong, 1563, 77.9, 362, 72, 5, 439
joejox, 1314, 59.3, 1745, 1351, 107, 3203
joelber, 1099, 26.4, 1524, 1744, 158, 3426
JoelH, 1624, 32.6, 4715, 3601, 614, 8930
joeloe, 1212, 26.3, 3495, 6878, 189, 10562
JoelQ, 1412, 25.6, 503, 466, 21, 990
joematt, 1142, 122.5, 32, 32, 1, 65
JoeMcDoug, 1825, 41.6, 3915, 1068, 195, 5178
JoeNash, 1270, 72.0, 4433, 6086, 596, 11115
joene, 1311, 83.9, 2671, 1580, 125, 4376
JoeO, 1372, 34.9, 3795, 3564, 162, 7521
JoeSendra, 985, 140.7, 1, 13, 0, 14
Joeshado, 979, 204.2, 1, 9, 0, 10
joesufjippie, 1551, 76.3, 1043, 1151, 30, 2224
JoeSurveyor, 1526, 106.1, 512, 298, 58, 868
Joetheguy, 1166, 138.4, 36, 20, 2, 58
joevick, 1478, 45.0, 270, 419, 28, 717
JoeWeber, 707, 245.9, 0, 5, 0, 5
Joeworm, 1657, 87.7, 182, 185, 20, 387
Joexc, 848, 133.9, 11, 21, 0, 32
JoeyD, 1315, 42.3, 2207, 2064, 148, 4419
JoeyMohr, 1230, 97.4, 504, 449, 26, 979
joeysantos, 1525, 89.9, 164, 84, 2, 250
johalla, 1451, 92.1, 242, 154, 6, 402
johanenhanlie, 675, 136.7, 1, 14, 0, 15
Johanfo, 1220, 50.0, 95, 180, 9, 284
JohannesKreisler, 1182, 33.7, 2437, 3515, 309, 6261
johanness, 1249, 35.4, 128, 198, 7, 333
johanpnza, 1323, 41.7, 381, 265, 52, 698
JohanSt, 1196, 32.5, 2990, 2513, 257, 5760
Johhn, 1386, 40.4, 2668, 3476, 215, 6359
Johnas, 1282, 26.5, 1109, 1446, 120, 2675
johnboon, 1618, 27.4, 15219, 33534, 4626, 53379
JohnBr, 1225, 28.7, 1361, 1307, 140, 2808
JohnButto, 948, 178.4, 4, 14, 0, 18
johncocktoasten, 1052, 35.1, 269, 189, 14, 472
Johndeconqueroot, 1073, 28.9, 758, 880, 20, 1658
johndepoe, 969, 184.8, 150, 193, 8, 351
JohnHolland, 1276, 27.6, 12599, 19927, 1427, 33953
johnhomerr, 1174, 43.7, 1451, 1595, 82, 3128
JOHNJCAL, 1390, 50.1, 1039, 588, 91, 1718
johnlivelong, 1724, 24.2, 5354, 5583, 511, 11448
johnmar, 1343, 31.5, 1855, 1645, 240, 3740
johnmrrs, 1392, 108.1, 127, 131, 17, 275
johnnieslick, 1293, 68.2, 193, 127, 16, 336
JohnnnyP, 1087, 130.7, 82, 69, 7, 158
johnnpok, 1077, 39.5, 143, 96, 10, 249
johnny, 1299, 64.9, 1965, 2825, 276, 5066
Johnnybr, 1909, 30.2, 1905, 1682, 198, 3785
JohnnyCat, 1591, 106.9, 2357, 1908, 191, 4456
johnnycecil, 1193, 39.8, 1165, 1020, 42, 2227
johnnycool, 819, 34.8, 146, 599, 4, 749
Johnnygomes, 1250, 48.7, 832, 855, 103, 1790
JohnnyStardust, 1417, 105.3, 297, 327, 31, 655
johnnytravis, 816, 115.4, 171, 199, 12, 382
JohnnyV, 1250, 116.0, 1032, 1531, 202, 2765
JohnnyYune, 1349, 45.5, 1915, 1587, 186, 3688
JohnOg, 1250, 95.4, 2523, 3374, 342, 6239
JohnPlayerSpecial, 1135, 336.3, 0, 1, 0, 1
johnqadams, 1128, 125.7, 8, 17, 0, 25
johnwalkerr, 1347, 113.7, 6, 9, 1, 16
JohnWSmith, 1877, 38.6, 2160, 2006, 188, 4354
JohnxMorgan, 1257, 33.6, 589, 660, 28, 1277
JoHodgins, 997, 120.2, 0, 20, 0, 20
JoICeR, 1175, 106.0, 138, 266, 10, 414
JoichiroNishi, 980, 83.6, 196, 385, 16, 597
joiner, 1068, 56.6, 545, 1194, 35, 1774
jointhans, 1315, 46.8, 6018, 5825, 567, 12410
jojac, 1645, 22.4, 12486, 10667, 976, 24129
JOKERESVIX, 1636, 39.0, 340, 196, 10, 546
JoKing, 1552, 27.9, 7340, 16217, 1041, 24598
jokojabo, 1005, 138.3, 19, 39, 2, 60
Jokul, 1356, 81.6, 533, 508, 32, 1073
jolastra, 1458, 48.0, 1425, 1776, 211, 3412
jollygood, 1533, 24.0, 7931, 10675, 548, 19154
jollymon, 974, 104.3, 10, 57, 1, 68
Joltan, 1699, 41.0, 6274, 8277, 787, 15338
jonasfagundes, 1246, 312.1, 944, 1114, 54, 2112
jonasmparker, 1124, 42.5, 846, 1108, 45, 1999
jonathanjetter, 1218, 309.8, 0, 1, 0, 1
jonbois, 1133, 101.0, 219, 276, 17, 512
jonbonjovirc, 2367, 114.5, 23, 6, 4, 33
jonce, 1431, 24.0, 7096, 10533, 906, 18535
JonChisum, 1338, 46.1, 1224, 807, 58, 2089
joneswm, 1470, 147.8, 1224, 1041, 74, 2339
Jonfern, 1483, 23.0, 8052, 4888, 445, 13385
jongalt, 1305, 26.1, 1890, 2455, 203, 4548
Jongers, 1637, 53.9, 523, 310, 33, 866
Jongleur, 1497, 42.8, 3153, 2724, 224, 6101
jonicustaiti, 1034, 65.9, 552, 772, 53, 1377
JonIronmonger, 1281, 28.2, 1572, 1727, 121, 3420
Jonker, 1399, 37.6, 979, 1358, 193, 2530
jonlintott, 1333, 62.5, 15, 17, 1, 33
Jonn, 1846, 38.9, 4938, 5904, 777, 11619
JonnyQuest, 1567, 30.3, 9791, 8492, 778, 19061
jonohelms, 850, 107.2, 400, 805, 35, 1240
JonotheRed, 1419, 25.1, 10977, 9228, 1292, 21497
jonpetur, 1486, 45.5, 589, 567, 27, 1183
jonyfin, 1505, 19.9, 4572, 5177, 441, 10190
joole, 1290, 19.4, 915, 1032, 33, 1980
jooler, 1219, 33.8, 2961, 3333, 235, 6529
Jooncer, 1425, 34.4, 7842, 5434, 425, 13701
jopewiwi, 1647, 25.4, 2828, 2963, 426, 6217
Joposki, 1416, 44.9, 595, 1220, 66, 1881
joranday, 1302, 31.4, 4041, 7460, 396, 11897
jordanandheather, 1226, 110.4, 423, 790, 64, 1277
JordanKwiatek, 1775, 83.5, 1222, 1600, 139, 2961
JordanRieger, 1566, 286.3, 4, 2, 0, 6
jordanwsvegas, 1048, 81.0, 304, 493, 25, 822
jordibc, 1338, 94.3, 897, 613, 39, 1549
jorgemonroy, 1080, 80.1, 2282, 2045, 110, 4437
jorgvicriv, 1693, 25.2, 1192, 1313, 130, 2635
jorisboy, 1261, 26.0, 4110, 4018, 371, 8499
Joroke, 1202, 48.5, 1099, 1830, 77, 3006
jorx, 1442, 36.7, 3529, 2085, 412, 6026
josagugon, 1161, 75.0, 440, 266, 16, 722
JOSAMD, 1415, 63.3, 205, 105, 12, 322
josea, 1511, 54.2, 1637, 1010, 93, 2740
josealfaro, 1712, 85.2, 220, 94, 18, 332
JoseCapablanca, 1148, 103.9, 19, 49, 3, 71
JosefGer, 593, 127.7, 21, 258, 6, 285
Josefnospam, 1115, 115.3, 66, 95, 5, 166
joseluislopez, 1737, 336.1, 2, 0, 0, 2
josemanchm, 937, 111.5, 5, 25, 2, 32
josephandrew, 1360, 34.9, 11668, 3628, 249, 15545
josephasiah, 1319, 69.0, 326, 516, 15, 857
josephjorkens, 1276, 27.4, 4091, 6530, 293, 10914
joshfernandez, 894, 95.1, 237, 490, 10, 737
JoshFerns, 1079, 119.6, 10, 15, 0, 25
joshmachine, 1107, 50.8, 86, 70, 4, 160
JoshuaPark, 1332, 38.6, 541, 541, 47, 1129
JoshuaPearson, 1293, 73.8, 40, 36, 5, 81
JoshuaR, 1339, 47.2, 402, 507, 60, 969
Josleo, 1526, 22.0, 1629, 1840, 95, 3564
josoma, 1227, 124.3, 241, 237, 19, 497
josua, 2300, 121.3, 2907, 2835, 506, 6248
Josue, 1326, 80.3, 2364, 2712, 285, 5361
jotabron, 1163, 34.3, 410, 598, 24, 1032
jouerechecs, 1025, 115.6, 604, 1061, 65, 1730
journeymanac, 1032, 33.0, 304, 496, 15, 815
JoustAnja, 1277, 277.7, 2, 3, 0, 5
joxrox, 1559, 46.1, 674, 654, 61, 1389
Joyus, 1246, 41.6, 2580, 2657, 380, 5617
JozeG, 1663, 25.1, 5056, 4085, 770, 9911
Jpaap, 810, 198.1, 0, 4, 0, 4
jpablo, 1618, 36.8, 7429, 8282, 692, 16403
JPatSoCal, 1159, 36.7, 539, 654, 28, 1221
jpaulson, 1584, 88.3, 151, 137, 16, 304
jpcarmonacarvajal, 1196, 68.9, 225, 174, 6, 405
JPDMA, 1044, 156.7, 150, 178, 8, 336
jpiza, 1293, 82.1, 405, 403, 18, 826
Jpkolind, 884, 253.3, 0, 3, 0, 3
jplamesa, 910, 46.5, 147, 372, 8, 527
jpodz, 946, 83.6, 35, 52, 0, 87
JPtwentytwo, 1122, 44.1, 263, 266, 17, 546
jquarry, 1393, 73.6, 189, 198, 10, 397
jragon, 912, 104.5, 4, 12, 0, 16
jrajaram, 1224, 65.2, 4440, 6223, 228, 10891
JRCapa, 1652, 24.2, 6965, 6098, 614, 13677
jrdnbaade, 1358, 96.7, 1096, 1147, 86, 2329
jrickert, 1022, 60.4, 68, 174, 12, 254
jrjr, 1481, 92.7, 745, 629, 80, 1454
jrkv, 1714, 62.5, 1269, 1408, 159, 2836
jrmchess, 1418, 50.3, 2676, 3040, 149, 5865
jrodriguez, 1452, 30.2, 4719, 3557, 462, 8738
jrrichardson, 1379, 35.3, 1197, 1041, 134, 2372
jrrrrr, 1011, 125.3, 16, 29, 1, 46
jrule, 1030, 136.6, 181, 307, 22, 510
JSBachThePoet, 1511, 67.9, 72, 69, 5, 146
jschach, 1700, 26.8, 13675, 17275, 1947, 32897
Jschmid, 1232, 35.4, 316, 199, 14, 529
jshaftpi, 864, 114.5, 17, 54, 1, 72
JSLEARNING, 1855, 132.3, 4939, 2439, 369, 7747
jsmithy, 1244, 26.4, 587, 655, 34, 1276
jsobo, 1259, 82.2, 353, 371, 19, 743
jsssstplayinn, 1590, 30.8, 7213, 4695, 474, 12382
jstampfli, 738, 44.1, 132, 473, 3, 608
JStan, 1125, 66.2, 36, 46, 3, 85
jstraat, 1871, 28.0, 17836, 10793, 1531, 30160
JSYantiss, 1199, 59.6, 1277, 1284, 100, 2661
jsylam, 857, 52.4, 114, 125, 14, 253
jtags, 1241, 30.9, 510, 464, 45, 1019
jtarkin, 947, 47.2, 633, 498, 36, 1167
jtcfmb, 1663, 22.3, 4641, 2269, 338, 7248
jtchezz, 1618, 33.8, 11372, 12383, 1181, 24936
jthom, 1300, 111.5, 1063, 715, 47, 1825
jthurman, 1214, 39.9, 1251, 1321, 91, 2663
jtravoltas, 1192, 31.8, 1045, 1569, 127, 2741
Juaca, 1002, 106.4, 88, 172, 4, 264
juanbarros, 857, 61.3, 191, 351, 9, 551
JuanH, 1817, 41.8, 281, 184, 26, 491
JuanIgnacio, 1319, 35.2, 336, 427, 38, 801
juanjof, 1440, 36.1, 1077, 868, 76, 2021
juanjperez, 868, 32.6, 118, 508, 8, 634
juany, 1429, 30.5, 8015, 9829, 801, 18645
juarezb, 1329, 117.2, 695, 761, 85, 1541
juari, 938, 105.3, 8, 77, 1, 86
jubeisan, 1422, 27.3, 22578, 17591, 1368, 41537
jubilicious, 1551, 160.4, 58, 31, 9, 98
Jubton, 1564, 97.0, 1877, 1119, 107, 3103
JudasIscariot, 1338, 68.0, 1107, 1423, 92, 2622
jufinski, 1623, 111.0, 977, 680, 56, 1713
Juggernot, 1439, 29.2, 9169, 14650, 549, 24368
jugggz, 1128, 123.7, 0, 10, 1, 11
juhi, 994, 30.1, 852, 728, 11, 1591
juicyjuice, 1114, 76.2, 715, 1063, 72, 1850
jujitsuchess, 955, 39.5, 448, 1316, 28, 1792
jukebox, 1745, 25.5, 6238, 8352, 1224, 15814
jukey, 1074, 52.2, 408, 716, 42, 1166
julbra, 1350, 99.6, 610, 510, 46, 1166
julianandy, 1869, 305.4, 1, 1, 0, 2
JulianoFaria, 1540, 75.9, 2374, 1685, 139, 4198
julianperconti, 888, 74.6, 61, 164, 8, 233
JuLIOgreen, 1021, 81.4, 121, 146, 2, 269
juliokroes, 1588, 35.7, 1772, 1956, 264, 3992
julou, 1140, 70.1, 693, 997, 68, 1758
Jumaji, 1120, 37.8, 484, 584, 27, 1095
jumpforjoy, 1156, 145.6, 209, 307, 4, 520
Jumpman, 1520, 26.0, 11896, 9070, 1102, 22068
junbagsik, 1669, 48.3, 808, 1154, 68, 2030
Junebucket, 1295, 36.2, 1332, 1560, 142, 3034
JuneSoWavy, 864, 131.7, 42, 143, 1, 186
jungla, 1294, 50.2, 1363, 1725, 158, 3246
junglee, 1218, 49.1, 43, 102, 3, 148
JungleWoman, 1164, 137.1, 31, 25, 1, 57
JunHong, 1488, 125.1, 790, 491, 58, 1339
JUPITTER, 1499, 116.4, 400, 299, 37, 736
Jurasu, 1405, 44.6, 578, 457, 41, 1076
Jurjevich, 1027, 58.7, 154, 243, 14, 411
jusgolf, 1189, 73.4, 559, 522, 24, 1105
juspic, 1644, 113.8, 335, 212, 38, 585
JustANewPlayer, 1500, 64.7, 215, 288, 27, 530
Justanotherpatzer, 1702, 25.9, 12702, 7213, 451, 20366
Justattack, 1459, 37.0, 282, 284, 27, 593
JustChessPlayer, 1794, 33.5, 17489, 5558, 890, 23937
justdoitcy, 991, 74.6, 306, 378, 28, 712
justforfunnn, 1505, 26.1, 157, 120, 10, 287
justfriend, 1386, 30.2, 1138, 1077, 92, 2307
JustinATX, 929, 79.9, 8, 24, 2, 34
justinb, 1808, 64.0, 2101, 1619, 163, 3883
JustinBarr, 1352, 40.4, 960, 1591, 108, 2659
justincaze, 1183, 110.4, 39, 59, 2, 100
JustinPerth, 1339, 85.5, 291, 362, 73, 726
JustJune, 1107, 32.6, 2207, 3950, 92, 6249
Justmegeo, 1098, 195.6, 2, 3, 0, 5
JustMicgo, 1281, 27.4, 6663, 6023, 781, 13467
JustPlayingAround, 1137, 59.6, 1527, 2106, 122, 3755
JustResign, 1355, 32.8, 1679, 1077, 83, 2839
justrighteddie, 1051, 39.8, 66, 104, 1, 171
justsayshmur, 1086, 120.6, 241, 241, 36, 518
justsojazz, 909, 46.4, 687, 828, 54, 1569
jvaldezm, 1349, 127.0, 715, 801, 44, 1560
jvisser, 1526, 109.1, 245, 294, 16, 555
jvonhelf, 1276, 47.2, 409, 696, 60, 1165
JWaceking, 1572, 245.7, 116, 109, 7, 232
jwbuda, 1076, 34.5, 784, 562, 58, 1404
jwgoes, 1599, 28.1, 6966, 4770, 481, 12217
JwilliamB, 778, 117.4, 4, 12, 0, 16
Jwoyak, 1203, 101.2, 164, 119, 16, 299
jyacp, 1607, 95.9, 3321, 2941, 369, 6631
JYDNemesis, 966, 207.0, 18, 67, 0, 85
Jyg, 1808, 27.4, 621, 515, 113, 1249
JyrkiSuhonen, 846, 116.2, 5, 51, 0, 56
JYuen, 1379, 42.8, 8407, 8431, 711, 17549
jywhe, 1116, 32.0, 1002, 1531, 52, 2585
jzcbzt, 972, 64.9, 22, 63, 1, 86
JZHouse, 1350, 207.4, 503, 498, 34, 1035
jzjames, 652, 123.6, 1, 46, 0, 47
jzoef, 1559, 35.3, 2750, 2572, 240, 5562
kaater, 1361, 42.7, 3949, 3853, 263, 8065
kabbal, 1540, 53.6, 4024, 3279, 344, 7647
kabdriver, 914, 82.3, 3, 25, 1, 29
Kabmaforlife, 1285, 85.1, 36, 67, 4, 107
KabutoGZ, 1291, 31.5, 153, 162, 10, 325
Kaczmar, 1123, 29.9, 4398, 6315, 585, 11298
Kadim, 1374, 41.1, 5996, 7955, 729, 14680
kaestamos, 1362, 26.3, 4143, 2520, 224, 6887
Kaezon, 1520, 58.2, 462, 423, 52, 937
Kafta, 1272, 40.7, 4182, 5046, 221, 9449
kahbod, 1183, 46.3, 167, 182, 25, 374
kaho, 1526, 26.1, 12665, 12114, 747, 25526
KaiKai, 1739, 50.7, 18772, 7936, 1268, 27976
kailashraj, 1182, 67.7, 113, 326, 6, 445
KaiserBowl, 1283, 57.8, 2044, 2083, 179, 4306
Kaisersoeze, 1624, 28.3, 3284, 2142, 132, 5558
Kaitlin, 964, 37.2, 706, 3775, 77, 4558
Kaituri, 2193, 135.4, 2940, 1644, 286, 4870
Kajameski, 1481, 29.5, 897, 653, 74, 1624
kajani, 1560, 28.5, 15881, 16646, 1093, 33620
Kajuga, 1505, 45.6, 2031, 1703, 134, 3868
kakawi, 1632, 63.3, 1882, 2655, 156, 4693
Kalaharie, 1154, 45.1, 5633, 6318, 555, 12506
kalaps, 1024, 107.7, 10, 25, 0, 35
Kalbar, 1296, 114.7, 4, 54, 1, 59
kalbuneh, 1459, 24.2, 9638, 11164, 590, 21392
KaleKBP, 1479, 41.5, 218, 281, 12, 511
Kalemegdan, 1579, 32.4, 3573, 4020, 497, 8090
Kalenski, 1447, 44.4, 1325, 590, 94, 2009
kalinga, 2193, 127.8, 136, 22, 3, 161
kaliyug, 1521, 84.8, 9774, 4633, 509, 14916
kalmadis, 1569, 92.9, 237, 205, 35, 477
Kalogorg, 1332, 24.8, 2225, 2738, 84, 5047
Kalubatti, 994, 142.3, 3, 255, 1, 259
kalumuangiandre, 1953, 25.7, 3097, 7460, 699, 11256
kalvia, 1229, 36.9, 1278, 1948, 68, 3294
kamakaziKidd, 1373, 29.6, 2592, 4345, 65, 7002
KAMAKSHI, 872, 198.1, 1, 15, 0, 16
Kamallieur, 1357, 55.0, 2062, 2537, 154, 4753
kamares, 1103, 55.3, 129, 281, 7, 417
kamikazeo, 1726, 106.3, 69, 116, 5, 190
kamilia, 1025, 35.1, 1863, 2911, 237, 5011
kanabis, 1215, 235.4, 1, 2, 0, 3
Kaname, 1367, 64.1, 133, 143, 8, 284
KANDESA, 1224, 30.7, 665, 1168, 59, 1892
KandinSki, 1542, 73.3, 1386, 1538, 115, 3039
kandula, 1439, 43.2, 333, 606, 29, 968
KanibalyxiuzDri, 1669, 41.7, 1885, 1916, 340, 4141
kanncaro, 1811, 31.0, 652, 656, 66, 1374
kanz, 1688, 42.2, 4258, 4060, 315, 8633
Kaonyx, 1201, 43.6, 1189, 2182, 93, 3464
kapnobing, 1562, 54.3, 4466, 6194, 568, 11228
kapybr, 1525, 76.9, 202, 188, 23, 413
karadepau, 1643, 41.2, 1785, 849, 163, 2797
Karaikal, 1879, 89.7, 376, 222, 16, 614
Karas, 1328, 123.0, 4998, 5466, 400, 10864
karavalai, 1120, 31.0, 3244, 3948, 193, 7385
Kareemiel, 1346, 44.5, 481, 421, 43, 945
KarelusMaximuz, 1972, 156.5, 8, 9, 0, 17
karenkh, 1281, 45.5, 1616, 1212, 103, 2931
Karic, 1603, 21.5, 9749, 11023, 1600, 22372
karlbarth, 1162, 105.1, 179, 225, 17, 421
KarlMarx, 1505, 25.5, 6682, 2379, 300, 9361
Karlosxdios, 1729, 76.8, 101, 162, 17, 280
karmaa, 1391, 39.3, 2267, 2833, 131, 5231
karmudin, 680, 133.4, 1, 22, 1, 24
karnik, 1373, 26.9, 1033, 842, 49, 1924
Karnut, 1301, 37.4, 278, 527, 20, 825
karolinka, 1077, 26.2, 860, 786, 92, 1738
karplov, 1606, 30.0, 2398, 4124, 499, 7021
karpoff, 1744, 26.2, 20207, 11157, 1230, 32594
KarthickSundaram, 1132, 39.5, 585, 859, 67, 1511
karthikg, 1547, 195.3, 1265, 1417, 107, 2789
kartoffelsuppe, 1546, 39.4, 2850, 2733, 139, 5722
karturb, 996, 135.7, 10, 18, 0, 28
karyoni, 1954, 111.2, 395, 366, 32, 793
karzan, 1773, 33.8, 4177, 5695, 778, 10650
kasak, 1607, 36.0, 7472, 7321, 999, 15792
Kaseldop, 1155, 39.4, 1415, 1228, 138, 2781
Kasepakkuda, 827, 137.2, 3, 10, 0, 13
Kaseygarcia, 765, 141.6, 5, 40, 0, 45
kasfisch, 1404, 100.6, 329, 891, 38, 1258
kashhh, 877, 66.6, 47, 104, 2, 153
kashmar, 815, 174.4, 1, 20, 0, 21
KashUnlimited, 1194, 124.2, 1131, 1684, 104, 2919
kashwan, 1720, 25.8, 2645, 1686, 217, 4548
kasije, 1538, 63.5, 818, 879, 96, 1793
kaspabranca, 1148, 106.1, 546, 776, 27, 1349
KasparovsDog, 1271, 22.2, 8082, 7999, 250, 16331
kasparovzbest, 1566, 143.9, 16, 22, 1, 39
Kasparovzilla, 1599, 56.8, 1392, 1357, 152, 2901
kasperyan, 1501, 57.1, 53, 94, 6, 153
katdog, 1508, 43.1, 2452, 1294, 72, 3818
katem, 1109, 80.2, 486, 681, 32, 1199
Kathago, 1611, 91.3, 4001, 2397, 267, 6665
kathmanuel, 1734, 24.0, 2737, 5030, 267, 8034
katipunan, 1065, 57.3, 123, 408, 13, 544
katyad, 1536, 37.7, 808, 746, 58, 1612
KatyPerry, 1314, 208.1, 1, 3, 0, 4
katzenjammer, 1128, 38.1, 1290, 2019, 197, 3506
kaucintaku, 1611, 125.7, 7, 13, 0, 20
kaun, 1377, 97.4, 1176, 1934, 175, 3285
kaushalSuvarna, 1647, 198.6, 3, 2, 0, 5
KawiRider, 915, 37.9, 435, 686, 18, 1139
KayKatz, 1374, 27.1, 9275, 14704, 1175, 25154
kayumi, 1852, 26.7, 4589, 2189, 278, 7056
KayzeJ, 1044, 349.3, 0, 1, 0, 1
kaze, 1441, 61.1, 7991, 8148, 698, 16837
kbourne, 1102, 22.4, 36327, 22029, 1759, 60115
kbsvarni, 1336, 27.2, 2224, 2635, 71, 4930
kcesq, 1360, 25.6, 195, 192, 11, 398
kcfan, 1146, 192.2, 2, 3, 0, 5
kclemens, 1341, 38.9, 1425, 1922, 212, 3559
KCOLD, 1033, 35.3, 359, 1017, 16, 1392
KDani, 1487, 104.2, 90, 68, 6, 164
KedarDesai, 1337, 26.1, 15313, 10087, 930, 26330
kedduff, 1379, 93.0, 18, 31, 3, 52
kedzior, 1603, 226.8, 15, 7, 1, 23
KeefKaleger, 996, 60.1, 192, 241, 8, 441
keegankris, 1634, 92.6, 78, 140, 10, 228
keelanmiller, 790, 119.6, 2, 11, 0, 13
keenben, 855, 107.2, 5, 17, 0, 22
keepyourline, 1035, 103.7, 22, 44, 2, 68
Keesie, 1615, 33.8, 5102, 4328, 511, 9941
Keientrekker, 1632, 28.9, 8793, 5281, 1203, 15277
KeithChess, 1618, 55.6, 4009, 2689, 233, 6931
keksas, 1463, 28.5, 3252, 3480, 266, 6998
kelbs, 1038, 74.6, 153, 181, 2, 336
kelby, 1500, 26.7, 4437, 2671, 697, 7805
Kelio, 1738, 33.4, 2914, 2197, 148, 5259
kellner, 913, 112.1, 357, 721, 11, 1089
kellog, 1061, 73.0, 1023, 1915, 94, 3032
kellonius, 1488, 82.7, 1108, 824, 93, 2025
kellymath, 1104, 37.0, 3124, 4005, 283, 7412
kellyzeye, 1058, 45.5, 1455, 2623, 112, 4190
kelmiskis, 1429, 231.0, 1, 2, 0, 3
kelseymw, 835, 169.5, 33, 92, 3, 128
kelz, 938, 66.7, 73, 145, 2, 220
KEMPSEYBOY, 797, 46.6, 347, 691, 12, 1050
keneth, 1622, 85.0, 7, 32, 1, 40
Kenhos, 861, 203.6, 0, 11, 0, 11
kenm, 1632, 25.7, 13045, 15897, 1376, 30318
KennethWillcocks, 1362, 38.9, 905, 767, 38, 1710
kennos, 1153, 39.7, 708, 1499, 51, 2258
kennyforchessnet, 1666, 116.2, 27, 11, 1, 39
kennyjeffrey, 1242, 108.9, 6, 12, 1, 19
KennyRide, 1148, 128.0, 497, 707, 38, 1242
KennySmyslov, 1754, 31.3, 411, 279, 42, 732
kenom, 1263, 35.2, 1440, 1889, 122, 3451
Kenouille, 1144, 94.6, 368, 604, 30, 1002
kenro, 1395, 43.5, 1766, 1185, 168, 3119
KentAndersson, 1158, 38.5, 3999, 3637, 575, 8211
KenyaMel, 1391, 66.8, 2069, 2048, 368, 4485
keracim, 1432, 60.8, 1350, 874, 76, 2300
keremyunus, 1618, 60.7, 2603, 1649, 216, 4468
Keresch, 1277, 69.5, 131, 235, 13, 379
Keresfighter, 1794, 30.5, 620, 719, 84, 1423
keresmatic, 1651, 26.7, 6773, 6133, 656, 13562
kerimga, 1787, 109.0, 12842, 8423, 1252, 22517
KEROI, 1169, 73.1, 3118, 6165, 360, 9643
kerpa, 1304, 37.6, 6739, 5553, 605, 12897
Kertez, 962, 257.6, 0, 5, 0, 5
kerts, 1381, 28.3, 4390, 4269, 205, 8864
keshavp, 1188, 68.1, 45, 60, 1, 106
Kesselya, 878, 117.4, 40, 52, 0, 92
Kesten, 1243, 38.2, 784, 728, 58, 1570
kestlere, 1261, 52.7, 742, 607, 93, 1442
Ketan, 1480, 45.1, 2774, 3468, 267, 6509
kevinchess, 1110, 54.6, 639, 984, 29, 1652
kevinjohnson, 1162, 83.8, 191, 210, 10, 411
kevinkevinkevin, 1029, 49.8, 80, 87, 3, 170
KevinLaung, 906, 148.0, 192, 683, 8, 883
kevinsmithstudio, 1322, 42.4, 446, 400, 52, 898
kevinsware, 1228, 34.5, 1650, 1637, 183, 3470
KevinTREvans, 801, 258.4, 0, 3, 0, 3
kevvy, 1435, 30.6, 12942, 16618, 1101, 30661
Keyan, 1270, 38.3, 1813, 1627, 94, 3534
KeyboardCat, 1428, 46.3, 53, 70, 14, 137
keychain, 1247, 230.7, 1, 2, 0, 3
kezientz, 1163, 41.3, 910, 804, 41, 1755
KFleming, 1725, 65.0, 95, 29, 5, 129
kfollstad, 1206, 62.3, 319, 314, 8, 641
Kgambito, 924, 190.3, 0, 4, 0, 4
kgbKILLER, 1062, 245.4, 1, 2, 0, 3
kgreenman, 1066, 97.4, 41, 65, 3, 109
khadijahchess, 957, 103.1, 22, 42, 1, 65
khairuddin, 933, 54.9, 15, 112, 0, 127
khakurel, 1153, 33.0, 3437, 3319, 217, 6973
khangkarot, 1487, 74.5, 285, 340, 24, 649
khans, 1378, 28.7, 792, 386, 66, 1244
kheladoo, 1478, 33.1, 2422, 2162, 255, 4839
khemosabi, 1108, 28.0, 1053, 1585, 44, 2682
KhNazreMowla, 1718, 73.3, 1503, 1462, 223, 3188
kholthaus, 1289, 34.4, 4851, 2982, 394, 8227
KhristoCheck, 1677, 23.9, 6471, 10925, 481, 17877
khs, 1621, 70.6, 4045, 3740, 555, 8340
khuizen, 1251, 32.3, 5002, 3333, 482, 8817
khun, 1455, 86.7, 7043, 9694, 507, 17244
khv, 1503, 95.0, 6, 10, 0, 16
Kiabou, 1508, 38.1, 287, 700, 44, 1031
kiaman, 1558, 23.9, 5192, 5000, 501, 10693
Kianto, 1446, 37.6, 7153, 6265, 656, 14074
KIAUA, 1283, 28.8, 4635, 6860, 366, 11861
kibounohikari, 1434, 78.9, 1038, 1257, 52, 2347
kicki, 1391, 25.7, 3143, 2927, 274, 6344
KickingRooster, 1413, 48.1, 22318, 24437, 1969, 48724
kiddaan, 1007, 181.6, 12, 54, 2, 68
KidKibbitz, 1599, 70.3, 7374, 4752, 699, 12825
KidOcculus, 1437, 96.3, 685, 949, 63, 1697
kihnutus, 1274, 77.7, 70, 139, 15, 224
KiingDavid, 786, 68.1, 17, 43, 1, 61
kijuh, 1370, 25.8, 7453, 5250, 313, 13016
kiknit, 1121, 23.8, 2094, 2896, 131, 5121
killerTcell, 960, 63.8, 287, 739, 32, 1058
killerxxx, 1232, 216.9, 3, 2, 1, 6
killhatz, 1907, 72.4, 3197, 1267, 175, 4639
killhorsebite, 884, 99.0, 85, 278, 4, 367
killinghero, 1093, 84.2, 7, 17, 0, 24
killmer, 1256, 32.1, 6920, 9887, 169, 16976
Kiloz, 1143, 64.2, 2021, 2726, 186, 4933
Kimberlite, 1005, 58.2, 96, 484, 15, 595
KIMLON, 1456, 89.1, 616, 619, 59, 1294
kimmurata, 1147, 88.1, 416, 545, 17, 978
KimN, 993, 133.6, 331, 444, 23, 798
Kimorott, 850, 116.2, 3, 15, 0, 18
kimotikons, 1734, 76.9, 136, 51, 11, 198
Kimowitsch, 1855, 40.0, 1646, 293, 56, 1995
kinchknifeblade, 1215, 53.3, 389, 472, 35, 896
Kindred, 1618, 48.5, 979, 458, 79, 1516
KingAleksiejew, 1285, 58.7, 156, 280, 38, 474
KingChecker, 1384, 122.0, 1937, 2854, 160, 4951
KingCrud, 1494, 30.1, 26691, 26066, 1886, 54643
KINGDAMN, 1076, 89.0, 531, 627, 24, 1182
KingDbag, 977, 103.8, 614, 1172, 35, 1821
kingdestroyer, 1931, 168.7, 165, 69, 11, 245
kingfisherman, 1037, 43.3, 424, 682, 40, 1146
KingForward, 1243, 41.4, 904, 1450, 36, 2390
Kinggg, 1433, 28.6, 2447, 2737, 158, 5342
KingGrab, 1703, 94.3, 1420, 640, 62, 2122
kinghh, 1326, 61.2, 2328, 3043, 161, 5532
KingIsDown, 1438, 50.3, 175, 116, 2, 293
KingJDawg, 1163, 115.5, 853, 1190, 77, 2120
Kingkai, 1109, 83.3, 109, 184, 15, 308
kingkong, 1573, 30.2, 11021, 11312, 878, 23211
kinglucas, 1272, 73.8, 649, 516, 21, 1186
KingMater, 1435, 95.9, 1005, 885, 55, 1945
kingMators, 1654, 85.1, 115, 119, 8, 242
KingMauler, 1285, 25.9, 2371, 3638, 171, 6180
KINGMEE, 1625, 23.4, 6494, 8293, 677, 15464
KingMiha, 1001, 64.7, 182, 260, 21, 463
KiNGMONiR, 878, 78.7, 9, 27, 0, 36
kingmorf, 1315, 37.0, 637, 1280, 73, 1990
kingMORONI, 976, 51.9, 420, 543, 51, 1014
Kingmufasa, 978, 185.1, 0, 9, 1, 10
kingmundi, 1782, 31.4, 13566, 8046, 1025, 22637
KingObamaWorld, 853, 115.4, 32, 164, 2, 198
kingobling, 1536, 49.7, 1024, 620, 69, 1713
kingoffools, 1239, 33.4, 6685, 4407, 482, 11574
KingOfTheSouth, 1911, 133.3, 886, 525, 84, 1495
KingPawned, 1107, 107.0, 7, 13, 1, 21
kingpawnplayer, 1555, 147.8, 99, 45, 11, 155
kingponta, 1427, 103.9, 47, 38, 4, 89
kingpr, 1558, 21.6, 7565, 6766, 809, 15140
kingprakash, 849, 53.7, 43, 193, 0, 236
KingPruts, 1648, 48.4, 11190, 7092, 1079, 19361
kingreign, 1403, 25.7, 3813, 7247, 309, 11369
KingsandKnights, 899, 90.8, 6, 107, 2, 115
kingsatch, 1223, 81.4, 591, 600, 68, 1259
KingsBloodFour, 1317, 55.9, 397, 380, 27, 804
KINGSERVER, 1066, 26.9, 2377, 4223, 235, 6835
kingsf, 1504, 73.1, 854, 516, 65, 1435
kingsford, 1183, 143.2, 57, 62, 7, 126
kingshredder, 1282, 114.4, 142, 206, 16, 364
KingsIndianWins, 1706, 24.1, 6142, 6600, 950, 13692
Kingsknights, 1768, 25.6, 9353, 6186, 869, 16408
kingstanley, 1084, 33.1, 4952, 7068, 440, 12460
kingsung, 1767, 50.6, 5129, 5778, 647, 11554
kingtower, 1501, 27.4, 1092, 1384, 44, 2520
kingtutt, 1317, 95.9, 1660, 2106, 186, 3952
kingzamunda, 1569, 94.6, 2831, 2322, 207, 5360
KingzKill, 766, 93.5, 89, 808, 0, 897
Kints, 1593, 81.4, 183, 92, 11, 286
KipChess, 1394, 22.2, 1598, 1335, 135, 3068
Kiponator, 1241, 129.2, 4, 8, 1, 13
Kiranam, 1233, 274.2, 0, 2, 0, 2
kirankn, 1284, 66.3, 990, 1070, 89, 2149
KIRANsunil, 957, 50.2, 25, 107, 3, 135
kirikou, 1468, 47.1, 7649, 5389, 500, 13538
kirkland, 1362, 58.0, 655, 726, 70, 1451
Kirktcb, 860, 126.6, 32, 78, 5, 115
Kisch, 851, 176.5, 1, 8, 1, 10
kisooo, 1194, 70.0, 307, 408, 18, 733
KisRoman, 1205, 30.6, 445, 955, 25, 1425
kissanya, 1309, 124.9, 4300, 4320, 301, 8921
Kissifrott, 1136, 41.1, 983, 581, 52, 1616
kitangkita, 1499, 39.8, 452, 549, 66, 1067
kittuchess, 1159, 56.7, 874, 1088, 72, 2034
kiver, 1483, 98.9, 45, 20, 1, 66
KiwiBond, 1436, 36.2, 2571, 2626, 200, 5397
kiwiMark, 1177, 39.2, 550, 780, 43, 1373
kiwipower, 1056, 211.9, 2, 6, 1, 9
kjacks, 1316, 103.7, 19, 14, 0, 33
kjcali, 1033, 51.7, 176, 420, 23, 619
KjellRS, 1241, 215.0, 25, 34, 1, 60
kjhamster, 1755, 25.5, 1878, 2022, 169, 4069
KJO, 2054, 39.8, 892, 797, 142, 1831
kjyun, 753, 79.6, 82, 882, 9, 973
kkakdkk, 1798, 23.5, 9805, 9462, 1558, 20825
kkangsv, 1257, 130.3, 153, 164, 9, 326
kkdhiman, 1331, 52.5, 337, 357, 33, 727
kkotnana, 1589, 110.1, 5, 12, 0, 17
kkour, 1517, 213.1, 4, 3, 1, 8
kkpsA, 1098, 62.7, 2267, 3975, 245, 6487
klaika, 1683, 134.6, 298, 202, 21, 521
Klango, 1146, 58.6, 274, 640, 35, 949
klausfuenfvier, 1197, 61.4, 677, 647, 21, 1345
KlausTrophobie, 952, 38.2, 375, 430, 34, 839
Kleinflo, 994, 64.6, 2431, 2689, 205, 5325
KLEINMEISTER, 1428, 21.8, 5773, 8357, 1062, 15192
kleinphi, 1269, 72.5, 1061, 666, 90, 1817
klessius, 901, 138.3, 3, 14, 0, 17
klevdav, 1311, 29.3, 3845, 5338, 203, 9386
KLewin, 1077, 113.1, 191, 247, 16, 454
klhrevolution, 1007, 192.0, 86, 130, 7, 223
klingelhoefer, 1082, 46.1, 135, 152, 13, 300
klinxit, 1164, 34.5, 1785, 2251, 79, 4115
kluebirby, 1175, 69.4, 381, 490, 33, 904
Klumpatsche, 1072, 52.0, 113, 130, 7, 250
klwe, 1313, 20.8, 11788, 16231, 928, 28947
KMarx, 1461, 65.2, 1282, 759, 123, 2164
KMMK, 980, 144.0, 9, 53, 2, 64
kmogli, 1475, 41.3, 256, 167, 14, 437
kmonro, 1433, 21.8, 5374, 4706, 345, 10425
KMONTE, 1320, 48.4, 1723, 3396, 202, 5321
kMorrison, 1746, 56.2, 895, 178, 62, 1135
knaaky, 1370, 27.8, 1877, 1372, 90, 3339
knaughtyknights, 1769, 130.2, 2021, 2235, 141, 4397
knaugle, 1605, 24.7, 1646, 1373, 173, 3192
Knet, 1633, 33.2, 8398, 3657, 485, 12540
Knightbane, 1254, 38.6, 322, 268, 28, 618
KnightBiker, 1421, 21.9, 16240, 14952, 1458, 32650
KnightBlight, 1183, 185.5, 3, 7, 0, 10
KnightCrawl, 936, 100.1, 179, 417, 13, 609
knightdancer, 1473, 29.3, 2182, 2332, 322, 4836
Knighteutonic, 1282, 51.8, 173, 185, 11, 369
knightfrederick, 1475, 29.4, 5500, 3921, 490, 9911
knightkingrook, 1293, 38.6, 281, 369, 15, 665
knightleader, 1394, 28.9, 2674, 2788, 267, 5729
KnightLyte, 1817, 79.4, 108, 106, 14, 228
knightmareblitz, 1300, 27.6, 4616, 5506, 571, 10693
Knightmarez, 1272, 63.1, 632, 622, 37, 1291
knightmassey, 1514, 40.1, 3336, 2606, 380, 6322
KnightMaster, 1517, 24.8, 1650, 1501, 144, 3295
Knightmaximus, 1105, 44.4, 188, 586, 4, 778
Knightmike, 1293, 111.7, 551, 358, 58, 967
KnightNee, 738, 99.1, 22, 140, 3, 165
KnightofGod, 1121, 49.7, 1853, 2820, 96, 4769
Knightpro, 1386, 31.7, 5514, 4933, 495, 10942
Knightpusher, 1341, 41.8, 1014, 489, 68, 1571
Knightrook, 1117, 89.4, 595, 749, 69, 1413
KnightRoyal, 1077, 67.0, 262, 512, 16, 790
KnightSchool, 1430, 88.8, 578, 590, 38, 1206
knightsInArms, 1386, 155.0, 2, 6, 0, 8
KnightsPassage, 1309, 49.1, 388, 478, 17, 883
KnightSquares, 1623, 107.9, 469, 285, 39, 793
knightstooge, 1487, 19.8, 10720, 7283, 1150, 19153
KnightToRookSix, 941, 35.6, 2800, 4979, 154, 7933
knightvision, 1591, 33.7, 5674, 6560, 396, 12630
kniper, 1535, 36.8, 4092, 3579, 258, 7929
knkhan, 1498, 33.1, 475, 717, 35, 1227
KnockOutNed, 795, 96.5, 9, 63, 0, 72
KnoKautt, 1135, 89.4, 7, 15, 0, 22
Knotsogood, 1006, 148.3, 6, 15, 3, 24
Knownsense, 1126, 71.9, 577, 711, 34, 1322
KnowOnesPawn, 1483, 128.9, 9323, 8671, 796, 18790
KnowUh, 743, 109.4, 4, 35, 0, 39
knoxl, 774, 81.6, 19, 90, 2, 111
knoxville, 1424, 37.8, 3877, 4381, 546, 8804
knubbel, 1466, 21.8, 4259, 3563, 391, 8213
knusoli, 1435, 109.3, 624, 559, 48, 1231
Knutijs, 1079, 54.7, 49, 45, 2, 96
knuto, 1464, 55.8, 213, 196, 20, 429
knutselaar, 1142, 39.2, 4769, 8056, 325, 13150
koach, 1786, 66.1, 858, 918, 117, 1893
KoalaFace, 1434, 85.9, 2138, 2048, 128, 4314
Kobac, 1660, 137.2, 2818, 1247, 157, 4222
kobushlevi, 1175, 51.9, 418, 743, 32, 1193
kocur, 1328, 323.4, 1, 1, 0, 2
kod, 1765, 34.5, 8261, 4197, 336, 12794
kodewolf, 1000, 53.5, 433, 664, 22, 1119
koenelton, 1552, 45.5, 755, 1176, 71, 2002
Koff, 1871, 72.1, 14375, 10270, 1531, 26176
kogoro, 1481, 38.6, 1348, 2020, 150, 3518
KOKANEE, 859, 182.0, 7, 36, 1, 44
kokchetav, 1118, 34.3, 1087, 2031, 58, 3176
kokoiski, 1730, 38.3, 1071, 1074, 94, 2239
kolambiru, 802, 232.8, 0, 7, 0, 7
koldmember, 1183, 104.7, 90, 46, 3, 139
Koll, 1001, 36.7, 443, 1155, 60, 1658
KOLOMYTCHENKO, 1547, 29.7, 697, 492, 118, 1307
kolslo, 1147, 38.2, 1085, 1167, 82, 2334
kommikiller, 810, 157.0, 0, 28, 0, 28
komyt, 1452, 91.3, 1091, 1300, 86, 2477
Konepelaaja, 1695, 46.8, 97, 105, 8, 210
kongoman, 1915, 20.6, 18383, 13834, 2187, 34404
Konigsberg, 1248, 36.8, 3047, 2088, 110, 5245
konijn, 1796, 29.0, 7390, 9432, 1864, 18686
koningsgambiet, 1635, 24.0, 9269, 14365, 1305, 24939
Koningsloper, 1602, 23.1, 18845, 21735, 1153, 41733
konkeydong, 1330, 271.8, 1, 2, 0, 3
koolpapa, 1760, 41.8, 7013, 5875, 933, 13821
Koordinator, 1382, 59.6, 2021, 1288, 75, 3384
koosgrandioos, 1856, 65.7, 2704, 4735, 468, 7907
kopikas, 1185, 81.4, 1362, 1285, 78, 2725
KopiPanas, 1009, 38.5, 156, 518, 6, 680
kopsuz, 1319, 39.7, 471, 286, 19, 776
Korito, 1248, 26.3, 728, 931, 31, 1690
Kormyn, 1429, 108.3, 835, 1056, 50, 1941
kornetti, 1286, 67.7, 218, 467, 31, 716
Koromjol, 716, 70.3, 23, 101, 2, 126
korrin, 1853, 79.6, 19397, 10478, 866, 30741
Korus, 1682, 26.8, 4299, 5187, 779, 10265
kosaco, 1226, 53.1, 1027, 971, 121, 2119
kosesavas, 1474, 24.4, 464, 540, 51, 1055
KosGeza, 1548, 52.6, 8534, 6280, 898, 15712
kosten, 1294, 26.6, 2920, 3511, 268, 6699
kostik, 1618, 33.7, 14886, 11438, 797, 27121
KostikChess, 1617, 27.8, 9047, 10681, 986, 20714
Kostromich, 1289, 60.7, 1934, 1748, 112, 3794
kosutnjak, 1098, 121.6, 15, 121, 8, 144
kotaskotaskotas, 1079, 38.1, 1292, 2193, 139, 3624
kotaukir, 764, 138.0, 2, 16, 0, 18
kotbegemot, 1636, 38.0, 991, 867, 75, 1933
KotDB, 1233, 83.5, 67, 95, 7, 169
kotedvali, 1197, 25.9, 2090, 4445, 160, 6695
kothari, 1148, 86.0, 436, 735, 34, 1205
Kotos, 1435, 102.2, 1516, 1708, 145, 3369
kotov, 1732, 32.5, 8860, 11633, 866, 21359
kottimuni, 1125, 56.0, 841, 1028, 61, 1930
kouassy, 1635, 26.9, 8613, 4836, 559, 14008
koufaxrules, 1339, 46.2, 3393, 1624, 280, 5297
Kovalcsik, 1619, 110.8, 2045, 1900, 216, 4161
koverhbarc, 1103, 62.9, 319, 421, 36, 776
Kowisss, 1784, 73.1, 1092, 849, 80, 2021
kozlik, 1373, 36.8, 1416, 1838, 142, 3396
kozyr, 1782, 44.6, 2748, 1992, 287, 5027
KPEOzOT, 1152, 65.6, 115, 155, 7, 277
kpt, 1037, 61.0, 2785, 2506, 159, 5450
kpthunderjam, 1034, 38.0, 455, 882, 39, 1376
kqb, 1251, 90.3, 131, 339, 8, 478
KQBFive, 1835, 75.4, 336, 321, 43, 700
krad, 1133, 44.1, 2704, 3035, 186, 5925
Kraehe, 1197, 72.2, 2684, 3178, 329, 6191
kragstr, 1812, 297.5, 2, 0, 0, 2
Krait, 1294, 270.8, 3, 2, 0, 5
Krakaur, 1125, 64.2, 268, 318, 25, 611
KraljevoKrilo, 1298, 183.1, 2, 7, 0, 9
kramavarma, 1282, 266.0, 13, 18, 4, 35
kramnitch, 1556, 27.0, 601, 540, 91, 1232
KrangKwanten, 925, 239.5, 1, 4, 0, 5
Kratt, 1397, 166.9, 2159, 3154, 224, 5537
Kraw, 1051, 62.7, 448, 351, 14, 813
krazyking, 1187, 84.2, 549, 816, 74, 1439
Krechet, 1561, 85.4, 3295, 2705, 196, 6196
krell, 1554, 26.9, 17810, 30769, 2088, 50667
Kremlock, 1038, 93.9, 37, 70, 0, 107
Kreyszig, 1563, 36.4, 586, 208, 44, 838
krimskramnik, 1618, 45.9, 658, 461, 44, 1163
Krinex, 1557, 196.5, 1539, 1848, 101, 3488
KrisBerntsson, 1607, 45.8, 34, 32, 1, 67
krishnak, 1124, 30.9, 2393, 1821, 113, 4327
krishnaraj, 1471, 52.6, 2961, 1960, 165, 5086
krispykurtis, 1376, 42.0, 908, 668, 23, 1599
krissie, 1595, 55.8, 5250, 7418, 449, 13117
kristeta, 1514, 83.1, 1527, 1935, 169, 3631
krivoy, 1213, 31.0, 703, 842, 29, 1574
KRMCHESS, 1601, 48.9, 3621, 2008, 314, 5943
krowndsy, 1141, 49.9, 111, 135, 5, 251
KRozak, 1205, 51.2, 586, 960, 69, 1615
KrTuanTuan, 1768, 116.1, 9, 6, 1, 16
krty, 1326, 27.4, 1473, 1174, 63, 2710
krumeich, 1446, 34.4, 610, 677, 53, 1340
Krusher, 1748, 185.3, 2089, 2497, 233, 4819
Kryndon, 1167, 71.1, 247, 661, 21, 929
krzysiek, 1615, 42.6, 3052, 3556, 605, 7213
ksflyfisher, 1459, 68.0, 3206, 1622, 261, 5089
ksideking, 1543, 37.7, 5657, 7357, 467, 13481
KSKmaster, 1410, 36.4, 4455, 3844, 297, 8596
KSRICHARANK, 1441, 34.5, 5777, 7341, 776, 13894
ksuchlicki, 1718, 48.4, 4607, 4245, 481, 9333
kta, 1093, 46.0, 1237, 1361, 82, 2680
Ktech, 1500, 307.5, 1, 1, 1, 3
ktgrey, 1296, 85.4, 175, 177, 18, 370
Kthanakit, 1453, 43.9, 163, 101, 10, 274
KTKnight, 1563, 52.0, 585, 762, 56, 1403
kttemplar, 1732, 30.1, 10820, 12565, 1662, 25047
ktxpchmate, 966, 109.5, 139, 209, 16, 364
KudaKayu, 1467, 38.4, 3059, 2144, 129, 5332
kudakikikai, 1557, 103.6, 90, 43, 9, 142
kudli, 1210, 194.9, 2, 4, 0, 6
Kuffner, 783, 106.7, 20, 123, 0, 143
Kughanr, 1279, 60.3, 252, 381, 17, 650
kujlikumar, 1315, 116.9, 57, 100, 8, 165
kukatym, 1805, 91.0, 162, 152, 13, 327
kukiromio, 1135, 38.6, 88, 98, 3, 189
Kukka, 1676, 39.9, 2744, 2228, 362, 5334
kukukilla, 1024, 137.2, 1, 25, 0, 26
kulal, 1415, 38.2, 2623, 1814, 148, 4585
kuland, 1494, 24.8, 4724, 6061, 347, 11132
kumamotop, 1306, 48.3, 9036, 11635, 976, 21647
Kumiankka, 760, 105.3, 15, 66, 2, 83
Kumis, 934, 215.5, 1, 8, 0, 9
kunde, 2312, 183.8, 5543, 6679, 1082, 13304
Kundeohmar, 610, 123.3, 13, 153, 0, 166
kunfucius, 1101, 115.3, 337, 426, 24, 787
kunge, 1505, 31.1, 5203, 3187, 141, 8531
kunnis, 890, 136.0, 3, 19, 0, 22
Kunta, 1648, 61.1, 3581, 3381, 404, 7366
KunTae, 1667, 120.7, 647, 442, 38, 1127
kurejiyaro, 1689, 75.7, 136, 82, 18, 236
Kurfuerst, 1691, 26.6, 9157, 11106, 1564, 21827
Kurgun, 1197, 208.7, 1, 3, 0, 4
kurich, 1212, 100.5, 188, 148, 13, 349
kurtissss, 1752, 24.8, 4520, 2368, 151, 7039
Kurukshetra, 903, 101.4, 96, 272, 0, 368
kurumim, 1439, 78.5, 26, 13, 5, 44
kurumo, 1615, 62.7, 1627, 1059, 164, 2850
kusadak, 1512, 97.4, 424, 596, 81, 1101
Kuschuj, 2051, 31.8, 588, 388, 114, 1090
kushal, 1339, 41.3, 641, 999, 88, 1728
Kuskus, 1614, 65.9, 5101, 3435, 291, 8827
kusokosla, 1572, 51.7, 2951, 3294, 408, 6653
kust, 1306, 94.6, 9, 9, 1, 19
kuyrten, 1445, 30.1, 376, 296, 17, 689
kuznec, 1883, 53.0, 797, 66, 12, 875
kvenna, 1137, 40.4, 445, 513, 27, 985
kvsankaran, 1207, 27.9, 3132, 4042, 352, 7526
kwidzynmaster, 1072, 57.3, 2579, 2662, 228, 5469
kwikarlo, 1438, 65.5, 868, 689, 72, 1629
kyaw, 1452, 79.3, 1744, 2185, 163, 4092
kybjung, 1251, 51.9, 92, 105, 8, 205
kylec, 1487, 45.5, 4200, 3178, 276, 7654
kylejmiles, 1567, 28.6, 1757, 1236, 83, 3076
Kyo, 1767, 91.0, 5786, 4524, 556, 10866
kyrgyz, 1605, 29.6, 371, 406, 37, 814
Kyuuketsuki, 2034, 84.3, 242, 109, 31, 382
Laa, 1268, 106.2, 278, 221, 18, 517
laalgolap, 1142, 63.6, 929, 1086, 63, 2078
labeton, 1206, 112.3, 1221, 2129, 154, 3504
Labyrinx, 883, 113.0, 73, 202, 3, 278
lacceroswaldo, 759, 61.8, 98, 415, 9, 522
lachmeeuw, 1358, 48.8, 4228, 4689, 888, 9805
LaCosta, 1566, 72.1, 512, 956, 65, 1533
ladardude, 1365, 47.1, 919, 938, 47, 1904
Lader, 1338, 25.8, 23293, 15134, 1218, 39645
ladja, 1661, 39.2, 928, 955, 63, 1946
lado, 1340, 36.9, 4329, 8791, 374, 13494
ladYCheckmate, 1641, 39.2, 623, 297, 34, 954
LadysKnight, 965, 205.5, 0, 5, 0, 5
laemania, 1441, 58.2, 947, 1427, 79, 2453
laerrus, 980, 47.9, 186, 825, 20, 1031
lafc, 1653, 24.3, 7031, 6053, 922, 14006
LaFly, 1586, 36.7, 423, 450, 44, 917
lagtag, 1624, 103.8, 162, 110, 10, 282
lahore, 1170, 174.2, 3, 4, 0, 7
Lahori, 1364, 28.0, 4937, 8933, 865, 14735
Lahrsen, 1842, 119.8, 2677, 4549, 554, 7780
laikun, 1806, 47.2, 2888, 3225, 396, 6509
lailasbar, 1423, 28.8, 7515, 2733, 425, 10673
LajosDr, 1418, 24.8, 10774, 12233, 1283, 24290
lakdrcjbj, 1368, 44.3, 223, 380, 18, 621
lakelandchess, 1861, 125.0, 2601, 2987, 249, 5837
lakerlife, 925, 67.4, 185, 270, 13, 468
Lakeview, 1112, 207.5, 0, 4, 0, 4
Laksa, 1811, 91.0, 5044, 7172, 479, 12695
lalison, 1396, 49.5, 89, 122, 3, 214
lalrinsanga, 1689, 50.8, 2464, 2399, 277, 5140
lamon, 1941, 49.5, 39, 68, 17, 124
lamplight, 1117, 42.2, 7940, 6930, 675, 15545
lamptraveller, 1237, 149.9, 180, 146, 14, 340
LanceBoil, 1304, 54.4, 325, 332, 21, 678
Landertxu, 1220, 110.2, 169, 128, 12, 309
landmind, 967, 180.3, 2, 9, 0, 11
landrew, 1491, 40.8, 4928, 3229, 361, 8518
Langan, 837, 84.1, 379, 1164, 31, 1574
langelot, 1734, 47.1, 4117, 5565, 529, 10211
Langoma, 1517, 54.5, 874, 1390, 87, 2351
lanikins, 1318, 58.4, 5526, 7453, 750, 13729
lankesh, 1254, 34.3, 676, 852, 43, 1571
Lansa, 1166, 289.0, 0, 2, 0, 2
LanssAnderson, 1210, 91.3, 15, 17, 0, 32
LanzenCity, 987, 163.2, 1, 14, 2, 17
Lanziee, 1299, 48.7, 182, 136, 8, 326
laotian, 1852, 35.5, 3430, 3928, 289, 7647
LaPazGuias, 1345, 82.0, 184, 91, 16, 291
lapham, 1862, 23.5, 19325, 14380, 1993, 35698
lapinsky, 1544, 46.3, 2096, 1511, 176, 3783
lapponia, 1453, 22.8, 838, 1474, 83, 2395
lapppi, 1099, 31.2, 2117, 4439, 149, 6705
lapsteelmando, 1058, 53.1, 36, 74, 5, 115
larcher, 1562, 45.5, 2754, 1187, 115, 4056
Largadon, 1164, 35.4, 201, 188, 22, 411
LargeJohnson, 1372, 24.6, 3289, 2576, 235, 6100
LARGOV, 1675, 72.2, 529, 489, 44, 1062
larion, 1396, 29.6, 501, 187, 15, 703
larix, 1535, 67.5, 1138, 975, 94, 2207
LarryCh, 1662, 65.6, 26, 25, 1, 52
larrygmone, 1321, 54.0, 1844, 1474, 160, 3478
LarryJ, 1098, 34.9, 1391, 1563, 81, 3035
LarryJasperson, 1233, 32.0, 103, 127, 5, 235
larryl, 1338, 25.5, 17208, 19064, 706, 36978
LarryS, 1640, 44.4, 9128, 5918, 1022, 16068
LarsenB, 1606, 38.6, 5216, 3195, 442, 8853
larsenross, 973, 38.7, 1562, 2162, 74, 3798
larumov, 1273, 27.9, 1118, 1888, 62, 3068
laserknight, 1114, 29.8, 1640, 2029, 125, 3794
LaskerEmmanuel, 1854, 72.5, 1079, 1800, 271, 3150
Laskerse, 1197, 32.6, 793, 1318, 85, 2196
laskersteinitz, 1477, 65.1, 19, 11, 2, 32
lasperge, 904, 233.1, 0, 3, 0, 3
LasseR, 1058, 70.3, 1219, 2052, 101, 3372
Lastavatar, 992, 50.3, 205, 315, 4, 524
lastchancexi, 1428, 69.1, 345, 384, 30, 759
lastjudgment, 2032, 37.0, 10049, 5641, 1039, 16729
LastKingStanding, 1500, 22.8, 5795, 7575, 925, 14295
Lasuede, 1268, 42.8, 391, 388, 25, 804
latahzan, 896, 88.8, 10, 23, 0, 33
latal, 1336, 34.4, 5067, 4174, 250, 9491
latentlives, 1461, 41.3, 539, 632, 69, 1240
LatentLogic, 1477, 51.0, 1305, 2215, 125, 3645
lathirus, 1289, 234.5, 2, 4, 0, 6
laudenor, 1368, 29.7, 3457, 4429, 408, 8294
laurieh, 1479, 25.2, 10951, 6649, 1242, 18842
lauriet, 1229, 42.5, 2605, 2453, 239, 5297
lauritza, 2011, 77.6, 1449, 951, 169, 2569
lavezaresnon, 1490, 26.0, 1298, 1880, 154, 3332
Lavrentivs, 1215, 87.9, 587, 764, 47, 1398
lawj, 1181, 225.9, 104, 46, 3, 153
Lawlcrackers, 723, 102.3, 24, 113, 2, 139
lawlessfew, 1233, 32.3, 2381, 2414, 153, 4948
lawrencegern, 842, 30.6, 135, 321, 5, 461
lazarferenc, 1066, 203.2, 13, 28, 2, 43
lazipawn, 1301, 39.3, 409, 313, 40, 762
lazn, 1245, 105.2, 1, 25, 4, 30
Lazouski, 1426, 67.8, 3529, 4723, 388, 8640
LazyGit, 1608, 38.2, 7945, 9956, 1203, 19104
LazyMan, 962, 223.5, 2, 3, 0, 5
lBOBl, 1543, 312.4, 1, 1, 0, 2
lcaution, 1995, 37.5, 3715, 2334, 838, 6887
LcfSeth, 1351, 37.8, 1731, 2017, 108, 3856
LcSkywx, 1674, 156.7, 91, 69, 9, 169
LDopa, 1003, 75.6, 119, 270, 5, 394
LeadFinger, 1380, 27.7, 5377, 5113, 490, 10980
Leake, 943, 94.5, 12, 35, 1, 48
lealmatheuss, 1505, 46.5, 1232, 1020, 101, 2353
leangleang, 1310, 21.5, 762, 524, 35, 1321
LeapingLeonard, 1265, 244.0, 1, 2, 0, 3
Learnfromthehood, 1107, 103.0, 184, 267, 6, 457
leasetentaysiete, 1228, 30.1, 2088, 3094, 176, 5358
leastbest, 1511, 65.0, 2718, 2870, 102, 5690
leatherjacket, 1519, 95.0, 134, 115, 35, 284
leatherjerk, 1422, 38.7, 495, 461, 38, 994
LeavingDetroit, 1066, 40.9, 726, 1719, 47, 2492
lebal, 1667, 30.3, 5553, 6095, 558, 12206
lebarts, 1360, 88.5, 6343, 5959, 534, 12836
LeBishop, 1113, 64.3, 34, 25, 1, 60
LeBronc, 1359, 27.2, 6374, 8374, 1279, 16027
lec, 1169, 38.5, 1899, 2742, 287, 4928
Lechevalierblanc, 1734, 48.0, 4764, 3923, 458, 9145
LeChinois, 1114, 45.7, 472, 384, 28, 884
Lecognition, 1336, 69.4, 411, 612, 52, 1075
Lectvay, 1416, 60.9, 3373, 3649, 227, 7249
ledude, 1200, 53.2, 5103, 6000, 172, 11275
ledutz, 1534, 65.2, 1816, 1269, 86, 3171
leeapples, 1533, 230.2, 0, 4, 0, 4
leehansen, 1358, 95.6, 262, 139, 24, 425
LeeHarvey, 1289, 50.6, 495, 443, 33, 971
leero, 1121, 46.0, 2376, 3811, 215, 6402
leeuwenhart, 1205, 41.7, 982, 1027, 82, 2091
LeffeM, 1470, 25.2, 1108, 510, 79, 1697
Leftang, 1125, 32.8, 2228, 2880, 39, 5147
lefthandsketch, 1582, 45.9, 1256, 1312, 172, 2740
Leftlane, 1050, 64.9, 1294, 1109, 49, 2452
legacyofblood, 1447, 89.9, 319, 159, 23, 501
LegalBeagle, 1688, 24.0, 15352, 4677, 843, 20872
legato, 1277, 39.7, 2310, 2141, 180, 4631
legendofme, 720, 119.9, 9, 43, 3, 55
LegendProducts, 1128, 42.7, 71, 224, 8, 303
legendyo, 991, 59.1, 174, 331, 24, 529
legoEngineer, 1239, 82.5, 53, 95, 3, 151
legrandmonarque, 1676, 40.3, 531, 291, 25, 847
Leikepeikepoasei, 1672, 111.1, 23, 3, 1, 27
Leitwolf, 1734, 32.5, 6333, 4196, 633, 11162
Lemale, 1121, 45.7, 157, 397, 15, 569
lemiiiii, 1382, 39.2, 6653, 5137, 378, 12168
Lemmy, 1213, 42.9, 1548, 2382, 94, 4024
LemonDragon, 919, 123.0, 52, 89, 7, 148
LemonKnight, 1458, 70.5, 140, 120, 13, 273
lempi, 1838, 70.0, 2233, 2268, 262, 4763
lemurcgt, 1455, 23.2, 1640, 1783, 126, 3549
Lemurian, 1667, 28.9, 5627, 4896, 954, 11477
Lennekrokodil, 1726, 51.8, 1332, 277, 66, 1675
Lennnnnon, 1456, 66.5, 11034, 11488, 1447, 23969
leoafricano, 1700, 36.7, 2130, 1335, 182, 3647
leobarnabe, 1085, 118.4, 90, 160, 8, 258
Leoch, 1885, 26.6, 6096, 2279, 648, 9023
leodemolidor, 1413, 53.1, 906, 1086, 95, 2087
leododo, 1532, 101.1, 99, 121, 10, 230
Leoduzi, 1382, 94.7, 828, 940, 41, 1809
leoitch, 1396, 32.7, 1879, 1146, 133, 3158
leoj, 1261, 53.5, 11435, 10840, 946, 23221
LEOLO, 1507, 37.1, 3897, 2795, 363, 7055
leomahler, 1207, 25.4, 638, 890, 83, 1611
leomuz, 1436, 62.3, 377, 573, 29, 979
leonardotsr, 1121, 95.4, 732, 765, 33, 1530
leonazoviv, 1410, 42.7, 361, 635, 42, 1038
LeonFede, 994, 39.4, 1776, 1620, 129, 3525
Leonfer, 1356, 18.2, 15156, 15996, 1982, 33134
leonferr, 1122, 98.5, 42, 44, 0, 86
Leonidshower, 1217, 31.1, 2720, 4900, 385, 8005
LeonidVolkov, 1841, 147.1, 4060, 4139, 780, 8979
LeoTR, 1235, 38.4, 231, 254, 22, 507
LePandaFou, 1142, 46.8, 259, 547, 9, 815
Leppur, 1530, 70.4, 1718, 1623, 164, 3505
leskovcanin, 1451, 24.7, 2865, 2844, 272, 5981
LeSpecialist, 1298, 90.6, 377, 368, 28, 773
LesPerkins, 987, 132.9, 41, 121, 6, 168
LeSquale, 1769, 34.2, 3408, 1501, 204, 5113
lethalgambit, 1808, 29.6, 24703, 7243, 1259, 33205
lethalLoy, 1338, 20.6, 234, 475, 30, 739
letsgetiton, 1935, 33.0, 13432, 5489, 876, 19797
Letshwiti, 1532, 64.8, 683, 885, 44, 1612
letsplaychessnow, 1211, 54.7, 4070, 5117, 403, 9590
lettucewacker, 1361, 41.4, 2905, 3170, 239, 6314
Letva, 1402, 22.8, 585, 748, 42, 1375
Leuniel, 1482, 49.2, 37, 56, 9, 102
levak, 1468, 25.9, 9085, 11173, 460, 20718
levell, 759, 82.1, 36, 149, 1, 186, 1682, 50.2, 1417, 897, 103, 2417
Leverkuhn, 1648, 52.5, 4165, 2520, 408, 7093
levicon, 1929, 50.8, 170, 232, 25, 427
Levilicus, 774, 131.8, 22, 113, 0, 135
Levinski, 1166, 171.6, 0, 6, 0, 6
levitan, 1343, 25.8, 4500, 4981, 344, 9825
levvel, 906, 147.6, 0, 11, 0, 11
leween, 930, 139.2, 221, 416, 22, 659
LexB, 1639, 24.3, 4814, 2993, 326, 8133
Lexcalibur, 2212, 42.2, 192, 73, 22, 287
Lexmo, 1793, 15.6, 5995, 5423, 425, 11843
lexspec, 1029, 27.8, 654, 1099, 67, 1820
LeZebo, 1514, 98.4, 42, 57, 4, 103
lfbpad, 1344, 37.4, 12989, 10658, 453, 24100
LFD, 1784, 40.4, 7352, 4541, 469, 12362
lfgaido, 1562, 30.2, 661, 396, 36, 1093
lgbarn, 1479, 64.5, 210, 98, 9, 317
lhoffman, 1175, 32.7, 1709, 1755, 123, 3587
lhoward, 805, 40.0, 336, 652, 12, 1000
Liakoni, 1702, 53.0, 3737, 2405, 170, 6312
LibinKERALA, 1699, 336.4, 0, 1, 0, 1
LiborK, 1243, 33.5, 1230, 1245, 82, 2557
Liburnae, 1492, 90.2, 1350, 1949, 171, 3470
licenser, 1568, 113.6, 154, 100, 13, 267
lichaa, 1171, 84.9, 763, 798, 40, 1601
Lictewitz, 1607, 29.6, 10744, 10787, 560, 22091
lideyi, 1265, 219.0, 4, 14, 0, 18
lienlo, 1915, 34.2, 858, 707, 73, 1638
lieverd, 2000, 115.0, 1531, 1311, 239, 3081
lifeisgood, 1439, 40.8, 1693, 2136, 223, 4052
lifeTaker, 1271, 135.2, 39, 31, 2, 72
lightfun, 939, 108.0, 1028, 1228, 107, 2363
Lighthill, 1668, 82.0, 481, 720, 72, 1273
LightningBlade, 1186, 215.4, 3, 5, 0, 8
lightningchess, 1581, 119.8, 327, 226, 35, 588
lightonwater, 1077, 96.9, 874, 864, 53, 1791
Lightrock, 1524, 100.1, 589, 644, 18, 1251
lightsabre, 1378, 31.3, 7757, 10004, 1764, 19525
ligmo, 1524, 23.2, 4291, 4782, 367, 9440
lihkin, 1193, 68.4, 589, 614, 48, 1251
Lije, 1594, 30.4, 6628, 5967, 710, 13305
LikesChess, 1345, 66.0, 66, 82, 7, 155
likkkkk, 1137, 148.0, 4, 8, 2, 14
LiKr, 1743, 37.2, 3384, 3072, 282, 6738
lilagondwana, 1365, 110.0, 652, 398, 21, 1071
lilithu, 966, 46.1, 1456, 4386, 90, 5932
liljan, 1586, 45.2, 2371, 1231, 138, 3740
Lillo, 1425, 68.1, 5386, 5175, 639, 11200
lilpuppy, 961, 25.6, 790, 1197, 68, 2055
LiLWeezy, 1618, 100.7, 159, 117, 8, 284
liman, 1116, 64.2, 11, 28, 0, 39
limewire, 1329, 22.8, 2692, 10132, 517, 13341
limk, 1540, 20.8, 5684, 8023, 844, 14551
limun, 1242, 37.9, 645, 666, 42, 1353
LinceHispano, 1586, 44.0, 511, 367, 79, 957
Linder, 1039, 26.8, 926, 2174, 71, 3171
LindseyLohansBox, 1655, 101.6, 6826, 5035, 670, 12531
linguist, 1982, 33.2, 1489, 1059, 85, 2633
Linhasxoc, 1088, 196.5, 2, 4, 0, 6
Linkslover, 1417, 69.7, 1626, 1543, 132, 3301
LinoC, 1311, 31.9, 6223, 4268, 444, 10935
LinuxGuy, 1350, 47.5, 409, 498, 48, 955
linuxinside, 1517, 35.7, 6784, 4088, 591, 11463
liontail, 1904, 104.5, 4015, 2980, 505, 7500
LipalarThunerien, 1917, 71.4, 875, 296, 47, 1218
lippnat, 1271, 39.1, 1283, 1374, 82, 2739
lipsticks, 1503, 38.7, 2380, 3420, 187, 5987
Lir, 1344, 100.1, 119, 54, 6, 179
LisaSimpson, 1044, 155.5, 13, 26, 0, 39
LissaChess, 1669, 126.9, 383, 238, 7, 628
Listopad, 1205, 37.1, 1810, 2140, 175, 4125
lisu, 1421, 34.7, 3279, 3193, 240, 6712
liteTouch, 1247, 308.6, 0, 1, 0, 1
Lither, 1750, 24.3, 2109, 2616, 308, 5033
litmus, 1653, 70.9, 9785, 6182, 915, 16882
littleKasparov, 1039, 63.1, 878, 3451, 111, 4440
LittleLulu, 1584, 30.9, 1080, 692, 117, 1889
littlemasterjoe, 1318, 37.9, 1072, 1176, 105, 2353
littlemoon, 1425, 90.2, 196, 239, 35, 470
LittleNorris, 946, 65.6, 46, 60, 1, 107
littlequeenmex, 1519, 103.3, 640, 987, 60, 1687
littlespidey, 1318, 128.3, 163, 90, 8, 261
LittleTrouble, 1815, 20.2, 1843, 1193, 180, 3216
littlewingpeace, 1417, 190.0, 326, 366, 41, 733
littlewoodenguy, 1324, 35.6, 3004, 4810, 391, 8205
litvintjuk, 1750, 57.2, 2109, 970, 127, 3206
liveinkicking, 1122, 63.7, 651, 778, 20, 1449
Livinglight, 1505, 128.5, 155, 60, 3, 218
Lizano, 1440, 53.2, 435, 505, 43, 983
ljj, 1380, 34.8, 278, 268, 8, 554
LJNights, 1100, 35.8, 58, 100, 3, 161
Ljube, 1316, 28.6, 1834, 1444, 239, 3517
lkajsdlfkj, 1228, 125.1, 11, 11, 0, 22
LKD, 953, 144.4, 61, 167, 2, 230
lklkck, 1150, 27.9, 188, 480, 6, 674
llaman, 1500, 38.8, 1247, 1341, 105, 2693
LLIAMAH, 1700, 29.0, 6210, 5318, 502, 12030
llmbs, 1154, 45.2, 2516, 4129, 158, 6803
LLoet, 1343, 39.4, 8267, 4482, 595, 13344
Lloth, 1604, 23.7, 1143, 1339, 99, 2581
LloydDobler, 1687, 20.8, 13477, 18956, 2616, 35049
lloydsanders, 863, 37.3, 957, 1136, 117, 2210
lloydx, 1490, 38.5, 11999, 12203, 879, 25081
lmanzi, 1774, 38.5, 3481, 4764, 566, 8811
lmftel, 1385, 25.0, 8085, 8016, 933, 17034
LMoves, 1444, 48.8, 545, 560, 18, 1123
lnhanj, 994, 55.2, 55, 95, 3, 153
lobodelbosque, 1356, 97.4, 1696, 2818, 155, 4669
loboherido, 1388, 106.4, 83, 110, 12, 205
Lobotek, 1192, 76.0, 974, 1248, 56, 2278
locco, 903, 229.2, 135, 234, 13, 382
lochNess, 1126, 58.7, 8767, 16907, 385, 26059
lockidagenius, 1341, 31.5, 1152, 987, 38, 2177
locksleyu, 1411, 111.9, 440, 311, 37, 788
locomo, 1126, 29.5, 2322, 4700, 157, 7179
LocoPoco, 1944, 140.4, 449, 156, 31, 636
lofff, 913, 72.0, 12, 27, 0, 39
Lofling, 1738, 72.9, 90, 95, 24, 209
LoganFive, 1628, 44.7, 767, 318, 67, 1152
Loggington, 868, 47.7, 227, 585, 14, 826
loggit, 1247, 65.1, 63, 105, 2, 170
logicl, 1128, 46.5, 505, 565, 30, 1100
Logosity, 1225, 36.0, 843, 1535, 83, 2461
LOGRE, 1285, 64.0, 1861, 1577, 145, 3583
loguh, 1424, 38.5, 2189, 3448, 117, 5754
lojvra, 1664, 37.3, 323, 186, 25, 534
Lojz, 1807, 23.8, 14579, 6928, 742, 22249
Lokeyx, 1604, 90.4, 49, 174, 8, 231
lokiju, 1295, 119.3, 478, 546, 65, 1089
LokiSon, 1487, 32.2, 3744, 4706, 184, 8634
LokiStormbringer, 1173, 49.8, 120, 164, 10, 294
lolaner, 1387, 23.2, 3720, 3193, 271, 7184
lolidis, 1798, 32.8, 5915, 7085, 672, 13672
lolification, 1407, 103.9, 332, 234, 24, 590
LolKingMe, 862, 61.1, 21, 43, 2, 66
LOMAROV, 1428, 32.6, 169, 125, 20, 314
Lomboc, 1813, 162.9, 1524, 1381, 124, 3029
LondonKC, 1422, 79.7, 40, 47, 3, 90
loneknight, 1316, 70.1, 2464, 4021, 381, 6866
Lonepaw, 1095, 337.6, 0, 1, 0, 1
lonewalker, 952, 156.1, 1, 13, 0, 14
lonewolfjoe, 1222, 28.2, 194, 317, 13, 524
Longandsons, 1070, 45.3, 240, 421, 15, 676
longrider, 1427, 53.4, 954, 941, 144, 2039
longrunner, 1002, 95.0, 42, 53, 2, 97
longvanpham, 1385, 44.4, 517, 455, 31, 1003
Loni, 1860, 47.2, 1718, 1162, 142, 3022
lookinglasself, 1586, 71.2, 5426, 2813, 367, 8606
LookZS, 1391, 50.5, 5141, 3847, 322, 9310
LooneyTunes, 1633, 40.5, 1899, 1819, 280, 3998
loosers, 1183, 110.8, 2005, 3306, 238, 5549
LopezE, 1371, 76.1, 301, 320, 27, 648
Lorca, 1423, 40.3, 8090, 6084, 863, 15037
lordargos, 1211, 60.6, 86, 109, 5, 200
LordBlackBolt, 1391, 61.2, 927, 990, 108, 2025
LordByron, 1349, 45.1, 6360, 5893, 444, 12697
Lordcloud, 1144, 99.8, 394, 624, 26, 1044
LordCurzon, 1468, 29.9, 4355, 5035, 322, 9712
LordFarquad, 1961, 132.4, 233, 101, 20, 354
LordFou, 1387, 53.7, 4300, 2076, 163, 6539
LordHenryWotton, 1179, 92.3, 135, 443, 19, 597
lordjules, 1517, 63.7, 1406, 1292, 145, 2843
LordManhammer, 1917, 231.8, 3, 0, 0, 3
lordofpimps, 1504, 90.7, 10, 17, 1, 28
LordofthePieces, 1146, 26.0, 1528, 2485, 200, 4213
LordRNA, 1398, 85.5, 71, 37, 7, 115
LordTyraad, 1130, 33.8, 1454, 2405, 110, 3969
LordVenom, 1738, 64.1, 363, 364, 30, 757
LordYama, 1027, 174.4, 63, 44, 1, 108
lordyburd, 771, 132.7, 4, 38, 0, 42
lorecai, 1206, 42.4, 7488, 9242, 650, 17380
LorenzoDV, 1218, 33.5, 6670, 12537, 410, 19617
LorenzoTraldi, 1503, 32.3, 14377, 9916, 1368, 25661
Lorgen, 1852, 121.5, 83, 41, 22, 146
Loschiburungulos, 1121, 37.7, 234, 313, 15, 562
loserville, 1401, 35.0, 233, 4725, 29, 4987
Lostbishop, 1211, 22.8, 5213, 7443, 344, 13000
LostIllusion, 1482, 28.0, 932, 759, 41, 1732
lostpawns, 1474, 38.3, 672, 431, 33, 1136
LostPotential, 1792, 47.3, 349, 339, 54, 742
LotusBunny, 1008, 217.0, 1, 7, 0, 8
louan, 1256, 33.2, 1308, 1384, 100, 2792
LouFelice, 1247, 37.6, 176, 215, 4, 395
louiii, 1013, 83.2, 2156, 4742, 294, 7192
Louisbed, 1380, 86.9, 442, 698, 70, 1210
louislobal, 808, 228.6, 0, 4, 0, 4
louissaint, 1028, 35.5, 780, 1525, 14, 2319
louwman, 1264, 55.0, 540, 428, 47, 1015
LoveBangladesh, 718, 130.1, 0, 66, 1, 67
loveinvain, 1678, 48.3, 461, 341, 32, 834
lovelace, 1705, 75.4, 7121, 3911, 738, 11770
Lovelost, 1022, 38.9, 1700, 2179, 150, 4029
lovemate, 1133, 27.9, 5212, 8945, 569, 14726
lovenikkiheat, 1493, 77.9, 1625, 1569, 97, 3291
LoverBoyBlitz, 1613, 26.6, 138, 152, 15, 305
LOVERBOYS, 1162, 19.0, 17626, 29459, 4443, 51528
Lovetylerlove, 1075, 124.8, 23, 39, 1, 63
lovtib, 1641, 34.5, 3124, 5201, 360, 8685
lovtoplay, 1347, 33.2, 4439, 2943, 331, 7713
lowcash, 1083, 63.8, 516, 678, 18, 1212
lowly, 1176, 38.5, 137, 152, 12, 301
lowmiles, 1518, 22.5, 6663, 8747, 318, 15728
lowroller, 1428, 32.8, 4562, 3811, 410, 8783
LowScore, 1314, 50.8, 1471, 1275, 187, 2933
lowther, 1113, 34.7, 109, 126, 9, 244
LPacheco, 1048, 33.3, 502, 1054, 41, 1597
LPetrosian, 922, 99.2, 18, 43, 2, 63
Lpham, 1479, 114.3, 141, 86, 7, 234
Lpolk, 996, 163.3, 0, 5, 0, 5
lporter, 1542, 37.6, 4402, 5075, 169, 9646
Lresseguier, 1073, 84.4, 7, 28, 1, 36
LScope, 1052, 31.7, 80, 223, 10, 313
LSDave, 1261, 57.1, 95, 78, 1, 174
lsetia, 1638, 43.8, 12338, 4748, 666, 17752
lshatok, 891, 114.2, 51, 158, 2, 211
LSLee, 1740, 22.8, 12843, 22280, 1413, 36536
lsteady, 1534, 35.9, 3979, 4562, 482, 9023
ltbgrindin, 760, 176.8, 2, 13, 0, 15
LTHigham, 1589, 38.5, 8702, 6093, 591, 15386
LTrailer, 1119, 71.4, 1011, 929, 60, 2000
lubbi, 1666, 28.7, 6794, 2089, 402, 9285
Lubitel, 1838, 51.0, 6903, 2441, 410, 9754
lubnet, 1312, 241.8, 1, 4, 0, 5
LubovD, 1411, 58.7, 159, 117, 4, 280
lubul, 1086, 48.4, 3508, 3707, 167, 7382
lucasm, 1230, 61.2, 1434, 1614, 108, 3156
lucathief, 1465, 251.2, 4, 7, 0, 11
lucckkie, 876, 72.7, 52, 158, 0, 210
lucera, 996, 111.5, 907, 1837, 26, 2770
luchitoelas, 1246, 66.5, 4144, 7042, 489, 11675
lucho, 1543, 41.0, 4143, 4685, 372, 9200
Lucianoasp, 1260, 176.1, 41, 50, 5, 96
LucidLeo, 1730, 129.8, 425, 354, 37, 816
lucindaram, 923, 53.3, 34, 82, 3, 119
Luckey, 1396, 59.0, 1188, 551, 48, 1787
LuckyDayDragon, 1455, 33.5, 3963, 2279, 235, 6477
Luckyfellow, 926, 35.3, 445, 357, 21, 823
luckyknights, 1171, 132.4, 66, 120, 11, 197
luckyluchino, 1060, 66.8, 316, 709, 45, 1070
luckylukelang, 1156, 121.4, 318, 485, 19, 822, 1227, 76.4, 10064, 14602, 660, 25326
lucytoo, 1512, 25.8, 3670, 4530, 331, 8531
ludimagister, 1441, 45.8, 3723, 2833, 586, 7142
ludom, 1162, 28.7, 451, 483, 13, 947
Ludovicf, 1619, 28.4, 2072, 2018, 275, 4365
luffe, 1529, 146.0, 21005, 24525, 2080, 47610
Lugin, 1726, 33.8, 491, 209, 57, 757
Lugosi, 1402, 29.8, 9858, 9850, 542, 20250
LuigiJerk, 1152, 30.3, 276, 361, 24, 661
luiscortorreal, 1233, 69.5, 369, 506, 27, 902
LUISFG, 1231, 36.2, 109, 208, 7, 324
luisfveloz, 1466, 41.2, 1324, 1024, 48, 2396
luisguillermo, 1324, 34.0, 1220, 1879, 100, 3199
luislebe, 1102, 73.7, 102, 91, 12, 205
LuisMaster, 1361, 78.0, 417, 428, 40, 885
luismrosario, 1009, 103.2, 40, 73, 6, 119
luisOett, 1429, 122.8, 359, 285, 24, 668
luispapa, 1435, 99.9, 5, 13, 0, 18
luizlandim, 1677, 31.1, 10118, 10160, 653, 20931
LukasG, 1549, 52.2, 2310, 1631, 221, 4162
Lukavuk, 1019, 55.6, 36, 41, 1, 78
Lukedoggy, 1625, 55.8, 1310, 1163, 129, 2602
LukeG, 1310, 60.3, 781, 1630, 109, 2520
lukestar, 1309, 113.0, 60, 38, 6, 104
lukilukas, 1291, 40.8, 2765, 4127, 328, 7220
LukoKruco, 1434, 22.7, 386, 557, 27, 970
lukwtwz, 1452, 25.5, 298, 489, 30, 817
LuleaSweden, 1536, 29.0, 3497, 5600, 416, 9513
lullard, 953, 102.8, 118, 175, 10, 303
lumas, 1241, 167.9, 1, 5, 1, 7
lumbering, 1413, 89.9, 1108, 525, 105, 1738
Lummox, 1643, 111.9, 13292, 7050, 936, 21278
Lunaticus, 1423, 42.7, 725, 504, 57, 1286
Lunda, 1200, 57.9, 105, 74, 8, 187
luou, 1760, 33.9, 8974, 7655, 689, 17318
Lupinski, 1389, 26.4, 7004, 6058, 510, 13572
lupita, 1727, 50.7, 12700, 16933, 1423, 31056
lupoconsult, 1881, 31.4, 4597, 3419, 354, 8370
lupu, 1538, 40.5, 4216, 3517, 427, 8160
Luria, 985, 96.5, 4323, 6903, 436, 11662
lusan, 1303, 50.6, 1228, 985, 45, 2258
Lushtresd, 1411, 87.0, 314, 374, 20, 708
lusor, 1158, 53.4, 582, 676, 68, 1326
Lustang, 1270, 50.0, 305, 386, 27, 718
luwsk, 1503, 79.7, 201, 272, 8, 481
LuxAeterna, 1633, 86.4, 128, 76, 11, 215
luxuskreuzer, 1231, 34.4, 649, 628, 40, 1317
luyola, 1498, 81.8, 416, 329, 19, 764
LVdave, 1450, 51.7, 131, 87, 12, 230
lvviejo, 1122, 109.8, 348, 327, 33, 708
LWashington, 1359, 35.7, 250, 292, 39, 581
LWCchess, 1094, 96.2, 114, 207, 13, 334
LXH, 1746, 86.3, 5109, 1732, 337, 7178
lxl, 1799, 51.6, 468, 602, 77, 1147
lyapunov, 1511, 28.1, 10807, 11815, 403, 23025
Lyckosam, 1360, 26.8, 877, 1028, 118, 2023
lyco, 1358, 20.7, 4839, 7330, 576, 12745
LydenChess, 1200, 49.0, 387, 472, 22, 881
Lyink, 1712, 81.9, 203, 266, 14, 483
LynxDe, 1460, 33.8, 405, 540, 78, 1023
lyrad, 966, 41.3, 1024, 1613, 48, 2685
Lysty, 1580, 38.2, 3060, 2165, 459, 5684
LytzOwt, 1159, 126.8, 25, 25, 2, 52
lzttk, 1130, 84.4, 660, 684, 32, 1376
maag, 1431, 30.7, 20457, 8522, 1171, 30150
maarnold, 1785, 109.0, 142, 146, 26, 314
MaccDavid, 1236, 53.2, 1754, 1594, 235, 3583
macgregorchess, 1363, 31.5, 6242, 5316, 364, 11922
Macgregr, 1118, 31.0, 3294, 2958, 186, 6438
Machecroute, 1722, 144.1, 3486, 2167, 245, 5898
Machessty, 1175, 125.1, 466, 334, 28, 828
MachineLanguage, 1414, 76.0, 563, 668, 48, 1279
machoking, 1517, 24.7, 12236, 10766, 1173, 24175, 1337, 206.7, 727, 392, 35, 1154
macjio, 999, 89.0, 955, 1894, 95, 2944
Mackavelli, 1219, 106.3, 3757, 4776, 373, 8906
mackgathey, 1377, 35.6, 2725, 2785, 250, 5760
mackhoward, 1582, 37.7, 584, 407, 53, 1044
MACKUSA, 1770, 21.0, 5758, 9717, 521, 15996
macocoy, 1186, 28.7, 1043, 1563, 175, 2781
macreez, 1222, 39.1, 2922, 3710, 189, 6821
MACRI, 1344, 26.7, 5335, 7593, 521, 13449
MacroMike, 1435, 32.4, 9089, 7410, 474, 16973
macstevet, 1276, 26.2, 1702, 1589, 108, 3399
Madamspank, 1044, 115.3, 244, 679, 35, 958
madaxeman, 1302, 91.1, 128, 395, 11, 534
madbiotic, 1323, 128.2, 34, 32, 5, 71
madcatlives, 1411, 198.2, 6, 6, 1, 13
madchenlied, 1274, 88.9, 44, 90, 4, 138
madchesser, 998, 48.6, 312, 203, 13, 528
madefighter, 1271, 49.0, 7722, 9276, 904, 17902
MadeYouRage, 964, 128.9, 2, 19, 1, 22
madhumita, 1267, 36.3, 879, 891, 55, 1825
madisonbritt, 834, 100.2, 1, 46, 1, 48
madjuice, 1607, 96.1, 3310, 3048, 224, 6582
madmayjohn, 1292, 41.1, 1853, 714, 85, 2652
Madmin, 2064, 281.2, 138, 57, 6, 201
MadMystic, 1189, 163.8, 7, 9, 0, 16
madnr, 1262, 46.2, 122, 241, 20, 383
MadRagingWombat, 1103, 36.6, 2523, 4444, 309, 7276
madrilenow, 1181, 47.4, 265, 170, 18, 453
madrock, 1150, 34.5, 6359, 3949, 354, 10662
maeniel, 1947, 60.5, 10393, 7531, 1084, 19008
maequalsf, 1587, 81.2, 1228, 730, 62, 2020
MAESTROJERU, 1187, 96.4, 16, 33, 0, 49
maestru, 1969, 60.2, 1125, 1688, 262, 3075
mafimoya, 1111, 26.1, 900, 1013, 15, 1928
mafy, 1500, 134.2, 478, 219, 52, 749
Magasek, 1257, 129.1, 699, 668, 68, 1435
magasser, 1279, 112.4, 103, 118, 10, 231
magberr, 1554, 38.6, 14426, 9059, 868, 24353
Mage, 1481, 23.2, 22217, 36737, 1650, 60604
mageta, 1727, 60.9, 2295, 1928, 282, 4505
maggiedog, 912, 31.7, 2362, 11796, 529, 14687
magiadam, 1280, 96.3, 669, 876, 58, 1603
magicalfiredragon, 1002, 40.1, 763, 858, 64, 1685
magiced, 1137, 144.7, 19, 16, 1, 36
Magicianofchess, 1261, 37.9, 2949, 2042, 247, 5238
Magico, 1542, 35.7, 6013, 6549, 918, 13480
MagicWlady, 1461, 24.8, 9495, 8958, 1016, 19469
Magio, 1225, 96.6, 1040, 1387, 57, 2484
maglorelf, 1563, 51.5, 857, 830, 54, 1741
Magme, 1537, 97.6, 816, 512, 57, 1385
magnif, 1020, 241.2, 18, 84, 3, 105
magnito, 1110, 162.5, 26, 67, 5, 98
magnoro, 1553, 84.4, 8020, 4945, 758, 13723
magnusmagnusmagnu, 1210, 43.9, 562, 563, 60, 1185
magochess, 1445, 84.1, 810, 730, 70, 1610
magomerluzzo, 1687, 30.8, 2059, 790, 77, 2926
Magsgold, 1356, 114.2, 9, 8, 0, 17
maguli, 1387, 31.9, 766, 848, 48, 1662
mahabaraya, 842, 99.4, 10, 50, 0, 60
mahabonu, 1397, 41.3, 306, 213, 24, 543
mahamud, 1712, 143.8, 24776, 23567, 1331, 49674
maharais, 1323, 32.2, 2275, 2345, 153, 4773
Mahendra, 1705, 75.6, 2063, 3060, 203, 5326
Mahgar, 1158, 68.5, 79, 105, 12, 196
Mahog, 1322, 39.1, 5049, 4668, 419, 10136
mahrooky, 1377, 46.1, 462, 311, 40, 813
MaineMathMan, 1094, 65.8, 67, 72, 2, 141
MaitreSaucisson, 1404, 119.7, 978, 651, 60, 1689
Majic, 1339, 207.7, 677, 382, 47, 1106
MAJPAO, 1286, 38.9, 1757, 2180, 214, 4151
makarp, 1489, 32.9, 15210, 16812, 668, 32690
Makedamove, 1834, 88.6, 22, 44, 2, 68
makers, 995, 63.7, 244, 483, 12, 739
makita, 1239, 41.9, 767, 924, 113, 1804
makitooop, 1639, 24.4, 1109, 444, 54, 1607
makkena, 905, 130.2, 48, 45, 1, 94
maksimiljan, 1411, 31.1, 90, 80, 4, 174
malachiconstant, 1433, 148.1, 8, 19, 0, 27
malachifnord, 814, 26.2, 194, 904, 24, 1122
malachirevelation, 1160, 36.4, 183, 296, 21, 500
malako, 1670, 26.5, 1968, 2253, 190, 4411
MAlbertini, 1138, 134.3, 0, 12, 0, 12
MalcaReborn, 862, 74.8, 1186, 2012, 286, 3484
malcolmreynolds, 1547, 37.0, 784, 685, 100, 1569
malconductor, 992, 120.6, 70, 206, 2, 278
MALCOVICH, 1735, 130.9, 5429, 7099, 802, 13330
maldov, 1101, 68.3, 395, 624, 31, 1050
Malfurion, 1700, 37.7, 3836, 2494, 327, 6657
Mallia, 1312, 47.7, 1331, 2086, 74, 3491
Mallinath, 1411, 101.8, 5, 25, 2, 32
mallowisious, 1419, 46.4, 4050, 3661, 240, 7951
Malondron, 1619, 78.3, 2818, 1401, 108, 4327
malpica, 1452, 23.1, 6951, 11618, 348, 18917
malteseone, 1069, 56.9, 944, 1185, 122, 2251
MalvadoRJ, 2307, 40.9, 563, 205, 49, 817
mamason, 978, 57.8, 76, 122, 4, 202
MamboTango, 2067, 82.4, 1297, 1370, 140, 2807
mamody, 1454, 133.9, 50, 89, 9, 148
mamulian, 947, 63.6, 215, 503, 13, 731
ManasRam, 1581, 76.1, 29, 38, 2, 69
manavsaraf, 1328, 41.1, 2310, 3094, 154, 5558
manchesten, 1321, 34.8, 10139, 14315, 562, 25016
manciano, 1305, 84.0, 164, 159, 7, 330
mandalorian, 1213, 26.3, 1814, 3457, 45, 5316
mandarinate, 1903, 66.5, 56, 44, 6, 106
mandevil, 1821, 61.8, 30214, 16858, 2329, 49401
mandragora, 1538, 101.3, 2702, 2316, 255, 5273
mandre, 1749, 29.7, 5008, 4330, 706, 10044
manette, 1157, 62.7, 799, 864, 103, 1766
manferK, 1322, 73.8, 491, 273, 40, 804
manfredw, 1135, 40.8, 2182, 2608, 115, 4905
ManFromGreece, 1290, 37.9, 6298, 8772, 494, 15564
ManfromKharthoum, 1237, 38.8, 3695, 8671, 233, 12599
manfrommanila, 1174, 73.8, 208, 469, 17, 694
Mange, 818, 82.8, 442, 851, 29, 1322
Mangekyo, 1038, 148.4, 5, 7, 0, 12
Mangis, 1865, 21.9, 4388, 5298, 736, 10422
Manglis, 1757, 52.9, 2485, 2564, 238, 5287
Manhammer, 1261, 28.3, 190, 209, 2, 401
Manichaean, 1076, 55.1, 924, 2440, 96, 3460
manicwild, 1182, 108.4, 3609, 6143, 271, 10023
manin, 1275, 25.1, 1246, 2293, 100, 3639
maninoak, 1400, 41.9, 2187, 2822, 335, 5344
Manishsprasad, 1086, 91.8, 13, 96, 0, 109
mannuly, 1398, 119.4, 52, 31, 2, 85
manoguru, 1503, 32.7, 3175, 3684, 278, 7137
ManoICE, 1363, 39.5, 3547, 2770, 386, 6703
manojnlrchess, 1258, 137.1, 36, 37, 6, 79
manok, 1474, 117.4, 11, 79, 3, 93
manokm, 1472, 49.5, 846, 466, 88, 1400
manola, 1509, 54.4, 271, 491, 27, 789
ManOnHorse, 1410, 41.5, 2427, 1700, 265, 4392
manopla, 1462, 38.1, 1006, 1752, 96, 2854
manosv, 1119, 35.0, 152, 265, 6, 423
manriper, 1271, 31.0, 2239, 3464, 225, 5928
Mansperger, 972, 31.5, 527, 445, 36, 1008
Mantini, 1143, 43.5, 117, 123, 5, 245
mantrimas, 1292, 55.2, 145, 201, 26, 372
Mantux, 523, 194.9, 0, 18, 0, 18
manueljaca, 1203, 22.8, 434, 583, 38, 1055
manuginobilli, 1632, 120.4, 354, 203, 22, 579
manureva, 1457, 51.2, 278, 310, 16, 604
manurpatria, 1296, 23.1, 5305, 6538, 186, 12029
Manus, 1305, 45.4, 1751, 1635, 90, 3476
ManyaChess, 1665, 101.7, 27, 8, 1, 36
maoristyle, 922, 115.0, 109, 663, 16, 788
Mapache, 1301, 66.5, 1445, 1401, 162, 3008
Mapleleaf, 1329, 98.5, 677, 581, 42, 1300
maquiavelo, 1700, 88.0, 3202, 2809, 253, 6264
maranathayes, 1555, 111.8, 4504, 3581, 267, 8352
marbleschess, 1169, 51.5, 11795, 14736, 961, 27492
Marbous, 1209, 43.7, 460, 523, 34, 1017
marburgcedric, 1544, 38.8, 3022, 2940, 330, 6292
MarcBourbaki, 1952, 163.8, 23, 2, 0, 25
MarcChess, 1327, 91.8, 414, 387, 19, 820
MarcD, 1470, 37.0, 7697, 4150, 1042, 12889
Marcin, 1596, 43.3, 1815, 987, 67, 2869
marcohutters, 1135, 33.0, 1371, 2144, 210, 3725
marcomoreano, 965, 104.6, 32, 67, 1, 100
MaRcONiKoF, 1553, 150.8, 6, 3, 0, 9
marconipoc, 1410, 57.0, 1047, 1164, 77, 2288
MarcosC, 1339, 33.6, 1861, 3270, 224, 5355
marcosimona, 1150, 39.4, 237, 515, 6, 758
MARCOVALERIA, 1378, 110.8, 458, 400, 33, 891
MarcPistole, 1532, 16.0, 15521, 16329, 1591, 33441
marcstender, 1678, 28.8, 4832, 4864, 546, 10242
marcusantoinerome, 1224, 119.6, 252, 282, 29, 563
MarcusCrassus, 1911, 139.6, 25, 24, 9, 58
marcusem, 1760, 62.3, 489, 339, 24, 852
Marcusfj, 1165, 246.0, 36, 62, 6, 104
Marcym, 1105, 42.0, 200, 282, 20, 502
MarcYuki, 1415, 35.3, 3824, 4542, 704, 9070
mardymarr, 855, 107.9, 5, 31, 0, 36
margareta, 1185, 49.7, 586, 760, 25, 1371
margentin, 1262, 112.3, 475, 825, 34, 1334
MARGNO, 1651, 41.3, 214, 239, 29, 482
marianomocoroa, 1204, 104.1, 521, 531, 30, 1082
Maridad, 1121, 257.5, 0, 4, 0, 4
mariebicurie, 1229, 63.7, 1058, 1511, 55, 2624
marinaccleo, 1473, 69.7, 444, 293, 39, 776
marinkovic, 1654, 120.8, 2910, 4147, 267, 7324
MarinoP, 1439, 23.9, 7328, 7548, 567, 15443
marinushj, 1240, 82.0, 649, 719, 44, 1412
mariorx, 1651, 22.3, 4821, 2107, 397, 7325
mariosanchez, 1349, 32.9, 2279, 2368, 138, 4785
mariozavood, 1280, 117.5, 1214, 789, 110, 2113
MarioZupperyIndia, 1481, 75.3, 13, 26, 2, 41
mariuchu, 1510, 36.0, 3017, 1811, 201, 5029
marjankr, 1266, 37.7, 3216, 3271, 385, 6872
marjohn, 1933, 28.7, 3040, 2146, 253, 5439
markcola, 1347, 93.8, 406, 260, 17, 683
MarkG, 1715, 24.1, 16389, 16174, 1875, 34438
MARKHOT, 974, 234.1, 3, 8, 1, 12
markid, 1020, 101.1, 127, 209, 11, 347
MarkinLondon, 1213, 23.9, 3661, 4815, 276, 8752
markivkram, 1266, 37.5, 1382, 1586, 160, 3128
MARKLA, 1978, 78.2, 5856, 3655, 550, 10061
marklla, 1164, 28.8, 5219, 5676, 214, 11109
MarkMcGoldrick, 1224, 42.8, 7069, 10850, 911, 18830
markmcgregor, 1699, 21.3, 1068, 1171, 177, 2416
markoca, 1158, 100.5, 87, 158, 9, 254
markosss, 1597, 24.1, 26294, 22947, 1977, 51218
markoteam, 1357, 30.2, 4719, 4663, 356, 9738
markpastern, 1596, 27.6, 3079, 3945, 481, 7505
markpellepedersen, 1225, 55.1, 1405, 1785, 90, 3280
markpenrith, 1243, 71.6, 2543, 1614, 145, 4302
markronilodevera, 1467, 110.9, 142, 109, 4, 255
markup, 1119, 36.7, 676, 585, 38, 1299
markybruster, 1371, 34.4, 2556, 2646, 312, 5514
marlbo, 1262, 36.9, 1369, 1264, 134, 2767
MarleysKush, 1197, 182.4, 3, 5, 1, 9
marmotil, 1456, 26.8, 14468, 9026, 624, 24118
Marrecao, 1347, 24.6, 1108, 1434, 85, 2627
marro, 974, 36.8, 788, 1960, 59, 2807
Mars, 1999, 41.4, 902, 1363, 323, 2588
Marsel, 1370, 27.2, 8794, 9116, 922, 18832
marshallattack, 1832, 48.3, 1381, 1326, 137, 2844
Marshallman, 1360, 35.8, 4933, 4702, 317, 9952
MarsHats, 1000, 77.4, 1395, 2188, 114, 3697
MarsX, 1164, 119.2, 236, 279, 11, 526
Marthi, 1681, 80.0, 4017, 4702, 374, 9093
Marticus, 1122, 49.9, 606, 691, 36, 1333
martincheung, 1505, 44.2, 945, 721, 66, 1732
MartinDimitrov, 1276, 199.0, 2, 4, 0, 6
martingambit, 1455, 29.9, 532, 498, 27, 1057
MartinOE, 1378, 98.4, 510, 946, 55, 1511
martip, 1384, 29.2, 671, 577, 40, 1288
Martsiga, 1820, 39.9, 506, 639, 140, 1285
marttinenjussi, 1696, 67.5, 676, 766, 128, 1570
marttinenossi, 1303, 23.2, 4078, 4226, 239, 8543
marttiola, 1565, 70.8, 1309, 710, 93, 2112
MartyStokes, 1516, 24.2, 4618, 5156, 499, 10273
Maruchan, 886, 88.0, 57, 292, 12, 361
Marudan, 1672, 24.4, 5031, 4880, 438, 10349
MarvelousMH, 1241, 162.1, 42, 112, 4, 158
marwenlaxis, 1237, 72.0, 230, 292, 19, 541
marxell, 1458, 48.2, 2319, 2985, 262, 5566
marxyst, 1191, 42.8, 1052, 1052, 60, 2164
MARYROLL, 1245, 30.4, 1820, 2703, 195, 4718
Mashedcarrots, 1421, 58.3, 2608, 4277, 225, 7110
Masilinisa, 1501, 53.5, 2295, 1248, 186, 3729
Masker, 1260, 45.8, 3771, 4333, 154, 8258
masspri, 1821, 87.7, 240, 87, 4, 331
mastablastawutwut, 1389, 54.7, 254, 283, 32, 569
MasterAttacker, 1473, 30.4, 2147, 3151, 223, 5521
masterbaris, 1043, 103.5, 239, 203, 20, 462
MasterBelch, 1075, 98.6, 14, 40, 2, 56
Masterboy, 1462, 44.9, 519, 320, 39, 878
masterfaux, 1645, 24.8, 2316, 1166, 233, 3715
MasterGee, 1335, 91.4, 65, 62, 7, 134
MasterLevel, 1555, 34.9, 899, 878, 66, 1843
MasterMcLovin, 1826, 34.2, 582, 451, 100, 1133
MasterSliva, 1938, 44.3, 1726, 2134, 346, 4206
mastertakuan, 1679, 40.2, 125, 105, 8, 238
mastertan, 1770, 83.8, 729, 996, 50, 1775
masterwilliam, 1687, 28.3, 26710, 13669, 2186, 42565
masterwsdouglas, 964, 49.4, 188, 246, 7, 441
MasterXiangQi, 1636, 42.7, 6622, 3234, 562, 10418
masterzeto, 1088, 112.1, 6, 24, 0, 30
mastroGiorgio, 1675, 29.5, 874, 753, 82, 1709
mastrogiro, 1157, 53.1, 64, 144, 3, 211
Matan, 1604, 57.4, 1713, 1386, 142, 3241
matanzas, 1391, 37.1, 2554, 2995, 347, 5896
Matata, 1158, 24.9, 7598, 9541, 443, 17582
Matchh, 1226, 41.5, 1463, 1670, 199, 3332
matechecksyou, 1188, 50.9, 99, 247, 6, 352
matechito, 1173, 31.9, 768, 745, 34, 1547
mateinsixtyone, 1412, 41.6, 808, 487, 94, 1389
Mateist, 1462, 126.1, 25, 43, 3, 71
matejaque, 1043, 139.8, 5, 6, 0, 11
Matemax, 1292, 47.1, 141, 190, 11, 342
maten, 1446, 31.2, 1358, 1530, 190, 3078
Matenoma, 1424, 118.2, 146, 127, 7, 280
mater, 1953, 29.6, 28168, 10463, 2406, 41037
MaterAmabilis, 1187, 40.6, 781, 941, 44, 1766
materimatt, 1089, 57.2, 107, 178, 6, 291
mateushfa, 1300, 46.7, 1206, 498, 62, 1766
matfyzak, 1543, 52.4, 873, 570, 131, 1574
Mathdud, 1319, 87.7, 712, 1020, 78, 1810
mathemagic, 1546, 55.1, 185, 142, 18, 345
MathewRicky, 1410, 59.0, 1248, 1273, 100, 2621
MathewSimon, 1319, 26.7, 2665, 2718, 168, 5551
MathGenius, 1403, 63.8, 267, 335, 17, 619
mathiasamyh, 1477, 26.7, 607, 688, 50, 1345
MathLePain, 1548, 93.0, 579, 533, 59, 1171
MathMajor, 1280, 83.1, 377, 1249, 41, 1667
Mathom, 1413, 80.8, 580, 436, 33, 1049
matinghabit, 1459, 52.8, 346, 232, 18, 596
MatingRitual, 1591, 131.1, 59, 33, 3, 95
matmunkh, 1602, 93.3, 1337, 877, 89, 2303
matodolo, 779, 62.3, 47, 222, 2, 271
matpr, 1519, 33.3, 1185, 1452, 171, 2808
MatrixKruel, 1122, 25.8, 7505, 7223, 359, 15087
MattEhlinger, 854, 117.7, 45, 156, 4, 205
MattFerreri, 1284, 99.9, 111, 124, 10, 245
MattGross, 1451, 45.5, 6189, 7084, 900, 14173
Matthewsen, 1412, 55.4, 1078, 1137, 72, 2287
matthewthecat, 1842, 48.2, 363, 405, 32, 800
MattHorwitz, 1593, 40.4, 167, 74, 14, 255
MattieC, 1559, 37.3, 105, 57, 7, 169
Mattise, 1508, 180.4, 5, 2, 1, 8
mattkort, 1434, 108.2, 1862, 1427, 227, 3516
MattMattK, 1234, 115.8, 132, 152, 10, 294
mattos, 1709, 72.6, 921, 483, 71, 1475
mattsaleh, 839, 240.9, 0, 4, 0, 4
mattsson, 1357, 28.3, 4724, 6729, 421, 11874, 1154, 42.4, 1226, 1314, 164, 2704
Matwith, 1670, 100.7, 4396, 3827, 658, 8881
MaunaKeaMike, 1504, 21.5, 678, 320, 100, 1098, 1969, 23.2, 9355, 4408, 758, 14521
mauriecain, 894, 85.5, 10, 40, 1, 51
maurizietto, 1433, 33.7, 10721, 15146, 790, 26657
MaurusAP, 1280, 34.0, 1160, 1048, 76, 2284
mavonehr, 1599, 64.6, 9019, 4786, 952, 14757
mavr, 1435, 126.2, 575, 346, 66, 987
maxblackmax, 1054, 49.8, 21, 59, 2, 82
MaxCraft, 929, 77.7, 2310, 2913, 141, 5364
Maxerman, 1186, 77.6, 2451, 2786, 241, 5478
MaxEuwe, 1180, 43.8, 4838, 4133, 369, 9340
maxfly, 1076, 172.3, 973, 1005, 66, 2044
maxheap, 1115, 266.1, 1, 2, 0, 3
maximb, 1568, 24.1, 16690, 18015, 1577, 36282
MaximillionCzeski, 1247, 93.4, 742, 745, 35, 1522
Maximillius, 1099, 126.7, 230, 402, 12, 644
maximusgladus, 1246, 27.5, 3682, 5938, 124, 9744
maxiwellington, 1128, 51.3, 184, 207, 6, 397
maxkat, 990, 48.8, 5251, 6504, 509, 12264
maxmi, 1074, 35.1, 493, 792, 19, 1304
MaxMuster, 1258, 234.9, 0, 2, 0, 2
maxsamuel, 1446, 100.7, 1421, 1331, 54, 2806
MaxTheThird, 1684, 37.6, 156, 199, 23, 378
Maxyiver, 1301, 104.2, 769, 1282, 54, 2105
MAXZHANG, 1078, 51.5, 517, 514, 22, 1053
mayan, 1553, 350.0, 1, 3, 0, 4
Maye, 1785, 56.3, 3409, 3560, 348, 7317
Mayo, 1359, 94.0, 752, 596, 78, 1426
mayoche, 1335, 71.6, 1631, 638, 73, 2342
Mayte, 1464, 23.4, 9527, 6740, 418, 16685
mazaychess, 863, 47.9, 49, 96, 3, 148
mazenwrq, 777, 144.3, 7, 25, 0, 32
mazit, 1353, 65.8, 2981, 2978, 216, 6175
MAZL, 1052, 174.4, 46, 82, 2, 130
mazoula, 1143, 69.6, 390, 483, 53, 926
mbaoyone, 1519, 39.2, 1181, 3059, 131, 4371
mbat, 1671, 30.9, 1967, 2812, 220, 4999
mbiker, 1418, 45.6, 1711, 1296, 101, 3108
MBWin, 1455, 39.8, 81, 80, 7, 168
mcarlsen, 1391, 38.0, 1391, 1700, 62, 3153
mcdrewbie, 931, 45.1, 1098, 1174, 54, 2326
mcfizzle, 1338, 112.1, 2164, 2719, 257, 5140
McHaggis, 1384, 29.0, 4424, 5286, 385, 10095
mchaz, 1383, 26.9, 7342, 6432, 472, 14246
mcintudt, 1069, 129.7, 418, 540, 34, 992
McKelveyABG, 877, 155.4, 27, 107, 5, 139
mckhoops, 1826, 49.0, 3712, 5503, 467, 9682
mckx, 1515, 63.6, 751, 419, 63, 1233
mclagrange, 1234, 122.1, 745, 578, 54, 1377
MCMLXXXIII, 1143, 66.2, 1014, 731, 64, 1809
McMYK, 876, 89.4, 79, 176, 6, 261
mcnanimus, 1328, 147.6, 6, 5, 1, 12
Mcode, 1106, 121.0, 508, 632, 79, 1219
mcoimbra, 1342, 20.6, 5049, 7165, 829, 13043
mconst, 1272, 29.2, 6451, 3236, 521, 10208
mcorallo, 1798, 46.4, 328, 266, 23, 617
mcr, 1130, 105.0, 959, 1566, 69, 2594
McRoin, 840, 104.3, 2, 11, 1, 14
McShane, 1415, 81.9, 2493, 2366, 317, 5176
mcsquirrel, 1071, 105.4, 433, 702, 27, 1162
McTab, 1577, 61.5, 1621, 1702, 59, 3382
Mcteague, 1245, 41.3, 1380, 1520, 79, 2979
McVities, 1324, 58.7, 2550, 2432, 144, 5126
mcx, 1336, 110.1, 1493, 2199, 80, 3772
mdanseven, 1222, 30.3, 2256, 2828, 225, 5309
mdarcy, 1754, 39.9, 856, 525, 89, 1470
mdavidm, 1406, 53.3, 949, 760, 84, 1793
mDebsankha, 1314, 67.5, 128, 119, 17, 264
mdeleon, 1438, 26.4, 9130, 6915, 490, 16535
MDESTINY, 1333, 112.2, 480, 528, 34, 1042
MDLopez, 1490, 90.2, 739, 1175, 64, 1978
mdorff, 1551, 179.4, 1279, 2022, 99, 3400
meandclifford, 1573, 82.6, 9013, 8398, 801, 18212
mecews, 1529, 64.7, 5708, 4178, 104, 9990
mechess, 1452, 31.3, 439, 293, 42, 774
Mechtabenech, 1626, 28.1, 3522, 2075, 330, 5927
mecso, 1439, 56.3, 4454, 3209, 313, 7976
MediDog, 1111, 41.7, 814, 820, 33, 1667
mediocreman, 1163, 67.7, 116, 166, 10, 292
mediterraneanblue, 1075, 48.1, 456, 289, 38, 783
medowman, 1269, 54.4, 855, 1523, 75, 2453
medullah, 1130, 34.8, 111, 193, 11, 315
meetarora, 1710, 23.2, 7616, 7375, 668, 15659
meetgab, 1122, 21.7, 2814, 3819, 197, 6830
megacruncher, 965, 46.3, 809, 682, 59, 1550
megaluck, 1473, 83.0, 75, 68, 7, 150
meganerd, 769, 72.4, 13, 79, 3, 95
megracia, 2015, 55.7, 1595, 1130, 154, 2879
Mehkapet, 1071, 199.9, 266, 325, 16, 607
Mehmaan, 1279, 310.5, 0, 1, 0, 1, 1728, 50.4, 2131, 1900, 262, 4293
meijinmike, 1488, 26.0, 3933, 4652, 360, 8945
meire, 1353, 27.3, 13771, 17279, 906, 31956
meisme, 1042, 182.2, 157, 357, 12, 526
melaleuca, 783, 74.0, 8, 55, 1, 64
Melegin, 990, 39.6, 428, 621, 38, 1087
melita, 1492, 91.3, 11537, 15246, 508, 27291
Melkie, 1664, 101.0, 3053, 2476, 200, 5729
MellowFellow, 1029, 130.5, 146, 186, 9, 341
melmacmpf, 1285, 80.0, 719, 505, 96, 1320
Mels, 489, 146.6, 3, 55, 0, 58
melun, 1316, 186.9, 2, 4, 0, 6
melv, 858, 123.8, 231, 557, 14, 802
melvin, 1559, 37.2, 6551, 3402, 416, 10369
Melzi, 2011, 39.2, 9643, 6015, 951, 16609
mementum, 1047, 141.9, 29, 99, 7, 135
memplex, 1675, 26.8, 14323, 20228, 1745, 36296
menander, 1320, 118.6, 6, 8, 0, 14
menatwork, 1579, 64.2, 245, 320, 22, 587
MenesterZ, 1345, 23.8, 1004, 1355, 74, 2433
Mengkeshi, 936, 78.3, 60, 126, 1, 187
menhir, 1187, 35.2, 1572, 1061, 88, 2721
MeninoCoro, 1335, 30.1, 385, 683, 68, 1136
mentalGIANT, 1254, 64.8, 412, 486, 16, 914
mentalharakiri, 1068, 220.8, 2, 6, 0, 8
Mentallytough, 1202, 47.2, 145, 180, 13, 338
meoma, 1631, 43.1, 10070, 10488, 1661, 22219
meowman, 1294, 36.2, 731, 2108, 117, 2956
mepatzer, 1719, 63.0, 538, 578, 47, 1163
MephistosGambit, 1352, 75.7, 94, 134, 11, 239
MeranoTS, 1503, 112.6, 423, 408, 22, 853
mercdr, 1479, 100.6, 1061, 748, 88, 1897
Meriadeck, 1376, 44.1, 5355, 4246, 367, 9968
Merijntje, 1704, 168.5, 933, 623, 113, 1669
MERKAABA, 1950, 55.0, 2119, 1879, 169, 4167
merlinme, 1538, 47.2, 13265, 7544, 713, 21522
mermentau, 1285, 33.2, 1510, 1495, 187, 3192
meroramadan, 1176, 183.5, 9, 9, 1, 19
MerryMozart, 1075, 29.1, 151, 357, 8, 516
Merte, 1482, 41.4, 85, 62, 8, 155
meshki, 1602, 93.2, 812, 702, 41, 1555
Meshu, 1425, 25.1, 1003, 886, 63, 1952
meshugge, 1613, 72.1, 324, 351, 20, 695
meshunzhu, 1585, 103.1, 580, 1030, 54, 1664
mesiodens, 1210, 124.7, 18, 17, 4, 39
Mesmerino, 888, 120.8, 44, 88, 5, 137
Mesmerized, 1402, 33.0, 459, 1155, 67, 1681
messtomasses, 1261, 94.7, 376, 370, 23, 769
MestreRusso, 1545, 43.9, 1544, 1411, 62, 3017
mesw, 1389, 27.6, 684, 1543, 51, 2278
MetalGuru, 1612, 52.9, 572, 256, 68, 896
MetalHeadSG, 1038, 98.2, 140, 232, 10, 382
MeTaLinYaCellz, 1376, 29.1, 1496, 1369, 75, 2940
metalogic, 1840, 136.2, 37, 33, 0, 70
MeTaLoV, 1491, 53.5, 996, 1093, 91, 2180
MetalSean, 1111, 91.1, 522, 532, 29, 1083
metalshredder, 1512, 48.0, 2644, 1650, 155, 4449
metalwarriorT, 1854, 38.3, 1494, 1937, 343, 3774
metatrony, 2023, 28.5, 2284, 2039, 224, 4547
Meteorite, 1825, 24.6, 7666, 6428, 460, 14554
metonymyman, 1330, 38.7, 1250, 1562, 70, 2882
metoo, 1141, 103.0, 1852, 2870, 111, 4833
Metsis, 1380, 32.9, 3737, 5649, 594, 9980
meuhnon, 1420, 24.8, 9271, 8203, 1154, 18628
MeV, 1554, 44.6, 6982, 9517, 800, 17299
mexijo, 1212, 37.2, 460, 650, 27, 1137
Mexloco, 1575, 26.2, 2409, 2905, 237, 5551
mexplay, 1248, 43.7, 4581, 4788, 553, 9922
mexsig, 1789, 83.1, 8164, 4489, 686, 13339
meyerj, 1372, 105.0, 69, 53, 4, 126
mfap, 1588, 33.1, 6038, 6800, 529, 13367
MFChess, 913, 97.4, 14, 33, 0, 47
mferreira, 1638, 89.6, 77, 62, 8, 147
mfilkins, 1027, 49.2, 145, 439, 10, 594
mfjp, 1651, 57.4, 895, 691, 122, 1708
mfoolb, 1273, 34.5, 1031, 1761, 138, 2930
MFT, 1063, 49.2, 1786, 2300, 265, 4351
mgae, 1440, 128.7, 1127, 1193, 103, 2423
MGchess, 1489, 29.8, 623, 559, 46, 1228
MGCiro, 1402, 22.2, 5616, 4622, 181, 10419
MGolz, 930, 91.2, 417, 1176, 12, 1605
mgoutham, 1265, 37.0, 285, 245, 7, 537
mhara, 1443, 350.0, 8, 5, 2, 15
MHC, 811, 89.1, 3, 42, 1, 46
mhelshou, 1311, 26.5, 3942, 4975, 173, 9090
mhernando, 1469, 30.4, 4878, 4381, 500, 9759
miachouf, 1260, 40.1, 131, 125, 3, 259
miazga, 1747, 25.5, 5870, 5698, 462, 12030
micabe, 1847, 68.8, 2171, 1033, 148, 3352
micaiiah, 1437, 26.4, 1879, 1969, 178, 4026
Miceal, 1414, 27.1, 17181, 11635, 699, 29515
michaelcena, 1350, 30.2, 1053, 1041, 121, 2215
MichaelGoostree, 1069, 66.6, 172, 259, 10, 441
michaelmckernan, 1455, 29.2, 1813, 1697, 130, 3640
MichaelOlsson, 1225, 43.6, 2154, 1707, 143, 4004
Michaelpt, 1284, 49.9, 4920, 3487, 233, 8640
MichaelSwartz, 1156, 27.9, 782, 669, 37, 1488
MichaelYang, 1653, 110.8, 257, 262, 28, 547
MichaelYates, 845, 44.8, 23, 82, 2, 107
MichailovA, 1702, 75.3, 2016, 1885, 191, 4092
michelbayon, 793, 113.9, 107, 433, 11, 551
michessacademy, 1518, 69.0, 24, 41, 2, 67
michielsmissaert, 1404, 106.9, 4705, 4171, 615, 9491
michih, 1710, 42.1, 2160, 1191, 144, 3495
Michiwausfle, 1339, 65.3, 317, 181, 21, 519
MickeyyMouse, 1416, 35.4, 4490, 6116, 603, 11209
Mickle, 1080, 97.4, 29, 37, 1, 67
micra, 1432, 40.8, 3728, 2763, 347, 6838
microknight, 945, 31.0, 926, 1371, 48, 2345
MiCrooks, 1705, 46.1, 1842, 1002, 180, 3024
midamida, 985, 273.3, 0, 2, 0, 2
middk, 1379, 24.2, 48675, 30310, 6809, 85794
MidlandBigMac, 1668, 57.6, 16326, 2924, 469, 19719
Midnitewolf, 647, 171.1, 1, 14, 0, 15
Miggle, 1126, 39.4, 981, 1546, 57, 2584
MightyGilgamesh, 1479, 27.9, 2037, 2162, 186, 4385
mightyjc, 1485, 50.2, 484, 736, 206, 1426
mightyua, 1061, 39.5, 198, 324, 14, 536
migpac, 1118, 31.5, 700, 982, 50, 1732
miguelini, 1315, 43.7, 935, 1074, 91, 2100
miguelkarranza, 1358, 25.3, 10200, 12455, 1087, 23742
miguelvegar, 1168, 49.1, 80, 309, 21, 410
migut, 1706, 37.0, 2196, 1928, 82, 4206
Miha, 1835, 36.7, 11045, 13493, 2236, 26774
MihaelVeber, 1534, 109.1, 962, 857, 78, 1897
mihaRouk, 1400, 30.5, 5632, 7660, 689, 13981
mihck, 1524, 21.7, 1213, 1381, 136, 2730
mihircn, 1622, 61.8, 22, 36, 3, 61
mikajum, 1405, 68.5, 963, 562, 24, 1549
mikealfa, 1687, 41.7, 6280, 5681, 513, 12474
mikebaker, 1528, 127.5, 4, 5, 3, 12
mikechan, 1693, 45.3, 2866, 1162, 176, 4204
Mikeconqueror, 1205, 49.3, 643, 580, 53, 1276
MikeD, 1502, 29.6, 5126, 8322, 700, 14148
MikeDnyc, 909, 51.3, 89, 207, 3, 299
mikefour, 2408, 111.4, 859, 557, 59, 1475
MikeFrost, 1908, 55.8, 1107, 822, 97, 2026
mikegibson, 1180, 55.8, 3512, 4707, 303, 8522
MikeGNO, 1243, 100.8, 1470, 1544, 134, 3148
MikeHallinan, 1585, 28.9, 14014, 13319, 2048, 29381
MikeHarris, 1650, 43.7, 5049, 3025, 397, 8471
mikeid, 1524, 94.8, 1039, 678, 59, 1776
MikeJM, 1210, 71.5, 105, 24, 1, 130
mikekamrath, 1164, 94.9, 320, 421, 16, 757
Mikeke, 1610, 34.9, 17503, 8815, 1355, 27673
mikekegster, 1297, 111.8, 62, 80, 3, 145
MikeKelley, 1136, 137.2, 601, 620, 30, 1251
MikeNJ, 1849, 32.1, 9514, 8654, 917, 19085
MikeRLee, 832, 62.5, 34, 73, 4, 111
mikesocal, 1486, 26.5, 2481, 2604, 252, 5337
mikethirty, 1498, 134.8, 6, 1, 3, 10
Miketinac, 1544, 35.8, 1817, 908, 79, 2804
mikev, 1346, 46.8, 25982, 27744, 1750, 55476
mikewarden, 1221, 169.8, 3, 7, 0, 10
mikezc, 1154, 27.5, 4935, 8810, 756, 14501
mikezulu, 995, 269.1, 1, 5, 0, 6
mikgoncharov, 736, 85.7, 89, 398, 6, 493
Mikhael, 1941, 99.3, 10333, 3985, 1326, 15644
mikheilm, 1278, 122.9, 99, 151, 10, 260
Mikiasso, 1673, 38.0, 203, 188, 13, 404
mikkojairren, 1651, 43.9, 2141, 1818, 217, 4176
MikkoS, 1758, 133.5, 183, 188, 18, 389
mikot, 1408, 37.7, 1057, 1171, 74, 2302
milalooser, 1536, 33.2, 8605, 6275, 389, 15269
milbel, 1788, 31.8, 12412, 14826, 2086, 29324
milecker, 2140, 26.7, 1115, 612, 69, 1796
milidor, 1314, 79.3, 268, 546, 33, 847
milimil, 1192, 73.7, 613, 1585, 123, 2321
milkystarway, 1450, 75.6, 3569, 2800, 153, 6522
Millerology, 866, 214.6, 1, 3, 0, 4
millerw, 1330, 68.1, 872, 1164, 48, 2084
millettes, 1493, 22.6, 2270, 2470, 567, 5307
MILLIoNAIRRE, 1093, 82.9, 5, 39, 0, 44
MillwardS, 908, 53.6, 15, 38, 4, 57
MillzesChess, 1571, 110.3, 105, 81, 8, 194
milond, 1555, 52.4, 3089, 1114, 117, 4320
milonguero, 1228, 24.2, 4093, 4556, 262, 8911
Milorad, 1737, 22.4, 15822, 17836, 2937, 36595
milpat, 1455, 21.4, 7909, 6621, 427, 14957
MILTI, 978, 65.8, 20, 47, 4, 71
Miltie, 1894, 138.1, 10, 4, 0, 14
MilwaukeeKnight, 1230, 83.1, 1608, 2454, 142, 4204
mindacatur, 1732, 78.1, 544, 233, 51, 828
MindBrain, 1026, 269.4, 12, 15, 0, 27, 1410, 77.2, 1504, 1043, 115, 2662
mindfreak, 1031, 37.9, 3477, 6127, 355, 9959
mindlin, 1582, 49.8, 2350, 1411, 311, 4072
MindMuscleChess, 890, 143.6, 89, 546, 7, 642
mindpatrol, 1682, 333.4, 0, 1, 0, 1
MindShaker, 2228, 32.0, 343, 111, 11, 465
mindstormGP, 1158, 37.1, 213, 197, 26, 436
MiniKarpov, 1631, 37.9, 978, 319, 97, 1394
MiniKing, 1460, 78.6, 20, 20, 4, 44
minimal, 1603, 61.8, 4952, 4912, 433, 10297
minimi, 1091, 110.0, 185, 124, 7, 316
minimumphase, 1409, 76.1, 3859, 5505, 533, 9897
MiniRhino, 1550, 64.2, 312, 264, 22, 598
MinnesotaDude, 1198, 37.8, 1172, 1460, 95, 2727
minobara, 1231, 28.9, 10217, 7057, 1239, 18513
Minquasman, 1069, 131.2, 14, 17, 0, 31
minsf, 1390, 65.3, 2459, 1027, 57, 3543
mintakastar, 1171, 139.7, 10, 13, 0, 23
MinV, 1722, 66.2, 4325, 3816, 308, 8449
miomatteo, 1273, 28.4, 664, 1060, 55, 1779
MIQDAD, 1301, 57.4, 622, 662, 24, 1308
Mirasol, 1675, 95.5, 1727, 3015, 228, 4970
Mirigeganto, 1129, 65.6, 114, 247, 25, 386
mirobed, 1225, 35.1, 132, 221, 13, 366
MiroslavKomar, 1610, 33.2, 3024, 2219, 224, 5467
Mirzabekov, 1406, 129.2, 296, 494, 30, 820
Misendero, 1654, 26.8, 7460, 9674, 476, 17610
misharov, 1646, 79.2, 197, 302, 30, 529
mishmish, 1515, 25.1, 9550, 7613, 904, 18067
misomor, 1552, 28.0, 2169, 1923, 240, 4332
MissClaire, 1595, 117.6, 1458, 722, 90, 2270
MissionarySeven, 1931, 194.3, 5, 2, 0, 7
missrapher, 1016, 79.1, 145, 280, 11, 436
MissZ, 1261, 139.5, 1, 14, 3, 18
mistakeI, 1876, 81.1, 3257, 3135, 670, 7062
MisterBean, 1573, 31.1, 3444, 3358, 409, 7211
MisterBunny, 1619, 41.3, 3113, 1779, 214, 5106
mistercool, 1232, 132.2, 123, 138, 7, 268
misterd, 1430, 37.7, 12998, 11576, 1505, 26079
MisterFace, 1162, 77.9, 517, 663, 26, 1206
mistergrinch, 1194, 39.8, 438, 634, 37, 1109
Misterio, 1237, 34.1, 688, 735, 27, 1450
MisterPanda, 1399, 27.5, 5292, 3133, 356, 8781
MISTERSISTER, 1153, 51.3, 2170, 2366, 201, 4737
mitouja, 1288, 94.3, 675, 672, 75, 1422
Mittoch, 1341, 23.2, 4520, 3626, 170, 8316
mitulpatel, 1198, 81.8, 1236, 1709, 102, 3047
mitzo, 1217, 107.3, 1025, 871, 87, 1983
MIXNUT, 1158, 98.7, 609, 776, 33, 1418
miza, 799, 73.9, 19, 87, 0, 106
Mizzac, 988, 58.5, 159, 269, 6, 434
mjb, 1454, 73.8, 728, 818, 57, 1603
mjcmjc, 1279, 44.5, 2036, 3621, 246, 5903
mjctac, 1345, 35.2, 6552, 5872, 423, 12847
MJE, 2002, 29.4, 9881, 5541, 1103, 16525
mjesuele, 1558, 303.4, 0, 1, 0, 1
mjfadeaway, 928, 51.7, 18, 52, 2, 72
mjkamp, 983, 106.3, 107, 268, 12, 387
mjmonday, 1077, 37.7, 6583, 6109, 556, 13248
mjqxxxx, 1177, 93.3, 136, 124, 15, 275
MJSOS, 1515, 43.6, 3605, 3157, 339, 7101
MKAA, 990, 93.0, 627, 3028, 47, 3702
Mkaaud, 1596, 32.8, 5539, 5602, 513, 11654
mkaeppler, 1056, 38.8, 120, 153, 10, 283
mkazhar, 1181, 52.2, 293, 169, 15, 477
mkelem, 1575, 69.8, 8920, 4809, 894, 14623
mkerouch, 1415, 35.7, 1638, 2335, 257, 4230
MKiroff, 992, 116.1, 107, 146, 8, 261
mkirstein, 1084, 70.3, 796, 617, 43, 1456
mklaus, 1544, 63.8, 8133, 5696, 753, 14582
mknatz, 1436, 115.4, 391, 270, 32, 693
mkortt, 1205, 39.4, 808, 1662, 62, 2532
MKrump, 1140, 56.9, 275, 354, 19, 648
mkuhn, 1563, 39.1, 14440, 6650, 1085, 22175
mkultra, 1314, 98.8, 3360, 2395, 242, 5997
MKvetinka, 1539, 34.2, 4693, 3518, 405, 8616
MladenPokic, 1533, 31.3, 787, 573, 72, 1432
Mlasker, 1227, 107.9, 15, 22, 0, 37
mlaue, 1644, 28.3, 6944, 7697, 429, 15070
mlauzon, 1526, 55.0, 674, 369, 43, 1086
MLee, 1450, 59.3, 382, 624, 29, 1035
mloki, 2211, 223.3, 13, 0, 1, 14
mlt, 1417, 55.0, 948, 578, 93, 1619
mmalchow, 1068, 30.3, 747, 1390, 21, 2158
mmamak, 1877, 97.6, 7101, 8338, 789, 16228
mmario, 1149, 254.5, 1, 2, 0, 3
mmarius, 1017, 183.0, 36, 104, 3, 143
mmarkidan, 1471, 110.5, 489, 303, 43, 835
mmcckk, 1254, 74.7, 597, 496, 75, 1168
MMDD, 1208, 66.8, 178, 334, 19, 531
MMehmedov, 2039, 83.1, 2652, 2598, 263, 5513
mmfw, 1515, 30.2, 3206, 4045, 268, 7519
mmjme, 1510, 30.1, 7144, 7826, 700, 15670
mmoakster, 1113, 125.9, 593, 1135, 29, 1757
mmodine, 1112, 34.3, 464, 635, 35, 1134
mmorris, 1557, 47.8, 4432, 2756, 345, 7533
mmoustache, 1914, 32.3, 4997, 4154, 502, 9653
mmschess, 765, 82.8, 48, 242, 3, 293
MMSoares, 1464, 78.5, 908, 1024, 41, 1973
mmsyh, 1216, 71.4, 1133, 1476, 104, 2713
MMT, 1780, 115.0, 4584, 2965, 392, 7941
mmwatusay, 1163, 48.5, 608, 579, 52, 1239
mnb, 1279, 130.9, 3056, 2391, 266, 5713
mnchesschamp, 1041, 28.5, 1001, 912, 51, 1964
mnebrooks, 1130, 56.5, 161, 130, 10, 301
MNeuron, 1094, 39.6, 1128, 1022, 66, 2216
mnite, 754, 140.9, 0, 17, 0, 17
mnoit, 1565, 25.6, 415, 277, 27, 719
MOAM, 970, 67.7, 159, 302, 12, 473
moaraujo, 1465, 36.8, 526, 383, 40, 949
Moassy, 1670, 112.2, 385, 616, 61, 1062
mobarez, 1762, 81.6, 445, 463, 61, 969
mobilitybundle, 1857, 31.9, 439, 354, 28, 821
MobyDick, 1348, 53.2, 675, 1087, 108, 1870
mocoespinho, 1542, 46.9, 3944, 4059, 186, 8189
modargo, 1286, 122.2, 358, 314, 44, 716
modemcowboy, 1175, 60.5, 686, 726, 43, 1455
modepasse, 1250, 105.3, 986, 887, 29, 1902
modernmaverick, 1121, 90.6, 20, 36, 0, 56
Modo, 1186, 21.4, 7679, 10985, 481, 19145
modonohue, 1074, 39.6, 632, 576, 41, 1249
modtup, 1505, 124.0, 4, 16, 1, 21
moekick, 1660, 28.0, 131, 146, 9, 286
Moekid, 1301, 77.3, 68, 53, 1, 122
MoepsStakato, 1078, 119.5, 40, 79, 0, 119
Mofish, 1582, 25.6, 1780, 1495, 71, 3346
MogelFritz, 1433, 26.8, 6772, 7679, 473, 14924
Mogget, 1753, 25.3, 4188, 2652, 266, 7106
Moglito, 1234, 116.5, 1192, 1638, 118, 2948
mohala, 1179, 38.0, 991, 1732, 58, 2781
mohdk, 1217, 134.9, 2460, 2094, 169, 4723
MohdRafi, 1497, 56.7, 1686, 1139, 168, 2993
moisesito, 1206, 24.9, 2411, 3920, 190, 6521
mojiedy, 1246, 67.0, 280, 583, 33, 896
MojoMan, 1446, 32.5, 6629, 6298, 394, 13321
mojso, 1124, 98.5, 152, 337, 20, 509
mok, 2004, 52.2, 4215, 3714, 566, 8495
Mokhless, 1424, 40.9, 554, 910, 88, 1552
mokrton, 1650, 21.9, 692, 519, 57, 1268
Mokusio, 1469, 50.3, 361, 233, 47, 641
molayak, 1175, 72.4, 45, 54, 4, 103
Molepolole, 1279, 29.8, 4288, 4823, 524, 9635
molfa, 1763, 43.0, 7325, 6610, 777, 14712
molinov, 1591, 27.6, 734, 792, 101, 1627
moliugas, 1621, 35.2, 919, 935, 60, 1914
moloco, 1586, 29.7, 6401, 4335, 384, 11120
Moloka, 1140, 55.0, 189, 288, 15, 492
MolokoVelocet, 1271, 120.4, 479, 245, 35, 759
MoltenThinker, 2100, 157.1, 24, 15, 2, 41
MOMLASAM, 1245, 219.0, 0, 4, 0, 4
Momling, 1426, 68.3, 347, 353, 8, 708
momowins, 1553, 33.3, 2110, 1818, 239, 4167
Momsspaghetti, 1137, 80.6, 31, 37, 3, 71
monacan, 1505, 20.4, 44375, 40994, 2981, 88350
monad, 1360, 59.8, 515, 338, 15, 868
monderer, 1786, 63.3, 5134, 5526, 584, 11244
Mondoloni, 1141, 94.5, 7, 11, 1, 19
MongelliFerdinand, 1432, 31.1, 607, 814, 60, 1481
monies, 982, 35.1, 2289, 2267, 198, 4754
monjardin, 1248, 55.5, 154, 158, 16, 328
monkeydoodles, 1800, 34.6, 2646, 2124, 185, 4955
MonkeyGame, 1222, 22.7, 5877, 5438, 525, 11840
Monosthatos, 1886, 29.6, 3480, 3451, 772, 7703
Monothu, 1122, 37.8, 129, 378, 25, 532
monsieurbelanger, 1205, 45.8, 485, 567, 25, 1077
MonsterofLogchess, 1800, 30.7, 2363, 3313, 285, 5961
montae, 1357, 24.6, 3424, 2682, 163, 6269
montecortiger, 935, 31.3, 1029, 1528, 24, 2581
Monteria, 1788, 218.6, 12, 7, 0, 19
MontrealCorp, 1792, 43.2, 889, 846, 85, 1820
Montyn, 1184, 52.6, 54, 61, 0, 115
Monzta, 1042, 158.4, 3, 10, 0, 13
moogli, 1660, 32.6, 8388, 4929, 334, 13651
Mooloo, 1928, 26.2, 3669, 4099, 602, 8370
MoonCat, 1023, 61.7, 1421, 1001, 93, 2515
mooncity, 2121, 47.8, 1515, 1015, 189, 2719
moonloop, 1611, 32.5, 5896, 2662, 471, 9029
MoonVine, 1267, 23.5, 2162, 3132, 130, 5424
mooseheadchris, 1645, 28.1, 12206, 7772, 1215, 21193
mopsey, 1495, 64.8, 1450, 982, 97, 2529
mopuma, 1277, 31.3, 5279, 5725, 270, 11274
Morassutti, 1150, 135.4, 209, 221, 15, 445
mordaz, 1437, 34.6, 12120, 9072, 712, 21904
Mordent, 1094, 63.2, 2125, 3085, 188, 5398
mordorin, 1348, 34.4, 3045, 3008, 90, 6143
morebeer, 1481, 30.5, 3133, 3003, 442, 6578
morenor, 1053, 52.2, 133, 149, 12, 294
MoreThanAI, 1640, 34.9, 1900, 1350, 227, 3477
morganlepirate, 1723, 105.0, 912, 599, 105, 1616
MORGANTE, 1107, 30.5, 9542, 19518, 570, 29630
Morikal, 1169, 87.7, 720, 1005, 64, 1789
Morinter, 1699, 153.4, 3277, 3559, 346, 7182
morkmindy, 1311, 162.2, 73, 46, 3, 122
morphdude, 1665, 224.4, 489, 389, 42, 920
Morphie, 1416, 28.7, 4880, 5250, 533, 10663
Morphium, 1156, 50.2, 195, 199, 23, 417
morphology, 1368, 31.5, 884, 1063, 92, 2039
Morphyer, 1219, 26.7, 658, 1008, 53, 1719
MorphyLives, 1555, 77.8, 5247, 4383, 819, 10449
MorphySwede, 1476, 41.4, 2804, 2655, 181, 5640
morsa, 1826, 117.8, 493, 365, 54, 912
morsalin, 1093, 154.5, 2, 5, 0, 7
Mortalnut, 1182, 24.2, 174, 370, 38, 582
Morteza, 1861, 29.0, 6975, 6688, 655, 14318
morts, 1062, 22.3, 15917, 18658, 987, 35562
Morvan, 1201, 31.1, 4425, 8262, 510, 13197
Moscarda, 1384, 22.8, 408, 415, 18, 841
MOshadow, 934, 167.1, 1, 38, 0, 39
moshest, 1126, 24.8, 3226, 6442, 222, 9890
moshiach, 1422, 336.6, 0, 1, 0, 1
mosinnagant, 1270, 46.4, 221, 262, 14, 497
moskh, 1138, 71.4, 6, 74, 2, 82
Mossi, 1306, 59.2, 31, 36, 5, 72
mosslegend, 1671, 22.3, 1690, 2547, 157, 4394
mostro, 1275, 58.3, 1466, 1682, 170, 3318
motacilla, 1327, 39.4, 726, 848, 52, 1626
motcheky, 1098, 120.1, 895, 2758, 36, 3689
Motifers, 1130, 100.7, 459, 344, 21, 824
motorfot, 1366, 26.7, 1713, 1659, 73, 3445
MoTownMoney, 832, 55.6, 40, 70, 1, 111
MountainGuy, 1217, 47.4, 1944, 1715, 120, 3779
Mountainwalk, 1409, 220.3, 3, 4, 0, 7
MouseMan, 1480, 29.6, 5101, 7697, 495, 13293
mouttoren, 1091, 80.9, 788, 2169, 53, 3010
mowngrass, 1187, 38.7, 1308, 2222, 82, 3612
Mozilla, 1183, 34.2, 2205, 2214, 151, 4570
mpohoritis, 1292, 41.2, 2509, 1710, 185, 4404
mpompos, 1166, 66.8, 528, 525, 34, 1087
MPU, 1978, 59.7, 3655, 2266, 264, 6185
mpython, 1221, 26.6, 314, 295, 32, 641
mraml, 1542, 92.6, 1955, 1990, 295, 4240
mrashid, 870, 99.9, 56, 233, 4, 293
MRBarupal, 1020, 22.9, 696, 948, 28, 1672
mrbeaujolais, 1365, 33.7, 9316, 13111, 1287, 23714
MRBOGAN, 1463, 31.5, 2951, 3205, 181, 6337
mrbojceski, 1287, 211.4, 3, 2, 0, 5
MrBravo, 957, 35.1, 192, 733, 21, 946
MrBrooks, 1253, 114.4, 2761, 2996, 186, 5943, 1930, 37.6, 10957, 6225, 787, 17969
MrCakes, 1670, 49.4, 1814, 1451, 200, 3465
mrcdog, 1612, 133.8, 3882, 2411, 346, 6639
MrCftr, 1365, 34.6, 818, 2436, 121, 3375
MrCharles, 980, 118.1, 1, 17, 0, 18
MrCheckmate, 1875, 125.0, 1319, 1188, 294, 2801
mrcheekz, 1527, 36.0, 664, 845, 34, 1543
MrCooke, 1180, 106.0, 655, 803, 48, 1506
MrCurly, 1380, 32.4, 1029, 958, 183, 2170
MrDavidn, 547, 169.2, 0, 15, 0, 15
mrdeadserious, 1522, 25.8, 4202, 3365, 643, 8210
MrDiabolical, 1140, 25.5, 3638, 4613, 381, 8632
mrdigital, 963, 48.3, 883, 1543, 71, 2497
mrdoom, 945, 109.2, 10, 30, 1, 41
mrdubbs, 1183, 50.8, 286, 474, 25, 785
MrFinn, 1312, 58.7, 2422, 2640, 193, 5255
MrFish, 1354, 60.1, 7868, 5715, 632, 14215
MrFlapjack, 1689, 50.0, 2172, 304, 66, 2542
MrFlounder, 1326, 32.9, 191, 212, 15, 418
MrGambitMan, 1325, 48.4, 594, 397, 44, 1035
MrGandale, 934, 183.5, 4, 11, 0, 15
Mrgaw, 1032, 57.6, 224, 217, 13, 454
MrGeg, 1231, 80.1, 76, 79, 6, 161
mrgomm, 1288, 38.9, 5308, 5196, 278, 10782
MrGoshawk, 786, 168.3, 28, 78, 6, 112
MRGREN, 1434, 92.6, 731, 828, 34, 1593
MRHaeroE, 917, 84.5, 61, 219, 2, 282
mrhamid, 1136, 34.4, 737, 1737, 105, 2579
Mrhamster, 867, 79.7, 95, 145, 17, 257
mrhilger, 1058, 51.5, 1738, 2255, 66, 4059
MrImmer, 1079, 39.3, 670, 1195, 29, 1894
MrJunky, 1198, 83.9, 1649, 2775, 202, 4626
MrKenG, 914, 116.5, 28, 92, 0, 120
mrknightly, 1316, 30.8, 11911, 8958, 898, 21767
MRKumar, 1306, 98.2, 18931, 13385, 834, 33150
MrLatvian, 1458, 52.9, 1361, 1187, 182, 2730
mrlighting, 1118, 139.9, 41, 43, 3, 87
mrmarcusd, 1171, 72.9, 547, 549, 51, 1147
MrMauney, 1155, 114.5, 864, 757, 52, 1673
MrMayhem, 1532, 31.3, 10516, 9342, 1124, 20982
MrMessUp, 1005, 82.3, 15, 46, 2, 63
mrmilano, 1748, 36.1, 224, 259, 26, 509
MRMO, 1082, 134.9, 14, 24, 0, 38
MrMyogi, 1058, 117.3, 466, 796, 22, 1284
MrNate, 1282, 55.8, 1522, 1382, 140, 3044
MrOaiki, 862, 113.9, 20, 96, 0, 116
MRobson, 1030, 81.7, 727, 1260, 37, 2024
mroche, 1207, 18.2, 3061, 3681, 290, 7032
MrOsito, 928, 34.4, 221, 507, 6, 734
mrow, 1935, 245.0, 3, 0, 1, 4
MrPianoMan, 669, 179.3, 1, 18, 0, 19
MrRasa, 1201, 76.6, 587, 606, 35, 1228
mrrizzo, 1531, 26.5, 10540, 14476, 799, 25815
mrrunner, 1229, 76.2, 147, 157, 11, 315
MrSchneider, 1400, 34.0, 931, 806, 45, 1782
MrsGrandMaster, 1024, 67.3, 33, 78, 0, 111
MrShankleee, 1426, 61.4, 374, 275, 18, 667
MrSmilingNarwhal, 805, 85.6, 13, 161, 0, 174
MrSmth, 1364, 50.6, 247, 269, 23, 539
MrSnrub, 1626, 33.8, 1256, 1563, 101, 2920
MrSocrates, 865, 93.0, 12, 75, 0, 87
MrSquid, 1541, 30.9, 5478, 4667, 863, 11008
MrStahle, 1123, 31.6, 731, 1250, 45, 2026
MrTHoward, 1404, 61.7, 144, 134, 14, 292
MrTimm, 1022, 35.4, 782, 845, 54, 1681
mrtnwebs, 1108, 71.2, 18, 20, 1, 39
mrtuple, 1074, 65.5, 495, 442, 33, 970
mrtwola, 1042, 95.2, 896, 968, 51, 1915
MrUbiquitous, 1273, 21.9, 1332, 1520, 118, 2970
mrumrill, 1504, 27.9, 929, 634, 71, 1634, 1625, 28.0, 9446, 7476, 840, 17762
MrWiggly, 1388, 68.3, 717, 1029, 87, 1833
mrwonkabar, 1398, 44.7, 7180, 8431, 451, 16062
MRZWISCHENZUG, 1488, 26.2, 8298, 9925, 639, 18862
msalman, 1630, 261.0, 1, 1, 0, 2
msalzge, 1213, 41.6, 1166, 988, 107, 2261
msampson, 1267, 134.1, 270, 305, 29, 604
mschaos, 598, 85.2, 100, 408, 7, 515
mschwartz, 1778, 45.1, 1126, 651, 117, 1894
mscpython, 1591, 51.1, 2233, 2194, 230, 4657
MsCrabtree, 1516, 100.4, 3493, 3577, 340, 7410
MsD, 1690, 44.1, 35194, 5912, 1148, 42254
MSEGOND, 1133, 119.4, 73, 94, 6, 173
msgenao, 1247, 54.9, 1491, 1406, 89, 2986
msheaf, 1758, 50.2, 5256, 4116, 638, 10010
mslmts, 1493, 38.1, 2753, 3500, 271, 6524
mssriram, 1382, 111.8, 2375, 1757, 141, 4273
mstefa, 1594, 61.4, 1409, 1249, 131, 2789
msundman, 1338, 34.4, 2698, 2984, 195, 5877
mszvacant, 1384, 56.1, 2375, 2809, 149, 5333
mtakeda, 1335, 86.1, 76, 90, 15, 181
mtatewaki, 1831, 30.1, 2655, 4788, 735, 8178
MTeinert, 1424, 33.0, 5640, 8026, 325, 13991
MTGreen, 1260, 40.8, 5885, 4885, 345, 11115
mthanakit, 1754, 70.7, 111, 64, 11, 186
mtibuk, 1243, 113.7, 25, 42, 6, 73
mtoom, 1530, 36.6, 5729, 6934, 386, 13049
mtotomwafrika, 1621, 30.4, 1229, 1079, 88, 2396
mtowngrizz, 825, 158.6, 3, 23, 1, 27
MtTabor, 1522, 43.5, 1910, 1082, 115, 3107
mtUA, 1469, 37.1, 2250, 2787, 252, 5289
muaadh, 1234, 60.2, 181, 209, 9, 399
Muab, 1107, 52.7, 32, 35, 1, 68
MuadDib, 1394, 41.0, 524, 503, 34, 1061
MuchoMacho, 1507, 42.8, 131, 179, 16, 326
muckermaker, 1232, 30.5, 1515, 1353, 124, 2992
mudEguy, 1283, 116.1, 1206, 1432, 118, 2756
mudobber, 1351, 81.6, 7670, 8007, 514, 16191
Muflaj, 1314, 35.4, 1456, 1827, 86, 3369
muflon, 1075, 79.4, 299, 474, 12, 785
mugger, 1289, 24.1, 8903, 8873, 1013, 18789
Muggur, 1524, 59.6, 628, 541, 112, 1281
mughalstate, 1539, 37.8, 1539, 1889, 142, 3570
Muizenberg, 1349, 32.1, 3495, 2775, 307, 6577
Mukidi, 1185, 40.5, 329, 286, 13, 628
Muksia, 1737, 32.1, 1473, 1469, 176, 3118
mukund, 1371, 81.1, 3257, 3232, 187, 6676
multilis, 1370, 24.2, 1458, 1420, 128, 3006
mumbaII, 1305, 28.9, 5411, 4923, 429, 10763
MummyTummy, 944, 44.8, 25, 54, 5, 84
munchhauzen, 1947, 48.3, 43, 35, 1, 79
munnu, 1096, 29.9, 211, 207, 16, 434
muralit, 1373, 71.9, 3825, 1764, 211, 5800
murka, 1107, 70.5, 2997, 5298, 197, 8492
Murx, 1353, 40.4, 665, 539, 28, 1232
muscimolo, 1166, 32.5, 2778, 6323, 243, 9344
mushkardin, 1443, 84.8, 1624, 1776, 132, 3532
music, 1279, 32.0, 6286, 10176, 431, 16893
muslimegy, 1145, 193.8, 1, 3, 0, 4
musmus, 1585, 34.5, 791, 1062, 47, 1900
musot, 1750, 41.0, 3322, 3371, 367, 7060
MusRam, 1273, 74.9, 438, 477, 13, 928
Mussklprozz, 1585, 30.0, 13965, 7077, 1346, 22388
must, 1326, 31.3, 5705, 9533, 620, 15858
mustafashawi, 1453, 51.3, 173, 292, 19, 484
musya, 1414, 25.8, 928, 607, 16, 1551
mutantja, 1491, 34.9, 88, 49, 8, 145
muwwatalli, 1811, 28.6, 1908, 3178, 258, 5344
MUYAK, 1454, 35.4, 619, 458, 55, 1132
mvharrin, 894, 53.1, 91, 167, 5, 263
MVOperaGhost, 991, 212.0, 3, 18, 0, 21
mvquatorze, 1286, 59.9, 1611, 1209, 145, 2965
mvrbaski, 1394, 29.5, 4379, 6280, 494, 11153
mwael, 717, 122.3, 0, 43, 0, 43
mwchess, 1164, 40.0, 119, 192, 15, 326
mwdwhd, 652, 104.1, 64, 267, 8, 339
mweier, 861, 168.4, 52, 116, 3, 171
mwhesq, 1342, 32.8, 2798, 2722, 156, 5676
mwslet, 1245, 37.3, 303, 986, 45, 1334
mwt, 1748, 29.1, 5893, 5572, 918, 12383
mxmobbs, 925, 115.6, 5, 13, 3, 21
MXracer, 1235, 46.8, 626, 350, 27, 1003
MyBirds, 1299, 114.2, 1402, 1366, 67, 2835
MYCAT, 1382, 29.1, 4972, 6566, 345, 11883
mychyo, 1391, 28.9, 8026, 7700, 579, 16305
MyCrew, 1313, 28.3, 4100, 4908, 301, 9309
mydogeatschessmen, 1333, 64.1, 111, 131, 14, 256
MyFriendTal, 1309, 93.4, 460, 576, 31, 1067
mygooddogbobo, 1471, 22.9, 1094, 834, 65, 1993
Myhasker, 816, 171.1, 11, 18, 4, 33
Mykadlo, 1445, 49.4, 3480, 2911, 231, 6622
mykidsdad, 1252, 113.8, 696, 820, 68, 1584
myldone, 1557, 52.6, 1812, 1918, 172, 3902
mylittlepawn, 1060, 37.1, 418, 778, 17, 1213
Mylo, 1326, 22.9, 322, 476, 24, 822
myls, 1301, 63.3, 459, 346, 40, 845
MyNameIsLegion, 1584, 26.8, 7625, 4900, 291, 12816
mynameismazin, 1365, 25.8, 3064, 3717, 221, 7002
Mysticmouse, 1414, 63.6, 75, 83, 11, 169
mzr, 1015, 68.2, 1045, 655, 37, 1737
nabface, 1156, 49.5, 142, 251, 11, 404
Nacaf, 1526, 34.5, 7210, 6633, 834, 14677
nadirzazueta, 1609, 49.5, 907, 798, 56, 1761
Nafets, 1413, 37.4, 5003, 3156, 315, 8474
nagavenimurthy, 1061, 157.0, 1, 6, 0, 7
NagazakiOkimura, 1765, 29.7, 3911, 5453, 576, 9940
Nagorb, 1107, 109.8, 25, 47, 3, 75
NAGPURINDIA, 1035, 77.5, 78, 101, 12, 191
nah, 1905, 118.9, 1617, 1447, 188, 3252
nahuel, 1297, 43.2, 2059, 2447, 122, 4628
Naixy, 1464, 30.5, 241, 247, 42, 530
najdorf, 1886, 32.2, 9148, 4672, 726, 14546
Najdorff, 1253, 26.5, 1884, 2255, 182, 4321
nakamuh, 1424, 59.8, 869, 666, 73, 1608
nakazanie, 965, 112.6, 197, 248, 19, 464
NakedNous, 1640, 45.5, 3597, 6260, 350, 10207
nakita, 1514, 39.3, 13292, 6533, 870, 20695
NakoSonorense, 1585, 28.7, 2378, 3002, 217, 5597
nalder, 1492, 34.5, 1444, 863, 124, 2431
naleon, 895, 53.0, 62, 281, 2, 345
nallalambazar, 555, 111.2, 0, 36, 0, 36
namanagrawal, 996, 33.6, 200, 257, 16, 473
nameloek, 1528, 23.8, 39411, 30260, 2501, 72172
namiche, 1353, 29.3, 8649, 11676, 1422, 21747
namida, 1005, 173.6, 4, 8, 0, 12
Namocich, 1090, 45.6, 1788, 3417, 128, 5333
nanard, 1529, 43.7, 1557, 866, 77, 2500
Nanchez, 1179, 85.3, 316, 291, 28, 635
nanebe, 1546, 34.8, 5228, 5420, 853, 11501
nanee, 1563, 29.7, 111, 187, 15, 313
naomi, 1460, 20.9, 39817, 47450, 4831, 92098
NapaDoc, 1231, 35.5, 505, 1000, 72, 1577
narag, 1119, 88.2, 352, 366, 26, 744
Narangdhawal, 1215, 74.8, 840, 1065, 48, 1953
naru, 975, 89.6, 93, 146, 9, 248
narutoril, 731, 63.5, 27, 92, 2, 121
narziss, 1380, 53.1, 12482, 15349, 793, 28624
naserkhan, 914, 44.3, 61, 9519, 57, 9637
Nathaniel, 1490, 168.5, 497, 467, 52, 1016
nathshar, 1404, 48.9, 210, 215, 26, 451
Natidor, 1125, 350.0, 0, 1, 0, 1
natrang, 1652, 41.0, 489, 827, 81, 1397
nattylight, 1459, 26.5, 1038, 1182, 81, 2301
naturopath, 1372, 26.7, 2053, 2131, 164, 4348
Nauliar, 1215, 69.2, 36, 49, 1, 86
navak, 1408, 41.1, 481, 696, 54, 1231
navan, 1887, 45.2, 17521, 7072, 1786, 26379
navdove, 968, 54.1, 315, 815, 34, 1164
naveenchess, 1228, 234.8, 2, 2, 0, 4
navgas, 1430, 34.7, 3097, 1654, 243, 4994
navraj, 1134, 38.5, 165, 382, 19, 566
Navu, 1347, 69.6, 655, 524, 20, 1199
Navyplayer, 1280, 101.1, 1461, 1283, 50, 2794
Nbella, 801, 24.8, 2275, 3661, 49, 5985
nbookman, 986, 51.8, 118, 156, 6, 280
NBZ, 1769, 67.4, 2685, 2302, 262, 5249
NCbuckeye, 979, 31.7, 192, 284, 30, 506
ndessai, 1341, 42.1, 1530, 1992, 96, 3618
NDIA, 816, 160.2, 4, 19, 0, 23
ndpq, 1087, 344.9, 0, 1, 0, 1
ndrwgn, 1477, 90.7, 1753, 2170, 77, 4000
ndsoji, 929, 187.1, 20, 77, 1, 98
neandertal, 1489, 28.2, 3015, 2493, 207, 5715
neanderthal, 1529, 60.4, 2742, 363, 65, 3170
Nebberz, 1535, 52.6, 2928, 1714, 226, 4868
NeboGajic, 1279, 47.7, 361, 387, 41, 789
NECKLACE, 1236, 186.9, 436, 589, 30, 1055
Necro, 1529, 27.2, 7426, 6792, 461, 14679
NedKellyLives, 1306, 30.1, 2957, 3417, 302, 6676
neelpatel, 1202, 58.5, 661, 816, 52, 1529
neenjah, 1001, 112.2, 29, 51, 1, 81
neev, 1505, 30.2, 798, 461, 37, 1296
nefen, 1479, 117.0, 180, 170, 15, 365
Nefski, 1725, 67.0, 2620, 2318, 253, 5191
negao, 1520, 25.5, 14591, 13623, 1159, 29373
NeightPthree, 1323, 72.6, 443, 370, 47, 860
neilgupta, 1083, 54.7, 338, 905, 12, 1255
neixfle, 1878, 51.7, 858, 1080, 157, 2095
Nelanie, 1504, 19.3, 9389, 11840, 668, 21897
nelg, 1531, 49.5, 51, 45, 2, 98
nelpiantao, 1249, 41.2, 1373, 2724, 102, 4199
Neminis, 1420, 48.4, 1380, 470, 128, 1978
Nemo, 1896, 31.0, 15915, 18220, 2226, 36361
nemotyro, 1290, 29.5, 1330, 1661, 165, 3156
Nene, 1079, 63.4, 2993, 3758, 210, 6961
neonlight, 1364, 131.7, 410, 377, 24, 811
neontetra, 1658, 32.4, 5193, 3050, 364, 8607
neotrick, 1125, 143.1, 20, 47, 7, 74
nepekeover, 1427, 35.4, 2457, 2504, 170, 5131
nepossiver, 1552, 21.4, 9414, 8313, 869, 18596
Nerazat, 1188, 23.5, 1485, 1589, 80, 3154
nerdlinger, 1251, 35.4, 1136, 1018, 117, 2271
neretva, 1360, 35.6, 7359, 7523, 376, 15258
neropero, 1596, 29.5, 290, 142, 22, 454
neselov, 1493, 22.2, 21368, 11185, 1144, 33697
netanava, 1595, 34.1, 2332, 2272, 222, 4826
NetBear, 1002, 118.1, 1078, 1818, 123, 3019
NetChessMonster, 1462, 121.7, 40, 15, 0, 55
netder, 1766, 41.5, 5489, 4100, 432, 10021
Netontuzo, 1022, 112.6, 80, 168, 4, 252
netoz, 1349, 30.3, 5237, 9124, 345, 14706
nettlesome, 1392, 54.1, 930, 908, 141, 1979
neulasta, 1072, 35.5, 2207, 3190, 138, 5535
neuphillyman, 1729, 193.6, 958, 474, 64, 1496
Neuronius, 1198, 29.3, 1643, 2610, 56, 4309
neutronbomb, 1411, 24.6, 150, 187, 19, 356
neuwerk, 1131, 39.0, 193, 183, 17, 393
Nevans, 816, 96.1, 12, 42, 1, 55
nevawin, 1426, 76.8, 4318, 4192, 316, 8826
neverevergiveup, 980, 117.8, 18, 56, 1, 75
NEVERSTRAXLER, 1927, 85.7, 388, 249, 56, 693
Neverton, 1428, 148.0, 4, 3, 1, 8
NevetsReg, 1207, 23.6, 11197, 8497, 868, 20562
nevidljivi, 1990, 29.6, 5020, 1705, 450, 7175
Nevito, 996, 46.1, 2053, 2529, 134, 4716
NEVORTU, 1565, 43.5, 2334, 2389, 332, 5055
newar, 945, 301.8, 4, 12, 2, 18
NewBalance, 492, 135.4, 3, 127, 1, 131
NewbieOfDoom, 1412, 99.6, 12, 15, 1, 28
newblank, 1150, 28.0, 11706, 13084, 1286, 26076
NewcastleFan, 885, 128.4, 1, 10, 1, 12
NewChessPlyr, 1107, 142.0, 15, 36, 0, 51
newdeem, 1707, 34.8, 538, 857, 72, 1467
newfisher, 2007, 289.7, 25, 28, 3, 56
NEWFOUNDGLORY, 1728, 134.3, 311, 170, 21, 502
newfoundlander, 1122, 95.1, 411, 638, 22, 1071
newhandle, 1260, 36.9, 3084, 3191, 245, 6520
Newintown, 1387, 17.7, 23035, 24636, 4092, 51763
newmove, 1567, 25.6, 6789, 7620, 593, 15002
newtodis, 915, 114.4, 78, 180, 4, 262
NewtonsLaws, 877, 84.2, 40, 99, 3, 142
NewTreeNo, 1469, 32.4, 3811, 5589, 276, 9676
newtry, 1557, 98.7, 6, 12, 0, 18
NewTwoChess, 888, 40.2, 130, 354, 9, 493
NewWaves, 1618, 35.0, 231, 378, 40, 649
nexin, 1184, 28.2, 10849, 10961, 1117, 22927
nextmime, 1006, 49.9, 193, 397, 23, 613
NextToU, 1375, 85.6, 222, 171, 17, 410
nexuver, 1109, 32.1, 367, 547, 20, 934
Neztop, 1094, 83.4, 444, 726, 13, 1183
nfazli, 1237, 37.2, 1098, 990, 76, 2164
nflmusicmaster, 1422, 69.9, 474, 533, 57, 1064
NforksQ, 1169, 34.6, 67, 67, 3, 137
Ngjens, 1337, 84.6, 121, 80, 13, 214
Ngotho, 1314, 49.8, 1172, 1466, 118, 2756
ngptmat, 1222, 29.8, 4058, 5663, 277, 9998
Nguburingi, 1097, 55.4, 223, 251, 12, 486
NGuerithault, 1303, 57.4, 587, 530, 47, 1164
NHariP, 1193, 36.1, 1151, 1147, 74, 2372
NHentschel, 1279, 42.6, 1007, 814, 75, 1896
nhoinla, 1258, 115.1, 288, 249, 23, 560
Niak, 1674, 29.7, 4184, 2490, 266, 6940
nibrumax, 1159, 88.3, 108, 240, 6, 354
Niburr, 1103, 37.2, 166, 224, 13, 403
nicelio, 935, 128.6, 67, 131, 9, 207
Nicfillion, 1512, 60.0, 3789, 1039, 144, 4972
nichelcromo, 1001, 28.8, 3729, 5046, 403, 9178
nicholasjanssen, 1027, 40.3, 454, 468, 26, 948
nichtswissender, 1773, 32.1, 2087, 1358, 175, 3620
NickeJ, 1681, 26.9, 48270, 29140, 3900, 81310
nickering, 921, 110.8, 72, 142, 2, 216
NickIvanov, 1459, 36.6, 2854, 1998, 249, 5101
nickolasnikolic, 1375, 80.4, 266, 215, 11, 492
Nickolov, 1334, 40.6, 989, 703, 66, 1758
nickon, 991, 84.3, 52, 72, 6, 130
NickParker, 932, 127.9, 78, 317, 4, 399
NickRang, 1314, 27.9, 7027, 6220, 830, 14077
Nicocat, 1710, 38.2, 625, 523, 48, 1196
NicolasLegrand, 985, 102.0, 63, 106, 4, 173
niculina, 1361, 98.5, 421, 435, 47, 903
nicuovi, 1616, 111.4, 401, 258, 45, 704
nidibou, 1363, 29.9, 2229, 4288, 257, 6774
Niederbachem, 1208, 83.1, 3104, 3853, 413, 7370
niff, 1369, 36.3, 787, 857, 81, 1725
nigach, 1504, 35.7, 3727, 1046, 163, 4936
nigeld, 1243, 34.5, 1806, 3881, 232, 5919
Nightbane, 1039, 102.0, 1, 12, 0, 13
NightFischer, 1044, 87.9, 8, 16, 1, 25
NightFury, 1734, 33.6, 527, 521, 51, 1099
nightgargoyle, 1122, 72.8, 200, 357, 17, 574
nightmerz, 1291, 122.2, 3, 11, 0, 14
NightoKnights, 1136, 39.5, 896, 1140, 45, 2081
nihilo, 1081, 128.6, 55, 53, 2, 110
NiiLoC, 1678, 76.2, 1657, 1143, 126, 2926
niitian, 722, 225.2, 4, 53, 0, 57
Nijrab, 964, 68.5, 318, 551, 33, 902
Nikademeus, 1406, 102.3, 2116, 1557, 186, 3859
nikgon, 1253, 136.2, 589, 334, 109, 1032
NikhilParte, 836, 152.7, 3, 37, 1, 41
Nikilady, 1420, 24.3, 5749, 2948, 392, 9089
nikizan, 1201, 29.0, 602, 370, 40, 1012
Nikjeboef, 1115, 57.2, 91, 166, 8, 265
Nikkki, 1632, 102.4, 3763, 2822, 300, 6885
niklasha, 1274, 337.5, 31, 67, 3, 101
NikoGM, 1274, 71.3, 170, 244, 16, 430
NikolaAntonov, 1468, 46.2, 1063, 579, 88, 1730
nikolaevich, 2026, 193.9, 8, 1, 0, 9
nikolam, 1455, 74.4, 271, 279, 17, 567
Nikonshooter, 1217, 30.6, 3537, 4720, 602, 8859
nikorin, 1094, 60.3, 72, 106, 4, 182
Nikro, 1740, 107.5, 9319, 10401, 862, 20582
nikros, 1677, 24.2, 1684, 3628, 285, 5597
nilaya, 1432, 63.4, 1942, 2649, 106, 4697
nill, 1218, 111.0, 1319, 1495, 59, 2873
NilMik, 860, 34.7, 86, 169, 3, 258
niloofar, 1386, 75.5, 49, 91, 2, 142
nilshero, 1751, 38.2, 4842, 5356, 623, 10821
nimam, 1073, 84.0, 64, 68, 8, 140
NimbusReign, 1224, 35.1, 1351, 1008, 33, 2392
nimzobaba, 1388, 67.2, 710, 609, 48, 1367
nimzocapatal, 1707, 29.9, 5074, 4614, 814, 10502
nimzoii, 1523, 33.0, 10602, 7930, 718, 19250
NimzoKnight, 1477, 23.4, 8406, 11542, 758, 20706
nimzolin, 1551, 84.4, 48, 15, 3, 66
ninaum, 1645, 30.7, 11551, 6769, 795, 19115
Ninebreaker, 1129, 148.8, 24, 19, 0, 43
ninenagon, 1019, 216.7, 0, 4, 0, 4
ninepointeight, 805, 147.2, 2, 22, 0, 24
Nineyes, 1430, 75.7, 7411, 9412, 492, 17315
NinjaPawns, 1673, 261.3, 1, 1, 0, 2
niorfed, 1305, 184.7, 18, 40, 1, 59
Nipiv, 1298, 95.8, 770, 990, 35, 1795
NirHart, 1483, 75.3, 370, 311, 36, 717
nisimnisim, 1896, 59.0, 84, 98, 9, 191
Nisyros, 1675, 24.7, 10703, 7313, 660, 18676
nitha, 961, 132.8, 124, 688, 20, 832
nithej, 1539, 37.1, 79, 40, 5, 124
nivi, 1623, 95.8, 1287, 587, 46, 1920
nivo, 1284, 114.3, 955, 1239, 84, 2278
niwei, 1542, 257.0, 0, 1, 0, 1
niwregski, 1335, 31.3, 817, 1295, 96, 2208
niyong, 1422, 50.8, 37, 51, 2, 90
Nizhniy, 1592, 46.1, 1166, 1638, 113, 2917
NJC, 1521, 131.2, 328, 235, 22, 585
NJeagle, 1447, 54.4, 11766, 5297, 420, 17483
njgrac, 1070, 53.1, 239, 303, 12, 554
Njnangel, 1155, 50.8, 659, 714, 17, 1390
nkb, 1255, 22.6, 13788, 22171, 1157, 37116
Nlshafi, 1293, 75.6, 1060, 1242, 67, 2369
NLStub, 1298, 92.4, 435, 119, 16, 570
nlyin, 1093, 55.9, 64, 90, 11, 165
nmuffjgp, 1166, 71.3, 1092, 1320, 194, 2606
Nniimmzzoo, 1704, 31.3, 2136, 3051, 234, 5421
nnsanh, 1210, 37.2, 4768, 7824, 423, 13015
noahsark, 1039, 103.9, 1048, 1414, 86, 2548
noblitzplz, 1411, 81.3, 84, 99, 12, 195
nobonestones, 1151, 49.1, 271, 652, 15, 938
Nocheckels, 1321, 126.6, 430, 752, 52, 1234
Nodakdan, 1384, 55.7, 3625, 4481, 204, 8310
nodras, 1390, 34.4, 427, 705, 55, 1187
nodreams, 1784, 27.0, 1388, 1197, 170, 2755
noekh, 1107, 101.3, 77, 104, 3, 184
NoelGrade, 2000, 80.0, 1545, 1200, 196, 2941
NoGossip, 1113, 70.7, 19, 19, 1, 39
nohandles, 1264, 54.4, 297, 331, 31, 659
NoHaRa, 1535, 40.2, 4942, 5309, 520, 10771
NoHero, 1191, 70.9, 662, 572, 38, 1272
Nohliife, 1377, 44.3, 159, 139, 14, 312
noibo, 1252, 34.7, 304, 372, 20, 696
NoiPiMan, 1089, 52.4, 132, 105, 3, 240
nojoek, 1241, 127.7, 41, 86, 7, 134
NoJoking, 1712, 60.6, 5451, 3842, 318, 9611
NokiaTwenty, 1739, 59.1, 651, 265, 57, 973
nokoreeb, 891, 111.0, 390, 528, 12, 930
Noldorin, 949, 58.4, 17, 52, 0, 69
noloveexpected, 1251, 28.5, 9386, 9170, 1496, 20052
Nomesi, 1164, 31.9, 4158, 6832, 240, 11230
nominalism, 1583, 25.3, 3390, 3126, 221, 6737
nomnom, 1053, 50.6, 183, 261, 9, 453
nomorecheckers, 2431, 43.5, 506, 12, 14, 532
nonajo, 1238, 108.0, 399, 524, 18, 941
Nonameneeded, 1033, 89.6, 10, 33, 1, 44
noncsi, 730, 146.7, 54, 291, 14, 359
nonotai, 1294, 29.2, 5296, 4231, 691, 10218
nonvideri, 1296, 71.7, 15399, 18088, 972, 34459
NoobieKnights, 1553, 104.4, 474, 398, 73, 945
NoodlePDX, 1315, 41.9, 1379, 1279, 54, 2712
NOOOO, 1259, 81.8, 134, 175, 8, 317
Noops, 1125, 44.7, 1263, 1810, 56, 3129
NoordZee, 1578, 350.0, 0, 1, 0, 1
noorzad, 1768, 350.0, 1, 0, 0, 1
Nopawn, 1807, 22.3, 20692, 15683, 3103, 39478
nopromises, 1212, 276.4, 0, 12, 0, 12
NoQuarterGiven, 1649, 36.4, 596, 613, 58, 1267
NORDRASA, 1384, 32.0, 1001, 1842, 91, 2934
NoResign, 865, 164.1, 1, 5, 0, 6
NoriegaA, 1176, 40.7, 291, 417, 15, 723
norky, 1493, 30.7, 4929, 3913, 816, 9658
normano, 1117, 28.4, 2011, 2893, 317, 5221
norrismi, 1166, 91.4, 551, 669, 12, 1232
NorthChileanG, 1136, 55.0, 1539, 2343, 142, 4024
northerfire, 1082, 30.4, 964, 1028, 47, 2039
Northern, 1203, 23.2, 14214, 11726, 1885, 27825
northernfire, 1106, 134.3, 4, 7, 1, 12
northlodge, 1676, 37.1, 1693, 1224, 150, 3067
NorthPaw, 1793, 271.1, 2, 1, 1, 4
northridgehawk, 1629, 39.9, 6133, 3401, 310, 9844
northsider, 1108, 34.6, 3327, 1275, 164, 4766
nortonm, 800, 111.1, 1, 12, 1, 14
nosdivad, 2282, 39.3, 4100, 715, 226, 5041
noseblunter, 1680, 48.3, 1765, 1968, 138, 3871
nosedive, 1341, 70.2, 239, 307, 19, 565
noseminer, 1092, 29.7, 352, 411, 18, 781
NOSna, 928, 81.0, 138, 273, 9, 420
nosorogov, 1507, 121.1, 37, 45, 0, 82
nossade, 1262, 36.4, 2971, 4404, 230, 7605
notAB, 1748, 21.6, 3959, 2777, 337, 7073
notgoodatchess, 1357, 56.7, 2296, 2335, 162, 4793
NoThought, 1581, 31.0, 3262, 3771, 458, 7491
NotMyDay, 1943, 23.5, 1178, 789, 52, 2019
notofthisworld, 1245, 60.3, 210, 263, 28, 501
NotShee, 1481, 33.5, 2624, 2593, 230, 5447
notthatrowson, 1357, 25.4, 5408, 6567, 923, 12898
nottobi, 1227, 48.4, 1510, 1640, 67, 3217
NovaHeart, 1411, 297.9, 0, 1, 0, 1
Novita, 1571, 73.4, 2880, 2285, 449, 5614
novix, 1313, 32.9, 2762, 4445, 306, 7513
Novocane, 2101, 70.0, 3989, 2170, 841, 7000
NovoLook, 1213, 29.2, 1223, 2340, 131, 3694
Novost, 1932, 57.1, 91, 148, 13, 252
NowhereMan, 1387, 48.1, 834, 786, 151, 1771
NOYDB, 1319, 65.3, 3871, 5906, 331, 10108
nozama, 1359, 21.3, 1395, 1014, 61, 2470
NPaleveda, 1807, 38.5, 1325, 1870, 231, 3426
npredom, 1812, 38.7, 837, 878, 73, 1788
nprolog, 1340, 30.0, 2057, 2931, 127, 5115
nraravind, 1645, 42.9, 8572, 5313, 880, 14765
nree, 1975, 42.0, 421, 568, 68, 1057
nreojlxr, 1585, 22.8, 3389, 2115, 360, 5864
nrmz, 1071, 69.0, 101, 274, 12, 387
nrous, 957, 39.0, 339, 579, 36, 954
nsane, 1270, 28.3, 6345, 8285, 343, 14973
nsbt, 1240, 76.1, 452, 675, 13, 1140
nshiba, 1053, 59.0, 160, 186, 12, 358
Nshifter, 1242, 98.3, 708, 767, 58, 1533
nstanev, 1411, 68.1, 242, 202, 20, 464
nstozr, 1356, 77.4, 164, 119, 21, 304
nstud, 1043, 65.9, 99, 156, 8, 263
nsushoma, 1031, 326.9, 0, 3, 0, 3
Nthdegree, 1453, 42.0, 1033, 673, 58, 1764
ntsvetko, 1751, 29.0, 5425, 5099, 713, 11237
nubreed, 1801, 39.1, 2895, 1218, 346, 4459
Nudgeroni, 1049, 46.0, 424, 746, 27, 1197
nukenut, 1831, 43.3, 1744, 1291, 200, 3235
nukesecurity, 678, 69.6, 33, 75, 3, 111
nunavuttaxi, 1594, 27.6, 2529, 1284, 65, 3878
nunes, 1404, 39.1, 7646, 7951, 637, 16234
NURbangladehs, 610, 115.9, 3, 28, 0, 31
nurmi, 1487, 43.7, 410, 302, 38, 750
Nuruddin, 832, 109.9, 6, 43, 1, 50
Nusbaum, 1925, 26.2, 15284, 12406, 1272, 28962
nutgrinder, 1309, 59.3, 317, 234, 41, 592
Nuthatchnut, 1510, 31.2, 1062, 1652, 217, 2931
Nutunchik, 951, 102.7, 142, 275, 11, 428
nuvoletta, 1435, 42.7, 7693, 9036, 579, 17308
nvarela, 1028, 35.3, 1558, 2668, 75, 4301
nvc, 1509, 35.4, 3767, 4672, 349, 8788
nvd, 1044, 130.7, 10, 13, 2, 25
nvrajesh, 1182, 119.8, 1018, 776, 75, 1869
NWA, 1161, 138.4, 101, 140, 5, 246
NWAdayz, 1031, 31.3, 283, 768, 11, 1062
nwayfarer, 1087, 51.5, 74, 122, 4, 200
nyBallers, 1245, 113.6, 16, 30, 0, 46
nyc, 1451, 130.8, 911, 1091, 84, 2086
nyny, 1223, 48.6, 1049, 2101, 99, 3249
nynymike, 1244, 179.9, 4, 8, 0, 12
NYrocker, 1212, 45.9, 995, 1485, 106, 2586
nzero, 1572, 23.9, 3714, 4993, 380, 9087
nzhoney, 1113, 38.2, 5659, 9976, 224, 15859
Oak, 1480, 37.3, 12510, 10541, 1398, 24449
Oaki, 2012, 38.3, 1601, 1338, 187, 3126
oakseed, 944, 40.8, 2096, 3540, 262, 5898
oalienista, 1361, 42.8, 554, 506, 32, 1092
obana, 1210, 120.3, 1878, 2002, 141, 4021
Obeespunone, 1455, 64.8, 799, 685, 72, 1556
Obeikan, 1052, 96.3, 132, 348, 2, 482
obikats, 1077, 42.1, 2709, 3228, 165, 6102
obladah, 1185, 31.6, 5168, 4629, 377, 10174
Obliviax, 1916, 36.8, 16483, 5446, 608, 22537
Oblonsky, 1282, 60.8, 5034, 5986, 367, 11387
obmanovichhh, 1162, 43.0, 1232, 918, 79, 2229
Obmanta, 1211, 76.2, 362, 354, 24, 740
OBrother, 843, 281.9, 19, 22, 0, 41
Observerxyz, 1241, 106.0, 919, 1067, 58, 2044
obtheone, 977, 46.5, 231, 638, 24, 893
ObviouslyRussian, 1218, 86.1, 195, 222, 9, 426
ocaric, 886, 60.2, 16, 64, 5, 85
OccultStone, 1258, 70.1, 15, 18, 0, 33
ocdjunior, 1489, 32.5, 2129, 2285, 154, 4568
ocelot, 1718, 55.0, 4681, 3093, 307, 8081
ochoo, 1344, 86.8, 8628, 16343, 783, 25754
ocinemo, 1365, 40.0, 450, 626, 51, 1127
OCizzle, 895, 100.7, 277, 325, 10, 612
octabeer, 1344, 40.7, 1683, 1668, 109, 3460
octorain, 1550, 87.8, 168, 93, 7, 268
Octos, 1478, 69.2, 242, 341, 32, 615
ocumichu, 1586, 32.3, 4791, 7417, 1111, 13319
ocustopus, 1658, 38.0, 432, 319, 35, 786
Odael, 1610, 59.5, 269, 167, 39, 475
OderusUrungus, 1608, 80.2, 6078, 4293, 290, 10661
odiegarjon, 1688, 34.8, 4899, 4583, 252, 9734
odnadenaz, 1114, 32.4, 686, 761, 24, 1471
OdongOdong, 985, 66.7, 17, 827, 1, 845
odysius, 1450, 84.1, 2891, 2406, 199, 5496
Oecleus, 1184, 62.8, 133, 141, 14, 288
oeli, 1765, 46.7, 3488, 3994, 440, 7922
Ofari, 1569, 34.1, 382, 161, 25, 568
offtherook, 1404, 33.7, 456, 484, 44, 984
ogopogo, 1400, 31.5, 3435, 3158, 295, 6888
Ogopogoman, 973, 139.0, 17, 67, 2, 86
ogreforce, 1256, 28.8, 619, 606, 49, 1274
ogunyemi, 1499, 66.4, 171, 293, 14, 478
oguzusman, 1405, 24.2, 7396, 4108, 465, 11969
OGxxxEmmet, 963, 73.9, 20, 39, 0, 59
Ohhhh, 1080, 53.9, 62, 78, 6, 146
ohhhhhnooooo, 1032, 53.7, 616, 820, 34, 1470
ohmar, 1540, 26.9, 4778, 4198, 310, 9286
Ohmu, 1175, 37.6, 574, 628, 48, 1250
Ohnoes, 1265, 86.4, 181, 247, 10, 438
Ohnyeon, 1072, 71.5, 1033, 1476, 116, 2625
ohrworm, 1383, 27.7, 7025, 9121, 883, 17029
OhSweetNuthin, 1452, 125.2, 182, 178, 15, 375
Oinegue, 1823, 53.3, 2157, 2086, 259, 4502
oipraciloPSresE, 1676, 57.2, 1686, 962, 82, 2730
okazako, 1391, 34.0, 1811, 1584, 73, 3468
okey, 1361, 41.7, 5706, 5703, 588, 11997
Oki, 1179, 232.5, 153, 195, 17, 365
okmijnuhby, 1536, 62.4, 358, 489, 91, 938
Oksg, 1492, 69.0, 413, 701, 53, 1167
okthapuul, 1660, 47.9, 1135, 1100, 108, 2343
Okunevich, 1595, 60.3, 2971, 1131, 130, 4232
olaflena, 1147, 84.6, 290, 449, 28, 767
olaha, 1522, 32.3, 4130, 3433, 437, 8000
Olarin, 1279, 32.0, 1029, 1282, 129, 2440
olavgrov, 1281, 225.0, 1, 5, 1, 7
OldAl, 1325, 42.9, 1354, 942, 177, 2473
Oldandlazy, 1738, 26.6, 3696, 4518, 449, 8663
OldBear, 1448, 35.2, 2762, 3349, 178, 6289
Oldenwayz, 1199, 64.6, 214, 298, 11, 523
oldgeorge, 1619, 25.5, 2194, 1497, 160, 3851
OldHolborn, 1241, 51.0, 406, 498, 23, 927
oldlove, 1124, 36.2, 536, 784, 65, 1385
OldMarine, 1163, 54.6, 1853, 1809, 70, 3732
OldMcFarlane, 1222, 27.3, 4438, 4120, 253, 8811
oldprovincial, 1189, 40.8, 486, 707, 27, 1220
OldRaptor, 1282, 114.1, 838, 686, 55, 1579
oldrope, 911, 123.6, 7, 26, 1, 34
oldway, 1242, 37.6, 11042, 10796, 1476, 23314
olebob, 1219, 31.2, 2257, 1804, 89, 4150
OleKicker, 1300, 19.8, 16110, 14721, 815, 31646
oleyhan, 1263, 26.3, 3575, 4289, 427, 8291
olinda, 1438, 50.1, 7840, 5668, 561, 14069
olivadecampos, 1159, 59.6, 2060, 2170, 155, 4385
OliverGuerrero, 1435, 62.3, 662, 540, 74, 1276
oliverhaddo, 1488, 33.8, 3505, 4844, 381, 8730
oliverinho, 1383, 128.7, 95, 107, 9, 211
olivierk, 1015, 114.6, 386, 587, 39, 1012
oljaanaga, 1469, 34.1, 7854, 5532, 782, 14168
olma, 1579, 47.0, 6258, 4510, 677, 11445
olpa, 1793, 56.4, 1616, 1572, 187, 3375, 1236, 65.0, 300, 364, 6, 670
olprospector, 1137, 32.4, 1189, 2160, 51, 3400
OmarJ, 1498, 72.7, 38, 39, 3, 80
omarrafi, 1524, 41.5, 893, 914, 108, 1915
omassa, 785, 66.1, 146, 241, 6, 393
Omeg, 1044, 77.1, 458, 721, 37, 1216
OmegaBeans, 1547, 80.3, 1027, 1693, 99, 2819
omendrec, 1600, 22.0, 10687, 9790, 851, 21328
omers, 1440, 263.0, 125, 105, 2, 232
omle, 1377, 40.2, 1231, 879, 92, 2202
Ommo, 862, 67.7, 28, 109, 0, 137
OncleWil, 1776, 31.6, 1611, 2109, 293, 4013
onebigfish, 1505, 33.1, 6244, 4273, 497, 11014
onecheplayer, 823, 123.8, 1, 7, 1, 9
onechessnut, 1326, 86.9, 30, 8, 0, 38
onedayfly, 1116, 34.4, 1731, 3189, 193, 5113
OneeyeWilly, 1683, 43.3, 842, 1019, 116, 1977
OneFromNone, 1771, 29.6, 14942, 9838, 1556, 26336
Onelegkicker, 1068, 52.8, 862, 1157, 71, 2090
onemoremove, 1025, 32.5, 1921, 2088, 159, 4168
OneNoTrump, 1284, 28.9, 7611, 7022, 553, 15186
onethousand, 1841, 130.4, 70, 23, 7, 100
onetouch, 1355, 28.8, 1864, 1667, 153, 3684
ongyj, 1508, 98.3, 853, 514, 129, 1496
onide, 1865, 104.7, 119, 79, 15, 213
oniyama, 1172, 120.6, 2, 10, 0, 12
OnlyOne, 1714, 36.9, 12585, 9876, 1189, 23650
OnlyTheBlood, 1160, 22.9, 8573, 12372, 1282, 22227
onme, 778, 76.9, 20, 116, 1, 137
onthedownlow, 1274, 78.2, 1721, 1967, 102, 3790
OnyxSquares, 1414, 45.2, 168, 182, 4, 354
oodi, 1112, 63.2, 41, 88, 0, 129
ooNIPURoo, 1745, 38.5, 473, 217, 18, 708
ooobruceleeooo, 1525, 119.6, 877, 912, 75, 1864
oooLAGASHooo, 1713, 24.1, 352, 168, 11, 531
oorp, 1010, 68.8, 355, 421, 40, 816
oOschaakmatOo, 1279, 41.4, 233, 254, 14, 501
oOSLayeROo, 1146, 182.1, 3, 4, 0, 7
OOven, 1583, 36.2, 11761, 7236, 982, 19979
oowat, 809, 27.6, 94, 324, 12, 430
oozecube, 1464, 91.2, 34, 31, 1, 66
openlook, 1477, 26.2, 2624, 2525, 99, 5248
opollo, 1096, 37.5, 347, 286, 19, 652
opportunity, 910, 104.0, 32, 174, 2, 208
Opposite, 1681, 108.2, 1046, 723, 126, 1895
OppTikk, 1424, 47.0, 2265, 2007, 165, 4437
oprincipe, 1646, 26.8, 5584, 5331, 460, 11375
OptimusBach, 1192, 53.7, 287, 273, 54, 614
Optiques, 1066, 27.5, 1994, 3304, 432, 5730
optrairony, 1231, 23.2, 7329, 8432, 338, 16099
Opushtencija, 1358, 33.9, 3079, 3370, 195, 6644
opy, 1394, 229.7, 5137, 5057, 531, 10725
Oracleman, 1188, 61.0, 159, 328, 24, 511
oralegre, 1169, 37.4, 1048, 1245, 79, 2372
oraoraora, 1028, 231.3, 1, 4, 0, 5
Oren, 1843, 31.9, 12416, 8529, 1301, 22246
OrganicChess, 1837, 135.4, 3683, 2699, 294, 6676
organicCow, 1246, 143.9, 11, 9, 5, 25
Oriant, 1455, 37.7, 2865, 2071, 163, 5099
orichaoco, 1298, 36.5, 1982, 4637, 173, 6792
Orienteer, 1463, 22.6, 15979, 23115, 1393, 40487
orientir, 1699, 68.1, 266, 94, 12, 372
originaldjtron, 840, 112.0, 19, 201, 3, 223
orionchik, 1337, 27.3, 1329, 1268, 95, 2692
oriongirl, 927, 46.4, 269, 818, 22, 1109
OrionKnight, 1455, 248.4, 0, 2, 0, 2
orionstar, 1288, 81.5, 11, 172, 0, 183
orlandus, 1236, 25.7, 1890, 2751, 169, 4810
ornello, 1757, 28.2, 3678, 5176, 558, 9412
ornito, 1470, 23.5, 17651, 14453, 1050, 33154
ornitorringo, 1840, 227.9, 2, 5, 0, 7
orolab, 1387, 140.6, 933, 1374, 139, 2446
oroplatamata, 1760, 38.0, 2480, 1457, 143, 4080
orsonscottcard, 1363, 61.4, 785, 1030, 116, 1931
Orthodoc, 1484, 31.1, 219, 231, 13, 463
Orusse, 1867, 37.1, 115, 111, 8, 234
oSand, 1363, 103.9, 488, 507, 21, 1016
OsaridSaris, 1641, 30.3, 2638, 1109, 238, 3985
oscarroberto, 1388, 55.6, 703, 613, 57, 1373
OscarTheMuppet, 1105, 35.4, 612, 585, 28, 1225
osilara, 1293, 32.6, 3369, 4146, 316, 7831
oskarov, 759, 95.8, 16, 48, 1, 65
OSNeutral, 1255, 27.4, 13440, 16747, 353, 30540
Osoinach, 1037, 99.1, 7, 8, 1, 16
osones, 1821, 50.7, 2875, 6530, 765, 10170
ossihousi, 1301, 29.0, 2138, 2116, 141, 4395
ostig, 1340, 158.8, 3, 14, 0, 17
ostprimat, 1359, 51.2, 1222, 1309, 52, 2583
osX, 1232, 35.3, 3569, 3110, 274, 6953
oszkari, 849, 50.4, 162, 390, 7, 559
Otavianocr, 1949, 35.5, 3844, 2832, 471, 7147
Othaluran, 1482, 110.3, 620, 1079, 77, 1776
OtherAsian, 1701, 92.5, 17, 14, 2, 33
othermeans, 1224, 30.1, 6610, 6454, 427, 13491
otherworldly, 1405, 42.8, 2166, 1841, 153, 4160
Otipac, 1223, 56.4, 79, 54, 5, 138
OTK, 1632, 36.1, 2493, 2869, 557, 5919
otllz, 1685, 119.4, 91, 39, 2, 132
otoz, 1385, 24.1, 19826, 21824, 2333, 43983
ottanik, 1702, 25.5, 10477, 9916, 708, 21101
ottodolfo, 1404, 25.7, 4215, 7337, 208, 11760
ottomanking, 604, 93.1, 2, 63, 0, 65
oubok, 1197, 32.8, 514, 605, 66, 1185
oudellvt, 1674, 42.7, 1574, 431, 71, 2076
ouibjamn, 1504, 75.5, 2512, 2587, 238, 5337
ousef, 863, 129.1, 3, 20, 0, 23, 1446, 52.2, 3417, 4197, 431, 8045
OutbackKnight, 969, 114.8, 1139, 1017, 98, 2254
Outin, 1623, 25.0, 15054, 8761, 534, 24349
OutlawdPipes, 1463, 24.3, 5142, 4380, 166, 9688
OutofTime, 1190, 34.4, 1898, 4637, 303, 6838
OUTRUNYOU, 1498, 49.4, 487, 725, 62, 1274
ouucch, 1454, 28.7, 3997, 3674, 273, 7944
Overstation, 1521, 108.2, 34, 37, 5, 76
OvidiuDanut, 1112, 78.8, 99, 101, 15, 215
Ovnis, 1787, 48.0, 3448, 2925, 440, 6813
ovonianos, 1488, 27.1, 14156, 16080, 809, 31045
OwenP, 1112, 39.0, 591, 685, 75, 1351
Owiseone, 1033, 101.4, 3674, 4681, 211, 8566
oxidant, 1862, 292.6, 66, 32, 1, 99
oysterpond, 1355, 35.8, 438, 260, 40, 738
ozebloke, 1240, 36.9, 4941, 5094, 461, 10496
ozypawnstar, 1191, 59.6, 620, 720, 58, 1398
ozzynoid, 1512, 21.5, 8491, 5358, 777, 14626
paar, 1622, 22.5, 8874, 9695, 1126, 19695
pablitodyg, 799, 132.3, 4, 18, 0, 22
PABLITOO, 686, 93.4, 3, 46, 0, 49
pabloarg, 1464, 26.2, 3493, 3701, 486, 7680
pablooo, 752, 94.9, 5, 22, 0, 27
pablopastore, 1045, 70.0, 308, 464, 28, 800
pablourgante, 1015, 41.1, 218, 141, 11, 370
Pacala, 1047, 61.3, 878, 752, 82, 1712
Paccer, 1578, 32.4, 2988, 3015, 180, 6183
paceytallblack, 1407, 73.9, 908, 1181, 106, 2195
pachapacha, 2090, 22.5, 16004, 6518, 1669, 24191
Pacho, 1695, 37.2, 3666, 3773, 268, 7707
pacificsun, 1425, 258.5, 9, 4, 0, 13
pacopi, 1499, 33.8, 6401, 4074, 393, 10868
pacovsky, 1720, 23.7, 9660, 11812, 513, 21985
paculla, 1695, 36.8, 786, 780, 80, 1646
PACxadrez, 718, 80.1, 9, 56, 1, 66
Padalino, 1074, 71.9, 1281, 994, 86, 2361
padichodgetheory, 1597, 30.3, 7681, 5141, 372, 13194
padraiken, 1119, 348.4, 0, 1, 0, 1
Padregordo, 1469, 39.7, 758, 1052, 54, 1864
pafthionville, 1471, 31.3, 1049, 635, 62, 1746
Paillao, 1411, 67.7, 23, 16, 0, 39
PainComplet, 1907, 52.6, 1950, 681, 123, 2754
paire, 1464, 52.8, 1507, 1456, 138, 3101
paisanet, 1616, 214.1, 2, 2, 0, 4
Pajdo, 1671, 69.1, 4135, 4602, 378, 9115
Pajonal, 1371, 30.1, 5447, 6718, 582, 12747
pakazuha, 1676, 118.2, 2278, 4569, 93, 6940
pakunoda, 1342, 58.2, 365, 237, 30, 632
Palamambron, 1402, 32.3, 2604, 2729, 218, 5551
palecek, 2038, 34.5, 2319, 1163, 226, 3708
Paligap, 1470, 19.9, 5915, 9005, 297, 15217
pallab, 1248, 105.4, 2092, 2866, 248, 5206
palleg, 1279, 31.9, 80, 134, 6, 220
Palles, 1006, 45.5, 118, 207, 5, 330
PallyChess, 1507, 103.8, 2103, 1989, 253, 4345
Paloa, 1328, 28.3, 11458, 17061, 1113, 29632
pammi, 770, 67.0, 9, 42, 0, 51
panama, 1603, 111.0, 5237, 3882, 228, 9347
panchodelmonte, 780, 99.7, 19, 71, 2, 92
PanchoPistolas, 956, 117.7, 194, 370, 13, 577
PandaRoux, 1368, 37.5, 7225, 4552, 613, 12390
PanderBobson, 980, 121.3, 8, 28, 0, 36
Pandion, 1240, 38.5, 1339, 1246, 88, 2673
pandit, 1100, 52.1, 1177, 2195, 107, 3479
Pandolfi, 1695, 29.5, 8753, 5756, 720, 15229
pangpang, 1064, 105.8, 19, 43, 1, 63
pangrango, 942, 124.1, 27, 135, 4, 166
pantai, 1629, 18.8, 22136, 20293, 2344, 44773
pantoja, 1495, 38.2, 652, 418, 29, 1099
pantyhose, 1268, 23.2, 2330, 2723, 186, 5239
PanwToRook, 1327, 88.0, 62, 167, 8, 237
PapaCarlo, 1637, 35.5, 131, 88, 7, 226
papajay, 844, 100.3, 2, 19, 1, 22
papao, 1129, 45.0, 238, 446, 10, 694
papasayangmama, 1273, 80.9, 78, 85, 9, 172
papasquirrel, 1193, 38.0, 4229, 4945, 346, 9520
papasteed, 683, 72.7, 3, 43, 0, 46
papaz, 1210, 91.9, 477, 562, 50, 1089
paperchasdvincent, 1128, 290.3, 1, 2, 0, 3
papernoose, 1549, 39.4, 9904, 4069, 294, 14267
papichan, 1088, 44.7, 1638, 3427, 133, 5198
papier, 1242, 35.7, 9692, 12026, 654, 22372
Pappanp, 1300, 144.1, 2, 6, 0, 8
papperlapapp, 1328, 34.0, 895, 1388, 49, 2332
papuga, 1735, 22.7, 261, 326, 35, 622
paquitou, 1170, 43.4, 814, 721, 44, 1579
Paradoxen, 1171, 32.4, 223, 394, 35, 652
paragmitra, 1157, 76.1, 34, 56, 0, 90
paragn, 1425, 24.1, 7800, 11013, 595, 19408
ParallaxNow, 1596, 32.0, 1213, 2558, 87, 3858
parampa, 1682, 32.8, 7971, 9580, 674, 18225
Parapatay, 1668, 74.6, 1903, 2077, 130, 4110
parasbrcr, 1355, 58.4, 377, 190, 22, 589
parb, 1246, 48.1, 1773, 2725, 273, 4771
Parcheesi, 972, 121.4, 15, 29, 2, 46
pardes, 1397, 29.2, 15383, 24911, 1559, 41853
pardi, 1534, 45.1, 1277, 1004, 96, 2377
Paregorics, 1631, 33.6, 1855, 1938, 222, 4015
parell, 1602, 31.3, 424, 660, 52, 1136
Parini, 1437, 72.9, 2433, 3480, 255, 6168
parisestmagic, 1552, 41.8, 8953, 9407, 676, 19036
ParisTokyo, 1261, 48.4, 541, 684, 28, 1253
ParkPlace, 1610, 202.2, 3444, 2609, 440, 6493
parlance, 898, 25.7, 1220, 1300, 53, 2573
Parodox, 1203, 25.9, 1725, 1521, 128, 3374
parolois, 1002, 177.4, 273, 235, 25, 533
ParoutyBY, 1342, 45.2, 599, 729, 30, 1358
parsappliance, 1144, 32.2, 524, 798, 96, 1418
parsleydonn, 1445, 32.4, 1262, 450, 145, 1857
parsonparsons, 775, 86.3, 38, 151, 4, 193
Parthian, 1215, 67.2, 203, 240, 11, 454
partyshah, 1445, 43.6, 2185, 1694, 105, 3984
PascalMail, 1646, 80.2, 640, 752, 51, 1443
pascalwilliams, 1308, 23.2, 9825, 10218, 870, 20913
Pasheek, 1332, 33.9, 2948, 3758, 276, 6982
Pasman, 1227, 124.2, 5, 8, 1, 14
passionateknight, 1290, 93.4, 356, 386, 19, 761
PastorEd, 1363, 42.4, 2213, 2946, 186, 5345
PastorK, 1368, 24.4, 7992, 7447, 529, 15968
PasUrb, 1049, 55.5, 1047, 1382, 84, 2513
Patan, 1810, 32.7, 15588, 7765, 1281, 24634
patatoff, 1780, 43.8, 226, 178, 18, 422
Patator, 1234, 62.1, 6441, 6473, 575, 13489
patc, 1578, 77.6, 30779, 19347, 1234, 51360
PatentedSkillz, 1152, 117.2, 95, 66, 5, 166
pathosabr, 989, 201.2, 0, 7, 0, 7
patients, 1578, 39.0, 840, 599, 30, 1469
Patmas, 1225, 43.9, 359, 692, 58, 1109
PatoisPatois, 1257, 120.0, 1474, 1424, 43, 2941
PatOrMat, 1572, 106.5, 206, 144, 15, 365
patosky, 1446, 31.6, 3468, 4069, 372, 7909
patpatzer, 1255, 52.0, 389, 365, 31, 785
Patrickdupsg, 1402, 34.9, 2293, 2803, 145, 5241
PatrickSilva, 1599, 38.3, 842, 725, 64, 1631
patrolador, 1694, 61.1, 810, 1067, 72, 1949
patrow, 1298, 32.0, 7550, 9792, 572, 17914
PattMatt, 1312, 39.5, 2698, 2607, 432, 5737
Patty, 1152, 32.0, 1198, 1795, 178, 3171
pattyvanny, 1391, 39.7, 1277, 1532, 120, 2929
PatzerEli, 1629, 100.9, 117, 37, 7, 161
PATZERFEVER, 1816, 25.2, 1931, 1883, 242, 4056
Patzerlino, 1161, 36.5, 1081, 1084, 54, 2219
Patzerpro, 1447, 29.1, 3378, 2996, 288, 6662
patzertime, 1407, 48.0, 1494, 1640, 112, 3246
patzzzer, 1681, 124.4, 16, 5, 0, 21
Pauken, 964, 126.4, 237, 430, 24, 691
Paula, 1557, 36.0, 6156, 5808, 526, 12490
PaulBne, 1241, 108.3, 3573, 3304, 365, 7242
paulbuchman, 2082, 30.1, 11944, 5669, 1341, 18954
pauldoherty, 1219, 47.5, 1700, 2076, 131, 3907
pauleinpaul, 941, 73.4, 649, 1146, 18, 1813
paulocardoso, 1064, 75.5, 113, 126, 4, 243
PauloSantoro, 1323, 73.7, 1841, 2291, 226, 4358
Paulqwert, 1383, 36.0, 2215, 2211, 431, 4857
Pauper, 1512, 114.1, 8237, 7539, 850, 16626
pavadhar, 1203, 31.5, 819, 841, 81, 1741
pavelex, 1397, 31.5, 1278, 943, 86, 2307
pavelg, 1428, 148.3, 5, 4, 0, 9
pavelpan, 842, 202.8, 0, 8, 0, 8
Pavia, 1371, 40.0, 2994, 3610, 246, 6850
Pavkovic, 1409, 87.7, 608, 188, 44, 840
pavlo, 1354, 35.3, 11799, 12489, 821, 25109
PawnAtCrux, 1082, 66.2, 254, 275, 16, 545
pawnchaser, 816, 103.7, 36, 125, 1, 162
Pawncheck, 1649, 78.2, 3366, 2890, 309, 6565
pawncouple, 1802, 73.1, 4401, 7794, 629, 12824
Pawndelion, 1381, 18.1, 8731, 12508, 1451, 22690
pawnderer, 1190, 276.2, 3, 11, 0, 14
PawnDirector, 1328, 71.9, 80, 57, 5, 142
pawnDonkey, 1313, 32.3, 1486, 1040, 135, 2661
pawnedpawn, 1299, 32.3, 186, 301, 30, 517
pawnhandle, 1472, 90.6, 1747, 1071, 208, 3026
pawnica, 1314, 121.9, 472, 576, 19, 1067
pawnislander, 1125, 26.9, 1222, 1119, 70, 2411
PawnJockey, 1647, 29.6, 5436, 4075, 435, 9946
PawnJones, 1351, 85.5, 1000, 656, 94, 1750
PawnMau, 1406, 32.4, 4841, 5622, 515, 10978
Pawnmower, 1710, 85.5, 15824, 15460, 1261, 32545
pawnmurderer, 1671, 23.7, 5214, 7582, 880, 13676
pawnoflife, 1197, 55.9, 1555, 1545, 131, 3231
pawnpeace, 1212, 78.5, 4446, 3830, 354, 8630
pawnrainer, 1292, 30.9, 1661, 1262, 75, 2998
PawnRex, 1765, 77.6, 54, 58, 5, 117
Pawnshop, 1602, 27.6, 8035, 7871, 1394, 17300
pawnshoppe, 1383, 81.7, 631, 782, 91, 1504
pawnslaught, 1591, 37.6, 12372, 5936, 643, 18951
pawnsleeper, 1494, 28.0, 4849, 4372, 450, 9671
PawnSmacker, 1564, 32.1, 2011, 1741, 190, 3942
PawnSoldiers, 1356, 34.4, 938, 907, 75, 1920
Pawnstarz, 1535, 24.9, 364, 493, 30, 887
pawnstriker, 1859, 34.7, 2852, 2559, 352, 5763
PawntoQween, 1392, 60.7, 672, 1131, 88, 1891
pawntrooper, 1374, 38.1, 172, 195, 13, 380
Pawnuntilyoucross, 1274, 56.2, 834, 573, 80, 1487
Pawnuser, 1003, 55.7, 224, 351, 17, 592
Paxi, 1064, 40.1, 350, 500, 40, 890
payneMax, 1421, 217.2, 1, 2, 0, 3
pazkey, 1627, 42.1, 439, 211, 24, 674
PBee, 1038, 26.9, 772, 1229, 40, 2041
PBenenson, 1363, 83.2, 401, 362, 13, 776
pboy, 1546, 63.9, 2193, 2680, 143, 5016
PBT, 1633, 58.8, 288, 377, 96, 761
pcannon, 1818, 24.2, 38249, 18338, 3524, 60111
pcarr, 1101, 72.1, 126, 180, 12, 318
pccat, 1833, 31.7, 4619, 3376, 462, 8457
pccordeiro, 920, 61.2, 43, 112, 2, 157
Pcibiri, 1128, 129.9, 22, 22, 0, 44
pcpzzzz, 1605, 50.9, 691, 582, 47, 1320
pdb, 1252, 26.2, 4888, 4294, 292, 9474
pdrag, 1245, 31.2, 1405, 1268, 161, 2834
PeachChess, 1143, 209.7, 2, 4, 0, 6
PeaHead, 1717, 32.8, 5256, 5828, 638, 11722
PEcoach, 1270, 42.2, 134, 878, 10, 1022
Pedalero, 1725, 76.1, 11598, 5207, 655, 17460
pedh, 1763, 123.8, 31, 19, 1, 51
Pedistol, 1655, 55.4, 798, 1464, 64, 2326
pedonarrogante, 1324, 85.5, 112, 233, 8, 353
pedreiro, 1714, 31.0, 6875, 4608, 330, 11813
PedroA, 1476, 25.7, 7181, 8397, 651, 16229
pedrohanson, 1218, 34.2, 2958, 3172, 428, 6558
pedroselle, 1681, 23.3, 13889, 17744, 1139, 32772
Pedu, 1592, 35.0, 17730, 20148, 2023, 39901
Peedle, 1372, 44.6, 1082, 1212, 92, 2386
peering, 1539, 64.9, 3317, 3586, 370, 7273
peerstein, 1401, 44.9, 193, 117, 6, 316
Peeters, 1648, 52.3, 316, 170, 27, 513
PEF, 1125, 58.4, 618, 588, 45, 1251
Pegado, 1023, 137.0, 73, 296, 5, 374
PegasW, 1410, 29.6, 5476, 11007, 567, 17050
peidi, 1298, 67.1, 158, 214, 14, 386
Peiler, 1761, 28.6, 7587, 5201, 806, 13594
Peiners, 1210, 94.5, 486, 563, 24, 1073
Peke, 1493, 25.3, 4324, 7554, 568, 12446
Peleg, 1540, 35.8, 577, 934, 63, 1574
pelehr, 1525, 58.6, 611, 1246, 66, 1923
Pelucon, 1243, 65.3, 3769, 6363, 139, 10271
pengupengu, 1007, 60.1, 65, 231, 8, 304
penkapenkina, 1607, 35.8, 1063, 1790, 142, 2995
PenniD, 1550, 69.7, 811, 477, 39, 1327
pennyfed, 941, 33.1, 124, 135, 9, 268
Pensar, 1397, 63.5, 96, 67, 7, 170
Pensphan, 1347, 33.1, 405, 341, 26, 772
pentarim, 1357, 60.1, 188, 222, 30, 440
pentawebs, 1157, 113.7, 4, 17, 0, 21
pentille, 977, 39.9, 1329, 2464, 99, 3892
penwell, 1539, 61.7, 5979, 3440, 504, 9923
PeondelaNoche, 1315, 88.2, 426, 387, 46, 859
peontrese, 920, 92.5, 5, 18, 0, 23
peonveloz, 1458, 28.7, 827, 1046, 52, 1925
peonverde, 1403, 38.0, 5084, 4561, 408, 10053
pepealfil, 1455, 52.4, 1280, 1492, 131, 2903
Pepperoncini, 1928, 34.9, 1889, 1371, 145, 3405
perama, 1044, 50.8, 830, 1133, 35, 1998
percyjackson, 1501, 30.9, 1835, 2410, 102, 4347
perece, 1309, 64.9, 154, 157, 10, 321
pereha, 1680, 27.1, 13270, 12344, 1828, 27442
PerErikA, 1400, 35.1, 6197, 5652, 603, 12452
perfessor, 1557, 38.6, 3416, 3308, 360, 7084
perlablabeck, 1004, 49.3, 912, 1135, 72, 2119
Permanence, 1453, 34.9, 4249, 3277, 298, 7824
peroneal, 1008, 59.2, 557, 844, 27, 1428
peroxisome, 1619, 34.0, 11368, 7731, 346, 19445
perpetualmotion, 1355, 30.1, 474, 579, 63, 1116
perricida, 991, 88.7, 360, 334, 13, 707
perrix, 1424, 111.5, 3912, 4635, 402, 8949
perrycomo, 1166, 36.5, 2197, 2648, 126, 4971
perrypawnpusher, 1168, 37.5, 1576, 1646, 320, 3542
PerrythePlatypus, 1894, 100.0, 2806, 1401, 333, 4540
persevering, 988, 55.3, 70, 93, 1, 164
persianprince, 1818, 26.3, 2673, 2792, 209, 5674
perthao, 1152, 85.7, 47, 89, 3, 139
PERUJAW, 1490, 46.0, 339, 269, 31, 639
Pesboy, 1683, 50.5, 2463, 2320, 350, 5133
pessimist, 1174, 230.7, 2, 4, 0, 6
petaling, 1473, 25.4, 3070, 2375, 353, 5798
Petasluk, 1418, 24.7, 12581, 9579, 926, 23086
petenathan, 1236, 165.0, 89, 137, 12, 238
peterburger, 2070, 65.2, 1582, 906, 139, 2627
peterchristian, 1418, 33.5, 5873, 6918, 322, 13113
peterpuk, 1498, 79.9, 410, 181, 18, 609
peterskak, 1114, 31.2, 6499, 11041, 370, 17910
peterwaffles, 889, 118.4, 73, 169, 2, 244
PeterZakin, 1152, 64.5, 62, 95, 7, 164
petitours, 1096, 73.7, 939, 998, 58, 1995
petpet, 1357, 55.3, 1692, 2152, 160, 4004
petrisykari, 1608, 71.3, 160, 190, 20, 370
petrk, 1632, 106.2, 2585, 1848, 165, 4598
petrlimonov, 1521, 85.9, 1310, 973, 104, 2387
Petro, 1335, 42.1, 3118, 2930, 227, 6275
PetroChess, 1275, 42.3, 179, 227, 18, 424
PetrosianWall, 1610, 32.0, 8380, 9561, 710, 18651
PetrusAbelardus, 1588, 43.4, 1403, 1363, 187, 2953
PetterO, 1692, 31.8, 3787, 2358, 443, 6588
pettigb, 1035, 204.0, 1, 3, 0, 4
pettuu, 1702, 46.3, 432, 334, 44, 810
peysyguy, 865, 133.7, 7, 38, 0, 45
Pfiffikus, 1838, 40.4, 5056, 605, 106, 5767
pfleg, 1289, 26.0, 4754, 8008, 668, 13430
pgawagner, 1485, 167.0, 4, 4, 0, 8
PGII, 1453, 97.7, 2683, 2547, 347, 5577
pgok, 1161, 36.5, 10404, 13506, 1168, 25078
phactpatterns, 1302, 28.2, 2263, 3160, 283, 5706
phalanxx, 1019, 42.7, 141, 189, 8, 338
phallowes, 1397, 30.0, 2407, 2133, 110, 4650
Phantast, 1571, 62.9, 1134, 398, 89, 1621
PhantomFive, 1437, 40.5, 3671, 3373, 206, 7250
Pharmasplint, 1686, 28.7, 484, 328, 33, 845
Pharygula, 1594, 68.4, 168, 158, 10, 336
PHDrWesley, 1555, 136.6, 5, 7, 0, 12
Phenylalanine, 1216, 101.1, 190, 173, 8, 371
Phidell, 991, 132.3, 2, 14, 0, 16
Phigrin, 1289, 68.8, 2353, 3359, 270, 5982
PhiHa, 784, 167.4, 1, 14, 0, 15
phildefer, 1343, 87.1, 169, 126, 17, 312
phileasfog, 1472, 50.4, 5153, 9226, 590, 14969
Philidork, 992, 50.0, 459, 470, 22, 951
philippemuurmans, 1137, 26.4, 1762, 2457, 125, 4344
PhilippHeinke, 1636, 59.1, 2935, 1015, 132, 4082
phillipov, 1410, 133.4, 326, 257, 29, 612
phillipwharton, 1068, 139.8, 39, 109, 6, 154
PhillyLawyer, 774, 81.3, 100, 424, 9, 533
philmic, 1407, 31.0, 13941, 18133, 948, 33022
PhilOfive, 2081, 30.1, 8236, 4062, 1269, 13567
PhilosopherKing, 1485, 76.1, 507, 343, 42, 892
Philosophicus, 1387, 205.3, 97, 95, 8, 200
philverb, 1389, 49.1, 13662, 13898, 639, 28199
Phineasphreak, 814, 74.1, 10, 55, 0, 65
phlampe, 1369, 58.4, 279, 247, 19, 545
phlar, 1245, 90.3, 1350, 4248, 77, 5675
Phoeniks, 1470, 18.4, 6032, 5716, 775, 12523
PhoenixEight, 1467, 39.1, 736, 862, 49, 1647
PhoenixRisingSun, 932, 88.6, 11, 54, 0, 65
phono, 1202, 126.3, 1010, 938, 40, 1988
phontex, 1186, 70.0, 987, 765, 40, 1792
Photonz, 1587, 26.6, 4239, 5606, 390, 10235
photopaper, 1555, 28.1, 9725, 12200, 501, 22426
PhretBored, 1242, 43.6, 122, 120, 14, 256
Phto, 1470, 46.4, 4097, 2737, 398, 7232
Phychosis, 2080, 92.8, 3081, 2031, 324, 5436
pianazo, 1402, 28.1, 2161, 1901, 161, 4223
pianomambo, 1699, 105.1, 475, 588, 44, 1107
Picabia, 1522, 60.2, 2458, 9081, 772, 12311
Piccoloalfil, 1454, 102.2, 2235, 1574, 134, 3943
Pichonkun, 1154, 86.2, 660, 707, 37, 1404
Pickwick, 1597, 26.1, 6290, 8200, 652, 15142
picoy, 1644, 36.9, 838, 928, 146, 1912
PidyPlatsch, 877, 119.0, 9, 55, 0, 64
PieceByPiece, 1368, 63.9, 148, 93, 5, 246
PieceHunter, 1309, 35.8, 451, 590, 50, 1091
PieceOfCake, 1852, 44.9, 1309, 549, 94, 1952
piedazzo, 1723, 22.3, 16785, 23892, 2809, 43486
Pierlu, 1611, 30.8, 8969, 9067, 706, 18742
PierrePPaljas, 1109, 54.5, 257, 255, 14, 526
piersici, 1629, 33.6, 11209, 6094, 701, 18004
pieterpieter, 1265, 32.1, 4969, 6726, 390, 12085
pietwiet, 1422, 66.4, 5388, 4538, 547, 10473
PifGadget, 1268, 31.1, 2828, 2684, 191, 5703
pigeonflyer, 1771, 36.2, 2584, 2388, 240, 5212
pigsfeet, 1083, 42.4, 1959, 2856, 64, 4879
pijamale, 1542, 40.2, 3605, 2900, 398, 6903
pikkul, 1423, 84.5, 3002, 3694, 219, 6915
pikot, 1160, 33.1, 1834, 4565, 173, 6572
pilloman, 1567, 31.6, 4961, 5588, 340, 10889
PiMaster, 1431, 56.9, 1626, 866, 102, 2594
pimenteius, 1151, 36.6, 204, 358, 39, 601
pimpapawn, 1004, 78.8, 19, 11, 0, 30
Pinckman, 1172, 29.6, 1732, 2748, 94, 4574
pinehead, 1063, 26.2, 1257, 2232, 352, 3841
PingPongthePanda, 1762, 99.2, 955, 1509, 57, 2521
pingupenguin, 1640, 68.6, 2479, 2202, 133, 4814
pinkboat, 1463, 103.7, 1256, 1142, 128, 2526
PinkFloydWall, 1372, 25.6, 16095, 23186, 1598, 40879
Pinkgirl, 1588, 30.5, 7914, 4990, 677, 13581
Pinkot, 1538, 19.7, 6931, 6046, 407, 13384
pinokkio, 1580, 32.1, 13783, 18983, 1082, 33848
pinov, 1413, 44.9, 800, 1302, 118, 2220
pintersamu, 2122, 95.2, 964, 825, 130, 1919
pintomed, 1535, 35.9, 1120, 680, 77, 1877
piokot, 1529, 60.1, 3894, 4891, 302, 9087
PioKotMobile, 1265, 121.6, 14, 26, 0, 40
pion, 1463, 28.3, 35335, 22179, 1634, 59148
pioneerknight, 1213, 46.9, 1157, 1984, 102, 3243
Pionfou, 1728, 59.5, 1110, 487, 54, 1651
Pionoffer, 1599, 87.1, 904, 946, 119, 1969
pionpawn, 1315, 44.2, 511, 521, 37, 1069
PiperD, 1115, 91.7, 404, 639, 29, 1072
pipiduch, 1545, 106.1, 2104, 3127, 215, 5446
Pipo, 1502, 30.7, 11869, 13989, 471, 26329
PiranaLoco, 1293, 26.8, 5758, 6781, 393, 12932
pirhosigma, 1496, 122.7, 682, 480, 39, 1201
PisoMojado, 1386, 53.0, 203, 269, 28, 500
pistacchionero, 980, 66.8, 42, 165, 9, 216
Pitagoras, 1652, 39.1, 3082, 2041, 233, 5356
pitfall, 1108, 30.5, 8264, 6696, 442, 15402
Pitsis, 1369, 68.8, 1046, 754, 67, 1867
Pivljanin, 833, 101.2, 16, 47, 2, 65
Pixar, 1109, 60.7, 251, 443, 18, 712
pixel, 1718, 182.2, 5407, 5242, 610, 11259
pixfan, 1643, 27.9, 3015, 2265, 366, 5646
pizzabox, 1334, 31.5, 2485, 4014, 273, 6772
PizzaMadness, 1462, 53.8, 846, 673, 101, 1620
pjbuijs, 1507, 39.9, 5008, 4560, 468, 10036
PJDLH, 937, 55.9, 111, 216, 11, 338
Pjking, 1107, 154.9, 4, 7, 1, 12
PjotrO, 1085, 41.4, 1771, 1562, 98, 3431
PJROAK, 1123, 72.7, 1660, 986, 113, 2759
pkeetingphd, 1204, 93.4, 323, 354, 24, 701
PKPKPKPKP, 1765, 41.4, 840, 1359, 195, 2394
pkpl, 1194, 95.9, 22, 30, 2, 54
PKT, 804, 109.0, 4, 27, 0, 31
Plafond, 1429, 43.0, 1613, 2044, 157, 3814
plage, 1471, 36.8, 2750, 2771, 330, 5851
plakburdang, 1562, 29.9, 14616, 9166, 1214, 24996
plam, 1149, 87.8, 235, 250, 20, 505
planlose, 1887, 64.7, 2288, 631, 149, 3068
plasa, 1633, 39.8, 2800, 2945, 191, 5936
PlastikSoul, 1227, 75.8, 194, 181, 5, 380
platinumbus, 1125, 37.4, 365, 479, 40, 884
PlatinumEmpire, 1018, 64.0, 83, 137, 1, 221
PlatinumKnight, 1099, 61.8, 13888, 18007, 758, 32653
PlayaPascual, 1143, 105.8, 373, 457, 14, 844
PlayerForFun, 1538, 24.7, 21368, 20549, 1786, 43703
PlayerPCG, 1097, 37.7, 831, 2036, 35, 2902
playerX, 1509, 49.9, 9025, 4542, 677, 14244
playfast, 1600, 24.1, 417, 637, 64, 1118
playingforfun, 1275, 29.0, 5101, 10213, 624, 15938
playoften, 1606, 24.4, 9509, 11072, 1152, 21733
playtoton, 1681, 87.5, 10010, 7464, 415, 17889
pleaseletmewin, 1539, 32.2, 4075, 7637, 381, 12093
Pletnev, 1611, 38.7, 1079, 630, 56, 1765
plexer, 1743, 25.1, 1161, 420, 49, 1630
Pliattal, 1160, 61.9, 654, 1286, 64, 2004
Pliquer, 1672, 75.7, 1564, 1394, 60, 3018
Plord, 1277, 46.3, 1110, 1429, 84, 2623
plotkin, 1234, 38.1, 3556, 6736, 433, 10725
PLUGZ, 779, 126.8, 46, 164, 5, 215
plums, 1444, 29.6, 7879, 6546, 460, 14885
PLURkidIT, 1570, 36.8, 3414, 3825, 228, 7467
plutarquito, 1833, 119.3, 893, 692, 100, 1685
plutonas, 1129, 51.2, 341, 521, 34, 896
plutonianavenger, 1203, 69.4, 23, 21, 2, 46
plutoniumxxx, 1080, 29.6, 1068, 1063, 40, 2171
pmackinney, 1293, 41.8, 11595, 14397, 659, 26651
pmeat, 980, 24.2, 871, 2600, 35, 3506
PMesquita, 1634, 74.9, 2346, 1355, 98, 3799
pmipmi, 1556, 29.9, 204, 122, 12, 338
pmsd, 1344, 64.3, 788, 904, 75, 1767
pnicolas, 1579, 21.7, 12021, 12059, 1033, 25113
PnTinh, 1422, 30.3, 2658, 2174, 321, 5153
pochemychker, 1514, 38.8, 2487, 1428, 213, 4128
Pocho, 1140, 34.6, 911, 972, 93, 1976
pochoclosalado, 1569, 116.1, 584, 594, 56, 1234
POCKETWATCH, 1016, 26.6, 2003, 4970, 230, 7203
podian, 1529, 127.3, 521, 374, 27, 922
Podjevsky, 1561, 31.1, 5610, 4882, 392, 10884
PoindexterIII, 1578, 19.6, 13855, 11653, 1574, 27082
pointenoire, 1515, 21.4, 847, 962, 67, 1876
pointofturnon, 1425, 44.5, 1552, 3762, 109, 5423
Pointtaken, 866, 159.0, 4, 15, 0, 19
poisonshot, 1303, 25.9, 1258, 1636, 63, 2957
pokejohan, 820, 67.4, 79, 360, 6, 445
pokerdude, 1794, 43.2, 965, 719, 43, 1727
pokernut, 1161, 37.9, 2478, 2919, 260, 5657
Poketato, 1882, 303.4, 1, 0, 0, 1
pokrate, 1574, 151.4, 101, 101, 4, 206
Polaf, 1192, 128.5, 3, 8, 0, 11
Polarised, 1639, 28.0, 5405, 6644, 524, 12573
Polarisman, 1622, 21.5, 9755, 10558, 749, 21062
polbor, 1764, 86.5, 8490, 5133, 843, 14466
polfilter, 1651, 135.2, 26, 10, 2, 38
poliponius, 1262, 98.5, 167, 149, 8, 324
PolishedBishop, 1098, 77.3, 69, 128, 4, 201
polite, 1695, 29.7, 26726, 27822, 2663, 57211
polosjdb, 1326, 38.1, 292, 364, 24, 680
Polotto, 1262, 82.9, 3504, 5275, 349, 9128
PolSe, 1315, 40.8, 1895, 1019, 100, 3014
polyhedron, 1394, 82.9, 293, 303, 19, 615
polyman, 1360, 25.4, 4519, 3099, 301, 7919
Polypheme, 1473, 61.4, 193, 262, 17, 472
polysciguy, 936, 107.1, 110, 284, 6, 400
pomerol, 1535, 50.0, 1476, 930, 239, 2645
pompier, 1594, 61.6, 219, 261, 26, 506
ponchoalv, 1563, 34.9, 486, 694, 39, 1219
Pondeone, 1365, 96.3, 513, 587, 69, 1169
PonderOn, 1194, 41.9, 4884, 4108, 386, 9378
Ponderthis, 1583, 27.3, 4100, 3212, 296, 7608
PongBoy, 1075, 39.3, 114, 158, 12, 284
PonyAndPawnLove, 1565, 23.7, 6692, 5144, 720, 12556
PookaShells, 1309, 28.6, 636, 431, 37, 1104
poorking, 1232, 45.1, 2101, 2001, 118, 4220
PoorPawn, 1337, 29.2, 6439, 6623, 809, 13871
poovi, 1074, 33.7, 982, 816, 62, 1860
popadopolis, 1301, 29.3, 2292, 2730, 235, 5257
popasile, 1364, 28.1, 5755, 10247, 749, 16751
popeII, 1214, 34.5, 968, 1599, 131, 2698
popiol, 1757, 35.9, 1891, 752, 156, 2799
popmanzxz, 1419, 64.7, 669, 660, 18, 1347
popovitch, 1093, 57.5, 373, 559, 54, 986
poppie, 1342, 40.3, 5393, 5905, 436, 11734
poppies, 1653, 21.7, 6814, 6018, 580, 13412
poppopjh, 1139, 41.7, 1377, 1203, 84, 2664
poptech, 1455, 65.2, 686, 949, 117, 1752
porcino, 1286, 39.8, 193, 112, 13, 318
porfavor, 1148, 30.4, 8572, 10869, 718, 20159
portcontrol, 1232, 194.4, 2, 3, 0, 5
Portillo, 1376, 95.9, 271, 301, 33, 605
posi, 1259, 35.4, 656, 687, 51, 1394
positiv, 1464, 52.5, 659, 1239, 69, 1967
posixstar, 1243, 73.9, 32, 25, 2, 59
posted, 1509, 32.4, 8024, 9966, 848, 18838
Pota, 1666, 120.6, 240, 261, 10, 511
potentia, 1163, 53.2, 78, 127, 4, 209
potosi, 1453, 26.3, 153, 96, 11, 260
potts, 1182, 34.5, 1390, 1561, 78, 3029
potuz, 1377, 30.7, 5777, 4998, 415, 11190
poubas, 2031, 40.6, 435, 481, 39, 955
poway, 1194, 54.9, 350, 265, 84, 699
powerchesss, 1370, 51.3, 77, 154, 15, 246
PoweredON, 1033, 86.7, 35, 108, 3, 146
PowerEngineer, 1642, 30.4, 750, 418, 18, 1186
powerknight, 1355, 120.7, 1469, 1325, 134, 2928
PowerLess, 1497, 29.5, 2193, 2844, 195, 5232
Powerlord, 1510, 58.6, 2094, 3359, 142, 5595
PowerMan, 1264, 87.0, 1496, 2234, 128, 3858
powerofgreyskull, 1139, 42.3, 415, 593, 21, 1029
PowerPudding, 1471, 35.1, 863, 717, 73, 1653
Powersurg, 1016, 116.1, 34, 47, 4, 85
ppasha, 1295, 50.5, 1355, 1960, 112, 3427
ppcoach, 1033, 33.3, 1229, 1667, 133, 3029
ppgoulart, 1537, 34.7, 10633, 6875, 489, 17997
ppl, 2064, 218.3, 4, 2, 0, 6
ppluche, 1574, 23.9, 6876, 9437, 1054, 17367
ppriolo, 1046, 56.5, 127, 203, 3, 333
ppttpptt, 1118, 34.3, 2248, 3794, 77, 6119
PPXAKE, 2000, 20.3, 5352, 6146, 770, 12268
pracasan, 1250, 42.3, 699, 643, 46, 1388
prachanda, 1584, 43.3, 12635, 10590, 587, 23812
Prachtschach, 1335, 27.2, 1576, 1791, 119, 3486
pradeepm, 1442, 75.9, 392, 255, 22, 669
PRadSkooldU, 1195, 56.1, 730, 796, 40, 1566
praealtus, 1002, 73.0, 1368, 1884, 63, 3315
Pragenius, 1181, 108.0, 597, 858, 63, 1518
Praha, 1153, 35.3, 1657, 1907, 204, 3768
Prahs, 1918, 67.7, 199, 168, 12, 379
prakaash, 1397, 58.7, 1084, 995, 35, 2114
Prakasham, 937, 136.5, 2, 15, 0, 17
prakashnaraine, 1046, 28.0, 678, 961, 41, 1680
PramitRJ, 1105, 140.0, 0, 12, 0, 12
pranavpd, 1436, 64.2, 1760, 2918, 269, 4947
prasadchess, 1905, 148.4, 6, 5, 0, 11
Prasetya, 981, 138.6, 39, 92, 5, 136
Prashantpereira, 1252, 82.3, 1659, 2243, 185, 4087
prathe, 947, 120.3, 26, 47, 2, 75
prathi, 1389, 41.7, 2489, 1872, 147, 4508
pratmanu, 1128, 33.5, 485, 581, 33, 1099
prattchie, 1693, 48.2, 936, 1229, 113, 2278
PravinMamania, 937, 42.5, 2865, 5122, 212, 8199
prawngrabber, 1395, 27.5, 1758, 1212, 299, 3269
Predatorone, 1685, 47.3, 13546, 17671, 1465, 32682
predkoo, 1554, 161.7, 109, 153, 18, 280
Preethoney, 769, 78.9, 39, 274, 2, 315
premed, 1281, 27.2, 888, 1365, 58, 2311
PREMK, 1295, 69.1, 1435, 1753, 161, 3349
preparationH, 1599, 41.6, 2615, 1177, 218, 4010
Preserve, 1156, 32.4, 402, 561, 24, 987
PRESIDENTBG, 1434, 26.7, 430, 315, 34, 779
Pressurepoint, 1294, 71.1, 1005, 1562, 94, 2661
Pressurepoints, 1159, 24.6, 224, 495, 6, 725
PrettyAnand, 1366, 28.6, 121, 131, 13, 265
PrettyboyBry, 1024, 134.7, 8, 26, 1, 35
PrettyHateMachine, 1708, 33.6, 449, 246, 21, 716
pretythesame, 1273, 32.6, 1781, 2210, 139, 4130
Pretzels, 1300, 33.3, 3073, 2033, 146, 5252
PREVAIL, 2002, 30.8, 2970, 2275, 208, 5453
priapisme, 1834, 70.6, 1802, 1856, 313, 3971
prideofapatzer, 1992, 112.4, 343, 383, 33, 759
priertoujours, 1592, 28.7, 732, 523, 101, 1356
Prieto, 738, 155.7, 3, 18, 0, 21
prikitiew, 1400, 46.0, 121, 167, 3, 291
PrimaPutra, 1472, 131.5, 10, 25, 1, 36
primitive, 1538, 79.4, 357, 157, 28, 542
primitivepainting, 1729, 40.3, 5622, 2165, 435, 8222
PrimorisLudus, 1300, 61.6, 1554, 1416, 147, 3117
princelyknight, 1192, 73.4, 607, 729, 31, 1367
PrinceOfTrinidad, 1166, 125.8, 13, 15, 3, 31
PrinceOrpheus, 1183, 115.5, 96, 145, 11, 252
princess, 2016, 34.4, 23367, 17955, 1628, 42950
prinsvaldemar, 1390, 47.5, 413, 326, 24, 763
priorityversion, 1752, 32.5, 286, 151, 18, 455
prismax, 993, 34.8, 672, 1476, 32, 2180
prisoner, 1264, 31.1, 6390, 10370, 913, 17673
privateschultz, 1419, 303.5, 1, 1, 0, 2
PriyatnO, 1268, 250.4, 2, 4, 0, 6
prmas, 1194, 104.0, 31, 90, 0, 121
Procter, 1163, 39.6, 714, 724, 40, 1478
procyk, 1723, 109.5, 110, 104, 13, 227
professorturnkey, 1126, 102.1, 6, 12, 1, 19
ProfPumpkin, 1396, 26.1, 2147, 2848, 63, 5058
progettoide, 1417, 23.4, 5043, 4598, 557, 10198
Programmerskills, 1242, 178.0, 2, 3, 0, 5
progResiVoOo, 1163, 37.3, 1073, 727, 18, 1818
Prohravac, 1281, 33.9, 3146, 3209, 243, 6598
ProjectZero, 1139, 167.5, 3, 35, 0, 38
Prokolab, 1924, 72.0, 1963, 2376, 325, 4664
Prokop, 1386, 129.7, 2422, 2249, 279, 4950
ProletarianPawn, 1521, 65.7, 4018, 3076, 237, 7331
prologman, 1337, 51.2, 937, 1244, 73, 2254
proma, 1717, 29.5, 1146, 975, 144, 2265
PromoteToKing, 1256, 50.8, 169, 502, 10, 681
PromptCritical, 1417, 48.4, 3142, 3628, 464, 7234
proofzzh, 1427, 105.1, 2725, 1601, 206, 4532
Prophead, 923, 36.5, 70, 120, 12, 202
proppsson, 1248, 34.2, 222, 212, 19, 453
Propugnator, 1820, 57.3, 773, 636, 120, 1529
Prosperace, 1676, 33.8, 6879, 3268, 452, 10599
prostate, 1195, 47.4, 454, 725, 60, 1239
PROSTOR, 1402, 25.6, 400, 227, 21, 648
ProstoUK, 990, 47.4, 300, 562, 22, 884
Protoporphyrin, 1407, 37.4, 140, 70, 7, 217
protosx, 1339, 37.9, 1967, 3257, 262, 5486
prototypemaster, 1134, 101.5, 26, 143, 2, 171
proudf, 1721, 33.3, 5299, 5875, 989, 12163
provenance, 1302, 85.5, 3448, 3545, 139, 7132
provost, 1412, 25.9, 8030, 10857, 808, 19695
prstephens, 1289, 77.1, 56, 72, 7, 135
PrtgsMnWr, 1209, 32.1, 895, 1392, 63, 2350
prudhvinlrchess, 894, 250.1, 0, 3, 0, 3
PScientist, 720, 89.2, 6, 58, 0, 64
pseudoconformal, 1233, 49.5, 1031, 1075, 98, 2204
pshaark, 1452, 54.2, 1088, 648, 46, 1782
psiloveyou, 1111, 313.6, 0, 2, 0, 2
Psolis, 1717, 80.2, 9701, 10967, 1247, 21915
PSpalek, 1336, 91.2, 18, 29, 1, 48
psrock, 1394, 29.2, 2041, 2102, 183, 4326
Psunil, 1114, 136.2, 1, 8, 0, 9
PSX, 1145, 48.4, 81, 139, 9, 229
PsychoGod, 1479, 35.8, 16031, 7301, 614, 23946
Psychovich, 938, 169.2, 0, 5, 0, 5
Psythagoras, 1240, 113.1, 184, 317, 24, 525
ptaha, 1025, 46.8, 320, 608, 78, 1006
ptd, 1557, 33.0, 4586, 6899, 363, 11848
Ptera, 1145, 74.9, 253, 238, 18, 509
ptistorm, 1375, 73.5, 8958, 9189, 393, 18540
ptmitch, 1369, 64.9, 1663, 1215, 171, 3049
ptrsi, 1252, 50.2, 1082, 832, 65, 1979
ptu, 1845, 53.0, 1593, 987, 128, 2708
ptzv, 1316, 36.0, 314, 362, 19, 695
pualkemp, 757, 152.8, 2, 19, 0, 21
pubiss, 839, 111.6, 3, 54, 0, 57
puchomyh, 1521, 81.6, 2412, 2238, 166, 4816
Puckster, 870, 350.0, 1, 8, 0, 9
pugnani, 1584, 38.8, 67, 29, 9, 105
pugoy, 1060, 103.0, 16, 88, 0, 104, 1405, 56.1, 2296, 3687, 269, 6252
pulsefrequency, 1868, 25.0, 2802, 3636, 254, 6692
pulsoste, 1849, 22.6, 1053, 1438, 157, 2648
Pumpernickel, 1188, 25.3, 553, 736, 65, 1354
pundai, 1452, 83.1, 980, 757, 66, 1803
punkbass, 1421, 30.8, 1963, 1942, 88, 3993
punthala, 880, 213.6, 0, 4, 0, 4
purcotes, 1542, 98.4, 405, 197, 29, 631
purduecruiser, 595, 280.2, 0, 3, 0, 3
PureEnergy, 1407, 61.4, 291, 299, 7, 597
Purevegas, 990, 43.2, 244, 260, 22, 526
purmerronnie, 1458, 78.7, 2357, 1457, 155, 3969
purplebaboonbutt, 981, 81.2, 261, 192, 23, 476
purplechess, 1431, 18.7, 7130, 7103, 856, 15089
Purpleflare, 1185, 75.1, 240, 257, 10, 507
Purplesock, 1093, 69.3, 439, 619, 19, 1077
purplewizard, 1638, 34.2, 6254, 4828, 611, 11693
pursinge, 1227, 80.0, 272, 175, 12, 459
pushingpawns, 1100, 68.2, 166, 232, 39, 437
PushKid, 1312, 38.6, 2018, 2288, 186, 4492
Pushkin, 1339, 21.5, 17110, 30392, 2352, 49854
pushkinfan, 1457, 48.1, 2013, 2254, 506, 4773
pussa, 1465, 41.7, 1838, 1076, 93, 3007
PuSsNbOoTs, 810, 131.5, 5, 19, 0, 24
puthoor, 1238, 66.2, 223, 178, 6, 407
putoblastion, 1108, 54.7, 3910, 4419, 271, 8600
putrapetir, 1448, 109.4, 91, 68, 4, 163
putsgrilo, 1603, 87.9, 1237, 1230, 69, 2536
putsy, 1662, 89.4, 183, 86, 10, 279
putthatback, 1480, 50.8, 1928, 1494, 112, 3534
putzer, 1351, 42.7, 3064, 5136, 292, 8492
Puuheppa, 1144, 51.7, 648, 639, 44, 1331
puzman, 1486, 24.8, 8817, 11883, 739, 21439
PuzzledPerson, 1005, 34.2, 516, 752, 41, 1309
Puzzlemania, 1477, 143.8, 308, 234, 22, 564
puzzlemethis, 1471, 31.6, 568, 1093, 70, 1731
pvdha, 1030, 41.7, 1002, 1344, 92, 2438
Pwelkagrater, 1724, 123.5, 388, 35, 10, 433
pwjohnson, 1288, 35.3, 15878, 18126, 2449, 36453
pwnedmate, 1275, 198.6, 2, 3, 0, 5
PWYMike, 860, 99.6, 242, 268, 14, 524
pyroarchangel, 1568, 70.8, 53, 41, 4, 98
PyroFire, 1579, 186.6, 455, 394, 18, 867
pyroflight, 1421, 42.5, 162, 162, 16, 340
Pyromonkeyac, 1106, 56.4, 576, 711, 63, 1350
pyronaut, 1080, 68.7, 1104, 1833, 60, 2997
pyshkinguth, 949, 58.0, 228, 252, 22, 502
Pystota, 1524, 40.4, 1927, 3054, 466, 5447
pyxis, 1248, 65.5, 1656, 1233, 116, 3005
PZaas, 1527, 30.5, 1366, 795, 58, 2219
QaD, 1408, 117.7, 3997, 3419, 357, 7773
Qauz, 1640, 43.0, 2461, 2250, 311, 5022
qcp, 1346, 100.6, 23, 30, 1, 54
qct, 1077, 29.0, 9557, 15561, 1014, 26132
qgd, 1506, 25.7, 10916, 11600, 1910, 24426
QhwaraX, 1609, 38.4, 1618, 1615, 158, 3391
qianjie, 1127, 160.5, 0, 8, 0, 8
qiaozhi, 1097, 28.3, 2333, 4797, 261, 7391
qingtianliu, 942, 114.5, 18, 52, 2, 72
qingxiang, 1150, 274.4, 1, 1, 0, 2
QJK, 1374, 33.5, 5302, 12018, 319, 17639
qjuice, 1774, 25.7, 17967, 15135, 1670, 34772
qkrwldnjs, 939, 213.1, 0, 3, 0, 3
qmorf, 1872, 38.1, 8518, 6392, 810, 15720
qoop, 1213, 64.5, 367, 468, 23, 858
QRayZ, 1331, 70.1, 434, 257, 10, 701
QRFC, 1447, 247.1, 0, 2, 0, 2
qsasha, 1702, 38.0, 3654, 1904, 264, 5822
QuanticDream, 1364, 39.1, 757, 1356, 77, 2190
quantumcloud, 859, 99.3, 70, 194, 3, 267
QuasarRed, 1524, 45.1, 3014, 2548, 305, 5867
quasimodem, 1351, 23.2, 10688, 12839, 904, 24431
Quasiuna, 1139, 111.2, 591, 429, 17, 1037
Quatari, 1212, 39.6, 2790, 1510, 151, 4451
quatreoctobre, 1616, 30.7, 1479, 1408, 115, 3002
Quattal, 1502, 52.0, 360, 349, 50, 759
quazy, 1391, 93.6, 14, 14, 1, 29
qubaliqaqash, 1288, 105.5, 266, 478, 19, 763
QueenChessy, 1387, 61.8, 1980, 2373, 85, 4438
QueenChomper, 1396, 38.2, 2639, 2547, 128, 5314
queenforker, 1268, 81.2, 164, 115, 24, 303
Queenhanger, 1662, 123.9, 959, 575, 49, 1583
QueenKillir, 815, 114.6, 28, 74, 2, 104
QueenLau, 936, 73.2, 15, 31, 0, 46
queenmolester, 1258, 337.7, 0, 1, 0, 1
QueenNatalie, 998, 99.4, 7, 12, 3, 22
QueenofScots, 1080, 33.8, 2593, 3773, 158, 6524
queenshunter, 1885, 54.3, 1556, 1164, 148, 2868
quelg, 1571, 26.6, 3290, 2916, 179, 6385
quenderin, 1478, 105.4, 1300, 845, 89, 2234
QuentinCassidy, 1484, 40.3, 683, 965, 72, 1720
quentinfuller, 1024, 116.0, 5, 23, 0, 28
Questalot, 856, 252.4, 5, 24, 0, 29
quickfist, 1645, 57.8, 9274, 10942, 1758, 21974
Quien, 759, 78.5, 50, 255, 7, 312
quietfish, 1373, 91.3, 19, 12, 1, 32
quiguisola, 1636, 22.7, 192, 192, 9, 393
quiksand, 1135, 106.1, 69, 52, 0, 121
quintic, 1380, 39.6, 6764, 5660, 442, 12866
quiqueguerra, 1419, 24.0, 20932, 24444, 1895, 47271
QuirinusRomulus, 1522, 57.3, 1542, 1148, 73, 2763
quiteirate, 1293, 31.3, 442, 496, 35, 973
QuixoticWindmill, 1312, 126.9, 22, 33, 6, 61
Quizzler, 1055, 126.4, 469, 680, 52, 1201
Quomo, 1675, 42.2, 6922, 3618, 725, 11265
ququshka, 1250, 94.7, 8, 17, 2, 27
QxQ, 1151, 28.5, 6946, 9608, 983, 17537
Raabe, 962, 114.6, 32, 83, 1, 116
Rabanal, 1766, 35.7, 2224, 853, 90, 3167
raberbar, 1661, 36.4, 4673, 4596, 1231, 10500
rabinix, 1418, 32.9, 509, 778, 125, 1412
racameron, 900, 162.7, 3, 10, 0, 13
raccoonmario, 1096, 28.3, 513, 601, 47, 1161
RaceBannon, 1598, 28.0, 3615, 4614, 420, 8649
racerxracerx, 1591, 29.5, 3505, 3146, 257, 6908
raconteur, 902, 116.7, 42, 84, 1, 127
radagaisus, 843, 112.0, 10, 47, 0, 57
radare, 1273, 60.1, 1362, 1374, 56, 2792
radart, 1255, 45.2, 483, 702, 62, 1247
raddala, 1455, 28.0, 5474, 5020, 665, 11159
Rade, 1575, 33.0, 17735, 13742, 961, 32438
radicaldude, 1151, 55.2, 79, 134, 7, 220
radioactivity, 1409, 30.2, 5432, 6445, 443, 12320
radioglue, 1275, 66.6, 307, 341, 27, 675
Radmcbad, 1068, 40.6, 190, 144, 7, 341
Radorf, 1468, 31.4, 1977, 1303, 127, 3407
raebigoy, 1387, 35.1, 598, 745, 64, 1407
Raevegas, 1133, 31.4, 4092, 6819, 279, 11190
rafaelvamos, 1519, 46.4, 217, 144, 13, 374
RAFALKOSTECKI, 1710, 27.7, 2983, 2207, 271, 5461
rafalski, 1454, 51.2, 207, 107, 10, 324
RafaNadal, 1489, 23.7, 1069, 1118, 103, 2290
Rafase, 983, 143.5, 16, 16, 1, 33
RafchessII, 1682, 30.4, 4587, 5325, 419, 10331
raffa, 1513, 17.3, 21046, 28361, 1396, 50803
RafiChowdhury, 1559, 59.7, 641, 283, 74, 998
rafiek, 1545, 32.8, 1903, 1226, 122, 3251
RaftaMan, 1151, 350.0, 1, 3, 1, 5
rag, 1618, 151.9, 1081, 517, 37, 1635
ragar, 1380, 36.1, 7116, 6627, 500, 14243
ragazzino, 1561, 32.5, 100, 131, 13, 244
Ragdoll, 1108, 60.3, 5117, 6062, 474, 11653
rageahol, 949, 48.2, 65, 86, 2, 153
RageET, 1647, 39.5, 142, 158, 9, 309
ragez, 1951, 29.9, 5322, 3114, 564, 9000
raghusm, 1327, 54.1, 688, 698, 45, 1431
RagingChess, 1622, 30.9, 1537, 1915, 197, 3649
ragingmr, 1565, 35.4, 515, 291, 50, 856
RagingRookCrook, 1412, 68.4, 118, 154, 17, 289
RAHEEM, 1137, 43.8, 2215, 3257, 181, 5653
rahmat, 1456, 103.2, 21618, 19250, 3137, 44005
RahulDravid, 1559, 47.0, 1011, 1919, 107, 3037
RaikvaWithCart, 874, 137.1, 61, 265, 0, 326
rainrop, 1507, 36.6, 188, 373, 8, 569
raipeldo, 1886, 51.0, 1221, 879, 182, 2282
RaisAn, 1552, 34.6, 289, 329, 20, 638
Raisha, 1515, 35.1, 8001, 4907, 686, 13594
raisinman, 1960, 23.6, 6557, 5381, 705, 12643
raisona, 767, 114.6, 68, 182, 0, 250
rajachola, 1187, 51.2, 778, 1006, 39, 1823
RajaRajaCholan, 1310, 83.5, 4868, 9461, 698, 15027
rajat, 1688, 36.2, 2097, 1541, 179, 3817
rajatrulz, 1419, 40.6, 3437, 6830, 416, 10683
RajChauhan, 1079, 87.9, 2208, 4329, 75, 6612
rajeshlovemamatha, 1019, 182.4, 0, 4, 0, 4
rajeshwar, 1435, 37.0, 11711, 14848, 747, 27306
rajganapathi, 1013, 106.6, 292, 435, 32, 759
rajibkudas, 1102, 342.3, 0, 1, 0, 1
rajpal, 1128, 88.1, 350, 555, 21, 926
rajputanawarriors, 913, 98.3, 10, 101, 1, 112
rajsingh, 1148, 49.0, 986, 1356, 37, 2379
rajto, 1401, 50.2, 333, 538, 28, 899
Raju, 1515, 48.9, 7661, 13636, 1244, 22541
rakk, 1141, 87.4, 231, 281, 10, 522
Rakkan, 1017, 92.6, 105, 187, 13, 305
ramac, 1458, 25.7, 857, 1307, 88, 2252
ramagonono, 1047, 128.5, 176, 182, 16, 374
Ramanujam, 987, 122.0, 9, 30, 0, 39
rambis, 1558, 26.7, 11187, 18691, 1087, 30965
RAMBLEBOY, 1714, 122.1, 5064, 4162, 191, 9417
Rambriz, 1151, 75.3, 42, 31, 3, 76
ramdoor, 1116, 71.0, 283, 312, 8, 603
RameshChess, 1120, 142.3, 3, 11, 0, 14
rameshsrivats, 1513, 23.2, 6583, 4859, 563, 12005
RamHammer, 1061, 72.2, 163, 239, 15, 417
ramikishek, 1146, 113.3, 1355, 4075, 90, 5520
raminsoli, 1623, 95.3, 978, 771, 54, 1803
Ramisis, 1485, 84.9, 560, 402, 15, 977
Ramlall, 1827, 113.3, 3727, 4116, 406, 8249
ramparashar, 1621, 19.9, 11055, 7674, 702, 19431
ramposki, 707, 90.6, 5, 22, 0, 27
Ramrusher, 1309, 79.8, 1058, 2210, 163, 3431
RamsesIII, 1635, 31.3, 2903, 2904, 408, 6215
Ramsesortiz, 897, 157.1, 7, 21, 0, 28
ranadipb, 1562, 37.4, 2363, 4739, 258, 7360
ranban, 1291, 83.5, 3086, 5890, 303, 9279
Ranbo, 1125, 60.3, 1264, 1198, 75, 2537
Rand, 1458, 78.6, 711, 572, 60, 1343
Randel, 952, 144.7, 15, 22, 2, 39
randomgonzo, 1367, 37.4, 2508, 2022, 153, 4683
RandomRick, 1454, 32.6, 5812, 6761, 435, 13008
randspringer, 1270, 22.2, 6614, 8075, 554, 15243
ranga, 1632, 37.6, 1120, 1533, 113, 2766
ranger, 1679, 51.0, 4574, 7478, 543, 12595
RangerE, 1056, 346.3, 0, 1, 0, 1
rangerook, 1344, 28.0, 366, 518, 46, 930
ranjitbok, 1128, 50.8, 203, 227, 32, 462
rantelg, 1317, 106.1, 1047, 963, 114, 2124
raouf, 1302, 45.1, 973, 1376, 81, 2430
Raph, 1806, 53.4, 15932, 10794, 1101, 27827
raphealBlue, 1465, 46.7, 1330, 918, 99, 2347
rapidhemu, 1398, 60.0, 949, 946, 63, 1958
RapidHorror, 1161, 54.8, 3721, 4835, 424, 8980
rapukalle, 1417, 28.0, 1129, 995, 66, 2190
Rapwat, 1344, 66.4, 1813, 2207, 131, 4151
RaquelC, 985, 68.9, 14, 15, 0, 29
rargos, 1543, 31.3, 6914, 6888, 993, 14795
Rarra, 1374, 32.7, 2020, 3127, 246, 5393
rasbauman, 1360, 133.0, 2681, 2182, 293, 5156
Rascian, 1690, 54.1, 812, 772, 53, 1637
rasek, 1239, 203.2, 2, 4, 0, 6
Rashidm, 1373, 25.3, 1087, 1291, 58, 2436
Rasikaperera, 925, 62.7, 105, 490, 14, 609
rask, 1400, 46.7, 3272, 1502, 312, 5086
raskerino, 1859, 29.2, 1671, 1480, 258, 3409
rasoha, 1414, 23.6, 4908, 4758, 410, 10076
Rasquinho, 1297, 25.7, 6292, 8924, 476, 15692
rastaking, 1139, 39.5, 466, 606, 58, 1130
ratherbesailing, 1386, 30.9, 1067, 876, 102, 2045
ratherBmating, 1180, 27.7, 2506, 4825, 57, 7388
Ratley, 1472, 26.9, 12071, 9606, 1231, 22908
Ratouau, 1193, 105.3, 111, 134, 7, 252
RattyMouse, 1340, 27.7, 6435, 5478, 405, 12318
raveline, 1173, 62.0, 512, 325, 20, 857
raven, 1960, 60.8, 2497, 1455, 247, 4199
ravenwolf, 1142, 87.1, 336, 332, 49, 717
Raveswan, 1322, 26.0, 1543, 1858, 84, 3485
RAVIKANTH, 1091, 53.5, 1885, 4268, 61, 6214
RavingEagle, 1170, 39.9, 1146, 3441, 74, 4661
ravirgti, 1079, 177.2, 2, 6, 0, 8
raviven, 1498, 29.5, 13419, 7511, 582, 21512
RavKK, 1604, 124.7, 196, 293, 13, 502
ravler, 1513, 279.8, 1, 1, 0, 2
ravnos, 1985, 91.2, 168, 119, 6, 293
ravshansbox, 1387, 68.7, 288, 450, 14, 752
RawAddict, 1563, 83.5, 307, 304, 20, 631
rawdavidc, 1166, 51.4, 798, 817, 77, 1692
RAYDKILLER, 1362, 37.0, 819, 554, 83, 1456
RayM, 1112, 41.8, 748, 781, 60, 1589
Rayqian, 1276, 110.6, 108, 157, 4, 269
raysfan, 1267, 26.0, 1089, 1784, 53, 2926
Razavilli, 1615, 81.9, 1765, 1793, 115, 3673
RazC, 1191, 67.5, 183, 210, 8, 401
razdan, 1360, 26.5, 22851, 22219, 1783, 46853
Razinator, 1318, 21.0, 554, 557, 80, 1191
razrez, 1473, 69.5, 186, 216, 22, 424
razvanc, 1471, 33.2, 5225, 6115, 438, 11778
rback, 1227, 56.2, 696, 777, 18, 1491
rband, 1429, 84.9, 3173, 2672, 327, 6172
rbgray, 1438, 26.4, 10729, 12728, 832, 24289
rbnn, 1663, 33.0, 1926, 2171, 250, 4347
RBurg, 1625, 25.3, 6150, 5084, 675, 11909
Rdgrdg, 880, 78.2, 17, 47, 1, 65
RDog, 1287, 37.2, 3245, 3318, 380, 6943
rdrdrdrd, 1378, 73.0, 67, 252, 12, 331
rdw, 1601, 30.2, 10644, 3486, 1223, 15353
readytofight, 1901, 100.8, 109, 301, 28, 438
realbeandip, 1082, 108.5, 427, 440, 35, 902
RealHuman, 1434, 22.9, 27176, 30481, 1668, 59325
realistknight, 1064, 75.7, 308, 340, 25, 673
ReAlizzo, 1464, 30.4, 518, 424, 23, 965
ReallyBadPlayer, 1262, 37.2, 5787, 7225, 322, 13334
realproto, 1382, 70.6, 416, 719, 31, 1166
RealUlysse, 1355, 49.6, 1492, 1727, 139, 3358
rebounded, 1191, 46.7, 485, 717, 30, 1232
Reconquistador, 1729, 90.5, 1839, 140, 28, 2007
recordingsponges, 1620, 28.6, 1685, 1761, 169, 3615
redbeast, 1093, 262.6, 1, 2, 0, 3
redbud, 1401, 113.3, 88, 110, 19, 217
RedCasey, 701, 86.5, 17, 58, 0, 75
ReDelSilenzio, 1167, 115.0, 175, 336, 5, 516
rederik, 1457, 40.7, 2789, 3898, 271, 6958
redeyeblind, 1540, 43.9, 2768, 2866, 319, 5953
redeyedmaster, 1330, 87.0, 76, 86, 3, 165
redgolfball, 1025, 63.8, 1074, 1302, 40, 2416
redhairfox, 1212, 197.4, 1, 9, 1, 11
Redial, 1398, 133.6, 7339, 8464, 359, 16162
Redmachineee, 1275, 34.8, 752, 518, 34, 1304
RedMagic, 1590, 45.5, 1144, 876, 87, 2107
rednapkin, 852, 36.2, 140, 248, 9, 397
rednuht, 1030, 64.1, 14, 24, 3, 41
RedPhoenix, 1441, 33.5, 2075, 1438, 260, 3773
redrat, 1728, 48.1, 2875, 1317, 221, 4413
redskinsfan, 1288, 109.1, 916, 580, 66, 1562
redsolarearth, 1312, 35.8, 1119, 1346, 67, 2532
redsoldier, 1238, 31.5, 3183, 2463, 181, 5827
reducto, 1665, 87.1, 3980, 3805, 430, 8215
reekhavok, 940, 167.4, 3, 7, 1, 11
reepr, 1251, 113.1, 15, 20, 0, 35
refat, 1142, 25.8, 3514, 5645, 242, 9401
Regehr, 1814, 26.0, 7060, 7567, 649, 15276
regensen, 1197, 35.2, 343, 375, 36, 754
reggiddlog, 1593, 104.7, 536, 554, 62, 1152, 1593, 76.7, 5556, 5117, 539, 11212
reggiegeary, 1268, 54.1, 4294, 3665, 433, 8392
reggieside, 1547, 61.8, 1292, 836, 77, 2205
rego, 1393, 29.0, 3117, 4065, 339, 7521
regularjohn, 1104, 55.5, 407, 451, 43, 901
Reidak, 1146, 74.0, 45, 75, 5, 125
reijendamjan, 1002, 81.6, 213, 299, 18, 530
reinovsky, 1399, 30.5, 7841, 8929, 448, 17218
Reisswolf, 1272, 49.6, 5495, 7259, 927, 13681
reivaxxx, 1596, 27.8, 4406, 2272, 448, 7126
reiziger, 1398, 25.7, 2303, 2693, 227, 5223
Rekh, 1292, 49.0, 1630, 1081, 103, 2814
relativity, 1084, 73.3, 353, 235, 33, 621
relaxguy, 884, 29.5, 532, 859, 23, 1414
REMATE, 1429, 29.3, 3046, 2860, 160, 6066
remkov, 1501, 41.1, 1025, 1207, 74, 2306
remolacsonjr, 1566, 130.7, 1474, 1758, 105, 3337
remoteboo, 2062, 127.9, 246, 93, 19, 358
remoteiron, 1618, 63.7, 475, 374, 192, 1041
RenegadeX, 1157, 141.5, 7, 20, 1, 28
renerene, 1287, 69.1, 563, 932, 61, 1556
Rennygil, 1511, 27.6, 4606, 6509, 669, 11784
renobandung, 1121, 28.1, 1218, 1908, 53, 3179
renouli, 820, 101.6, 6, 25, 0, 31
Repeldo, 1840, 30.4, 5353, 8127, 1311, 14791
repelsteel, 1198, 43.0, 976, 1088, 84, 2148
Repon, 820, 104.1, 12, 110, 1, 123
republique, 1308, 39.7, 2368, 2699, 89, 5156
RepUP, 1711, 56.8, 523, 396, 37, 956
resarf, 1261, 53.3, 92, 200, 7, 299
RESE, 1362, 22.3, 424, 329, 29, 782
Resendiz, 1560, 78.7, 1334, 1132, 70, 2536
Resipsaloq, 1239, 29.2, 2207, 4321, 188, 6716
resistence, 1357, 34.9, 5084, 6137, 413, 11634
resize, 1782, 177.0, 12, 1, 0, 13
resol, 1263, 27.6, 4450, 4097, 197, 8744
Resole, 1399, 25.9, 3579, 3190, 392, 7161
Resolo, 1022, 63.5, 255, 259, 15, 529
restyrona, 1325, 142.0, 34, 28, 1, 63
Retard, 1845, 95.4, 683, 499, 58, 1240
Retech, 1298, 48.8, 143, 261, 22, 426
retguy, 1375, 39.6, 2082, 2197, 179, 4458
retraiter, 1167, 64.7, 147, 130, 7, 284
retrophoebia, 1200, 43.1, 1642, 2017, 157, 3816
retsam, 1416, 21.1, 24010, 25180, 1830, 51020
retsi, 1506, 26.7, 10692, 9837, 1116, 21645
Retzin, 1053, 40.9, 880, 734, 32, 1646
ReubenFine, 1565, 27.5, 16763, 12824, 1579, 31166
reuss, 1443, 28.5, 9811, 6200, 860, 16871
revelateX, 792, 300.1, 0, 2, 0, 2
revelator, 1554, 41.3, 11711, 5464, 1150, 18325
Revelc, 1511, 82.0, 881, 680, 29, 1590
ReverseSideSpin, 1404, 109.2, 65, 47, 4, 116
RevivalFires, 1224, 53.3, 151, 154, 19, 324
RevJohn, 1336, 34.7, 7183, 8856, 1089, 17128
Revontulet, 1471, 73.0, 366, 336, 24, 726
RevPod, 1274, 88.1, 1261, 612, 77, 1950
Revup, 1272, 58.3, 22, 19, 0, 41
rewm, 951, 182.3, 24, 40, 0, 64
RexButler, 1288, 64.2, 2643, 3520, 427, 6590
RexM, 878, 116.1, 10, 31, 1, 42
Rexonarus, 1069, 112.1, 201, 273, 14, 488
RexRegorum, 1377, 57.6, 141, 126, 15, 282
rexsolus, 1310, 48.6, 4493, 5784, 245, 10522
ReyDeBuin, 1323, 36.3, 1404, 1629, 231, 3264
reytekno, 1336, 27.9, 763, 169, 14, 946
Rezzu, 1975, 51.6, 904, 356, 66, 1326
rfdfdr, 1635, 31.1, 5518, 5309, 302, 11129
rfdumas, 1211, 26.3, 1475, 2255, 180, 3910
rferrin, 1331, 35.6, 326, 357, 14, 697
rfischer, 1704, 106.5, 2832, 3142, 394, 6368
rfruto, 1200, 98.6, 85, 137, 2, 224
RFW, 1301, 53.8, 1120, 1249, 32, 2401
rgmchan, 1318, 34.5, 666, 1023, 53, 1742
RGrove, 1174, 43.6, 493, 585, 33, 1111
Rhitz, 1129, 41.6, 104, 126, 21, 251
rhoalpha, 1486, 27.4, 4590, 3772, 466, 8828
Rhuiden, 1137, 144.5, 49, 94, 3, 146
Rhune, 1386, 81.5, 675, 601, 47, 1323
rhytnen, 1316, 98.2, 301, 359, 26, 686
riaz, 1216, 29.8, 8631, 18521, 614, 27766
RicardoST, 1075, 40.4, 44, 113, 3, 160
riccardito, 1045, 30.2, 430, 564, 49, 1043
Riccikiller, 1424, 32.9, 2009, 1093, 108, 3210
ricciolo, 1829, 68.8, 1081, 1210, 152, 2443
Ricdah, 1241, 59.6, 4748, 4919, 213, 9880
RiceRiceRice, 783, 185.3, 22, 47, 1, 70
richardborromeo, 1139, 95.1, 216, 291, 4, 511
RICHARDEUR, 1131, 20.5, 4251, 6301, 432, 10984
richardfowles, 1125, 86.8, 41, 69, 2, 112
richardu, 1083, 66.2, 2469, 2130, 71, 4670
richsmosmo, 1419, 79.9, 1063, 1103, 43, 2209
richwillis, 1713, 32.6, 6751, 4894, 634, 12279
Rickert, 1369, 288.4, 0, 1, 0, 1
RickNaR, 820, 153.0, 4, 17, 0, 21
rickrice, 1239, 42.8, 7484, 6634, 554, 14672
rickyks, 1397, 77.1, 93, 83, 13, 189
ricolalala, 947, 75.9, 539, 1366, 46, 1951
ridlermik, 1332, 54.2, 942, 806, 51, 1799
Riegler, 1626, 29.6, 5494, 5701, 384, 11579
RiemannUS, 1437, 43.1, 1040, 706, 120, 1866
rienthemachine, 1328, 41.4, 2745, 2897, 358, 6000
riese, 1517, 33.8, 12540, 29761, 1908, 44209
riffraf, 1500, 46.5, 1455, 1168, 79, 2702
rigabor, 1598, 33.0, 7376, 7846, 1309, 16531
RigoM, 789, 155.4, 59, 174, 3, 236
riicardo, 1235, 127.7, 257, 393, 28, 678
rijekaz, 1152, 94.4, 1166, 1613, 83, 2862
riks, 1719, 69.0, 2995, 2849, 394, 6238
rimga, 1711, 130.8, 2423, 2565, 298, 5286
rimjhim, 1288, 24.0, 2077, 2083, 203, 4363
Rimura, 1023, 107.2, 401, 1117, 14, 1532
RinaChess, 1616, 30.0, 2135, 2979, 233, 5347
ringhofferakos, 1113, 87.3, 209, 157, 33, 399
ringinandrunnin, 1226, 119.8, 94, 106, 6, 206
Ripitup, 1401, 30.6, 8482, 8420, 601, 17503
Ripline, 1142, 46.9, 1430, 1628, 74, 3132
Ripple, 1435, 55.1, 2762, 2820, 219, 5801
riquet, 1403, 34.9, 3360, 4370, 340, 8070
Risen, 1694, 70.5, 195, 162, 12, 369
RishiTalreja, 1202, 227.3, 1, 6, 0, 7
risingagain, 810, 140.0, 2, 9, 0, 11
riskquant, 1192, 41.0, 204, 232, 11, 447
RiskReturn, 1736, 350.0, 1, 0, 0, 1
RitchMex, 1237, 80.3, 29, 39, 6, 74
ritt, 1211, 65.7, 1122, 1298, 109, 2529
Ritzel, 1389, 46.3, 5615, 5616, 702, 11933
rivaldy, 1349, 110.8, 7, 20, 0, 27
RiverPlateforever, 1276, 47.0, 1431, 1503, 188, 3122
Rivertroll, 1297, 25.6, 2506, 2283, 261, 5050
RivoVei, 1324, 92.9, 1882, 1371, 145, 3398
RizzlesWorld, 886, 171.9, 1, 7, 0, 8
rjbriggs, 1321, 33.5, 2304, 2974, 210, 5488
RJCrash, 1110, 88.0, 24, 37, 2, 63
RJHRJH, 1031, 128.2, 5, 20, 0, 25
rjsekhar, 1064, 36.3, 420, 611, 44, 1075
rjw, 1212, 31.5, 4596, 5577, 175, 10348
rkchaudhary, 1353, 120.4, 2576, 1985, 218, 4779
rkrram, 1354, 71.1, 660, 518, 37, 1215
rlgg, 1018, 43.5, 5035, 3822, 230, 9087
RLP, 1338, 28.6, 3630, 4560, 381, 8571
RLW, 1463, 50.5, 4382, 4024, 511, 8917
rmatous, 1303, 35.5, 3518, 3138, 367, 7023
rmcaleb, 1494, 32.7, 1637, 975, 94, 2706
RMLPGB, 1541, 120.9, 742, 986, 96, 1824
Rmoreno, 966, 47.5, 88, 298, 7, 393
RMReed, 1106, 40.2, 575, 700, 61, 1336
RMSWANN, 1404, 43.7, 3047, 3232, 306, 6585
Rmuriel, 1968, 67.6, 181, 93, 13, 287
rmutch, 1226, 167.4, 6, 8, 0, 14
rnickanderson, 1337, 34.8, 1579, 1575, 97, 3251
rnolet, 1383, 30.8, 18914, 14077, 2083, 35074
roachs, 1308, 90.6, 1261, 1150, 85, 2496
roadhan, 1121, 57.2, 96, 105, 8, 209
roadypooz, 699, 81.5, 56, 1355, 6, 1417
roastbeefs, 1225, 34.2, 944, 891, 33, 1868
robalack, 1343, 29.9, 233, 188, 9, 430
robberi, 1051, 44.4, 3077, 2996, 148, 6221
robbertw, 702, 217.3, 0, 12, 0, 12
robbi, 1544, 228.8, 407, 439, 31, 877
Robbinsc, 1378, 124.6, 338, 593, 51, 982
robbobcon, 1193, 97.8, 722, 647, 55, 1424
robdabonk, 695, 112.6, 16, 157, 2, 175
RobertFrost, 1170, 93.9, 171, 194, 8, 373
roberti, 1323, 105.0, 1433, 2283, 203, 3919
RobertJones, 1301, 28.5, 1655, 2040, 117, 3812
Roberto, 1451, 53.3, 1327, 1494, 129, 2950
robertoalonso, 647, 74.3, 43, 163, 2, 208
robertpless, 1564, 290.3, 1, 1, 0, 2
robertpmntr, 734, 138.0, 15, 54, 1, 70
roberttdaniel, 1028, 29.4, 2368, 4203, 209, 6780
roberttorma, 2136, 57.5, 3140, 1430, 478, 5048
robeVAT, 1075, 27.7, 1041, 2613, 182, 3836
RobFlynn, 877, 60.7, 84, 240, 8, 332
robiceflame, 1811, 40.2, 1352, 1105, 132, 2589
robivan, 1260, 101.2, 572, 601, 34, 1207
RobLab, 1457, 31.0, 11369, 6628, 680, 18677
robnormal, 1351, 37.6, 698, 642, 61, 1401
RoboMan, 1315, 33.2, 3132, 2788, 357, 6277
robotmotor, 1993, 44.3, 50, 23, 0, 73
Robotronic, 1929, 61.4, 299, 230, 9, 538
robslabbers, 1440, 39.0, 2180, 1546, 243, 3969
robsOr, 1871, 102.3, 4156, 3570, 302, 8028
Robyzd, 1194, 37.2, 893, 936, 71, 1900
rocal, 1482, 29.0, 3875, 3322, 143, 7340
Rocangus, 1409, 48.5, 2752, 1809, 253, 4814
rocastar, 864, 143.2, 2, 10, 1, 13
Rocato, 1687, 36.4, 4291, 5653, 473, 10417
RoccoM, 1223, 32.1, 2725, 2290, 377, 5392
roccovargas, 1120, 28.6, 4224, 4750, 230, 9204
RochaBSB, 1137, 56.6, 550, 361, 44, 955, 1955, 38.7, 4590, 1905, 769, 7264
rockdaddy, 1689, 54.2, 1332, 979, 102, 2413
rockjuju, 1562, 22.8, 8797, 10319, 859, 19975
rockshane, 900, 47.4, 71, 317, 3, 391
RockyButler, 1481, 91.0, 53, 50, 18, 121
RockyRook, 1324, 86.8, 534, 515, 34, 1083
rodeloper, 1214, 85.6, 6828, 8450, 885, 16163
roderick, 1181, 59.0, 8198, 12561, 628, 21387
rodgegreen, 1157, 43.6, 289, 504, 18, 811
rodhessing, 1574, 25.9, 14428, 15519, 2070, 32017
Rodion, 1552, 91.2, 3004, 3468, 271, 6743
Rodney, 1570, 73.2, 1717, 1115, 148, 2980
rodnojo, 1629, 22.4, 6945, 11281, 515, 18741
RodrigoSanchez, 1442, 31.7, 3867, 3835, 285, 7987
RodriT, 1265, 45.9, 976, 870, 124, 1970
rodsky, 1412, 67.6, 161, 426, 10, 597
rodskyforlife, 1084, 84.9, 223, 250, 15, 488
roduart, 1158, 38.5, 135, 217, 11, 363
Roekless, 1396, 36.7, 580, 501, 54, 1135
Roetman, 1082, 46.2, 980, 909, 95, 1984
rogben, 1666, 38.8, 2541, 2196, 313, 5050
rogerb, 1435, 80.1, 2407, 2162, 294, 4863
RogerS, 1917, 97.4, 5462, 3055, 566, 9083
rogerwm, 847, 63.7, 135, 446, 12, 593
rogeryap, 1654, 27.8, 16389, 11213, 1700, 29302
Rogetl, 1240, 95.9, 180, 341, 12, 533
roggellio, 1199, 60.5, 365, 191, 26, 582
rojmedi, 886, 74.4, 19, 79, 3, 101
Rokada, 1278, 235.3, 1, 4, 0, 5
rokh, 1178, 78.4, 1601, 1653, 135, 3389
rokivlada, 1291, 292.6, 1, 1, 0, 2
Rokossovsky, 1751, 33.4, 3979, 3277, 340, 7596
RolandKirk, 1277, 127.7, 66, 108, 9, 183
rolkel, 1002, 42.9, 2423, 2516, 176, 5115
rollfi, 1522, 97.6, 623, 676, 55, 1354
rollingrooks, 1260, 94.8, 422, 1302, 62, 1786
Romannavarro, 1765, 329.4, 1, 0, 0, 1
romanra, 1625, 27.0, 2699, 2277, 272, 5248
RomanV, 1577, 51.2, 1647, 1263, 145, 3055
romazbasha, 1240, 52.5, 1840, 2477, 104, 4421
romedi, 1289, 89.6, 12, 21, 0, 33
RomeGor, 1351, 47.6, 1100, 1437, 79, 2616
romek, 1486, 51.8, 1969, 2476, 170, 4615
romeloker, 1275, 115.5, 10, 8, 0, 18
romil, 1428, 88.3, 463, 261, 40, 764
rommeltan, 1461, 123.2, 1250, 1682, 99, 3031
rompialan, 1729, 38.0, 320, 310, 28, 658
romuloalbert, 1204, 83.2, 600, 785, 62, 1447
ronaldomponte, 1302, 34.7, 1814, 2310, 163, 4287
RonDingo, 1211, 58.3, 13, 30, 1, 44
Ronels, 1337, 122.4, 3247, 2603, 194, 6044
Rongley, 1452, 29.9, 1915, 1872, 84, 3871
RoniChessman, 1623, 48.3, 1870, 2110, 98, 4078
RoninFH, 1043, 44.3, 322, 610, 17, 949
RonMeister, 1141, 44.9, 993, 1535, 56, 2584
RonnieKah, 1376, 46.9, 523, 526, 42, 1091
RonnyMumbai, 792, 117.5, 65, 600, 7, 672
Ronrufin, 1420, 80.5, 108, 96, 9, 213
RonsonJonson, 1573, 106.0, 504, 430, 54, 988
RonStewart, 1805, 31.6, 7663, 7400, 1013, 16076
ronthelibrarian, 1379, 94.2, 538, 441, 53, 1032
ronYcoca, 1313, 92.4, 104, 70, 6, 180
roochie, 1493, 116.9, 2396, 2059, 163, 4618
roofman, 1335, 41.0, 7964, 6299, 538, 14801
rookbusterxyz, 1240, 101.5, 36, 58, 6, 100, 1607, 34.4, 5088, 3811, 430, 9329
rookea, 1711, 28.4, 8932, 11657, 1663, 22252
Rookheighter, 1457, 47.4, 475, 198, 26, 699
rookholder, 1486, 23.4, 7153, 4149, 461, 11763
RookRule, 1185, 59.0, 1744, 2427, 78, 4249
rooksniper, 1252, 112.8, 17, 45, 4, 66
RookSnooker, 1196, 74.5, 561, 763, 41, 1365
ROOKSOFROCKS, 1329, 37.9, 2967, 2937, 325, 6229
RookTakesPawnShop, 1156, 63.9, 89, 143, 9, 241
rooktwelve, 1333, 39.8, 4405, 6579, 402, 11386
roorar, 1430, 58.9, 771, 545, 59, 1375
RooRooBear, 1311, 192.4, 267, 270, 29, 566
rooschess, 1417, 304.6, 1, 1, 0, 2
rooshl, 1085, 167.5, 2, 3, 0, 5
roosmanla, 1310, 43.5, 5698, 6370, 474, 12542
rootsi, 1500, 28.7, 5033, 2960, 283, 8276
roqueur, 1337, 41.4, 1638, 1125, 88, 2851
rorique, 1449, 33.8, 1252, 1234, 128, 2614
rorky, 926, 46.8, 184, 823, 47, 1054
rorowood, 926, 66.0, 13, 26, 1, 40
rosadeginga, 1337, 61.5, 485, 757, 39, 1281
Rosaflor, 1037, 350.0, 0, 2, 0, 2
Rosalie, 1300, 31.5, 487, 616, 21, 1124
Roschka, 1264, 34.7, 7350, 8179, 471, 16000
Rosenator, 1315, 28.2, 2892, 2607, 235, 5734
rosewoodtele, 1464, 196.7, 2, 2, 0, 4
Rossgo, 1599, 26.6, 12712, 12478, 1245, 26435
Rotaraan, 953, 46.9, 56, 109, 4, 169
Rothschild, 1353, 78.5, 957, 1298, 261, 2516
rotiii, 1661, 78.2, 329, 157, 19, 505
rotorchamp, 1614, 54.7, 1707, 1663, 191, 3561
Roufianos, 1131, 122.9, 43, 71, 4, 118
RoughHiker, 1597, 29.3, 7675, 5089, 723, 13487
rougon, 1315, 95.0, 683, 1027, 103, 1813
roumian, 1173, 58.5, 170, 247, 9, 426
RousterRook, 1300, 22.7, 13504, 19407, 1684, 34595
Roweja, 1505, 36.5, 2228, 2943, 190, 5361
roweth, 1341, 29.6, 4565, 4592, 341, 9498
Rowlandiii, 1103, 63.5, 3228, 4883, 341, 8452
rowwmayynn, 1341, 49.2, 242, 710, 21, 973
roxannelv, 1333, 27.7, 3884, 4758, 358, 9000
roxinante, 1537, 40.9, 1345, 1331, 174, 2850
roxtar, 1076, 33.6, 675, 693, 30, 1398
royalcrown, 811, 107.2, 15, 95, 2, 112
Royalhavok, 1900, 83.6, 4135, 4530, 528, 9193
RoyalOui, 1274, 98.6, 595, 910, 87, 1592
RoyalSpoon, 1343, 36.9, 1175, 1274, 101, 2550
royhaddad, 1115, 25.6, 353, 480, 34, 867
RoyJuarez, 1449, 48.9, 1761, 1435, 95, 3291
roymalan, 1249, 181.7, 2, 5, 0, 7
roymunson, 1316, 31.5, 8053, 7490, 380, 15923
RoyRodrigues, 1123, 36.1, 160, 167, 12, 339
rpeacock, 1293, 31.6, 6749, 4369, 260, 11378
RPeters, 1290, 135.4, 9, 18, 1, 28
rpimentel, 1216, 24.6, 1583, 1586, 194, 3363
rpjimenez, 1424, 224.9, 3, 2, 0, 5
RpokerJ, 823, 103.6, 1, 22, 0, 23
rponting, 1532, 38.0, 3859, 2134, 192, 6185
rprosser, 878, 112.7, 167, 990, 6, 1163
rpwali, 855, 154.4, 41, 171, 8, 220
RraavviI, 1354, 30.4, 3215, 6005, 339, 9559
rradev, 1337, 24.7, 6295, 7034, 931, 14260
rradjah, 1475, 38.8, 2355, 2315, 343, 5013
rraty, 1200, 59.5, 677, 553, 37, 1267
rrelax, 1340, 39.7, 691, 588, 65, 1344
rstuvwxyz, 1256, 39.7, 2573, 2899, 206, 5678
rsuazoj, 1694, 95.1, 2798, 3951, 286, 7035
RSWtwo, 1650, 26.4, 11964, 19052, 1319, 32335
rtcooked, 1297, 53.0, 669, 463, 60, 1192
rtglass, 1050, 35.8, 883, 1059, 85, 2027
rthxyz, 1146, 73.9, 617, 741, 35, 1393
rtist, 1264, 207.6, 0, 3, 0, 3
rualsoviejo, 1181, 32.1, 882, 1091, 82, 2055
ruatuti, 1419, 23.2, 13141, 9980, 880, 24001
rubengh, 779, 61.9, 14, 85, 1, 100
rubicorn, 1315, 56.2, 132, 22, 12, 166
RubiksRevenge, 1541, 30.7, 1094, 852, 70, 2016
Rubinsteinfan, 1360, 38.7, 299, 381, 49, 729
Rublius, 1393, 91.1, 1782, 1829, 128, 3739
rubymoonstar, 694, 83.6, 3, 26, 0, 29
ruchira, 1785, 30.0, 1102, 1503, 121, 2726
Rudan, 1219, 66.7, 683, 671, 39, 1393
rudderlessship, 1418, 28.1, 2565, 2406, 422, 5393
rudiprus, 1544, 66.6, 2851, 2152, 313, 5316
Rudsar, 1486, 19.6, 10607, 13697, 1275, 25579
ruesseltier, 1187, 59.3, 461, 536, 16, 1013
rufii, 1679, 50.0, 197, 220, 21, 438
rugero, 1551, 44.5, 1061, 1032, 65, 2158
RuggedChess, 1290, 53.6, 597, 1075, 83, 1755
ruhan, 1019, 145.9, 2, 11, 1, 14
RuizLopez, 1386, 27.6, 7459, 5570, 780, 13809
rulochess, 1214, 26.0, 166, 166, 3, 335
Rumpstiek, 1750, 32.8, 2115, 2699, 588, 5402
rumtouch, 1341, 125.7, 1645, 2553, 107, 4305
runciter, 2139, 28.2, 4332, 2920, 224, 7476
runrida, 1158, 79.4, 87, 138, 3, 228
rupertico, 1565, 51.5, 2471, 1267, 140, 3878
RuReti, 2094, 138.5, 41, 8, 5, 54
ruribem, 875, 136.5, 5, 25, 0, 30
RusFalcon, 1552, 27.1, 4074, 3307, 230, 7611
rushclasic, 1265, 134.1, 354, 368, 27, 749
RuskiyIvrai, 1218, 39.4, 284, 707, 35, 1026
rusputin, 1394, 27.5, 1350, 2486, 151, 3987
russianpro, 879, 133.4, 7, 26, 0, 33
RussianRoulette, 1875, 32.9, 295, 175, 11, 481
russianway, 1277, 47.6, 262, 376, 42, 680
Russsell, 1128, 31.5, 396, 465, 22, 883
Rustaa, 1408, 65.3, 2065, 1748, 246, 4059
rusticanegro, 1118, 54.9, 176, 251, 26, 453
rustico, 1577, 92.0, 831, 659, 37, 1527
rustychub, 833, 124.0, 285, 90, 21, 396
Rutherford, 1404, 25.8, 13487, 12590, 335, 26412
Ruttworm, 1494, 98.5, 48, 20, 8, 76
ruvelob, 1256, 93.5, 270, 241, 15, 526
Ruvz, 875, 83.3, 65, 77, 4, 146
RuyLupit, 1280, 302.2, 3, 1, 0, 4
RuyP, 1318, 49.9, 2822, 2531, 246, 5599
RuySmith, 1367, 39.6, 4748, 3870, 452, 9070
Ruza, 1260, 32.9, 369, 293, 41, 703
ruzon, 1510, 73.0, 1458, 1446, 182, 3086
rvhonka, 1498, 25.8, 4343, 3940, 467, 8750
RVLY, 1193, 25.6, 7621, 7879, 659, 16159
rvs, 1548, 75.0, 5741, 5833, 594, 12168
rwadu, 1394, 75.6, 37, 56, 5, 98
rwaelder, 1307, 121.9, 321, 360, 5, 686
rwaynec, 1389, 26.1, 7854, 10750, 783, 19387
rwedlichsoldner, 1613, 41.3, 40, 45, 9, 94
rwehrli, 1769, 114.1, 3501, 1252, 195, 4948
rwickstrom, 812, 73.2, 1702, 2141, 75, 3918
rxlrxl, 1199, 37.2, 2116, 2964, 127, 5207
RxR, 1833, 38.1, 206, 139, 17, 362
ryanmat, 1388, 51.1, 1381, 1214, 140, 2735
Ryanowski, 1913, 111.5, 630, 462, 66, 1158
RyanPlayChess, 1159, 34.4, 622, 711, 41, 1374
rybokas, 1240, 32.8, 3121, 2702, 136, 5959
Rybone, 1069, 87.5, 1806, 2181, 80, 4067
rymor, 1474, 23.0, 1755, 2878, 264, 4897
ryncon, 1539, 37.0, 2785, 2564, 248, 5597
rynos, 1598, 24.6, 2588, 3405, 178, 6171
ryoushi, 987, 209.4, 0, 5, 0, 5
rythmic, 1596, 22.7, 2528, 3234, 283, 6045
RyujinKami, 989, 57.4, 29, 62, 2, 93
RyujinScylla, 1742, 82.0, 495, 156, 18, 669
ryutime, 1563, 68.9, 484, 561, 59, 1104
ryvar, 1496, 31.1, 714, 571, 33, 1318
ryven, 922, 71.4, 88, 231, 3, 322
rzd, 1671, 37.2, 3052, 2460, 387, 5899
rzdf, 951, 30.5, 1978, 3642, 114, 5734
RZipp, 1400, 27.2, 2543, 1753, 167, 4463
SAAChess, 1500, 52.6, 348, 287, 12, 647
SAADMAAZ, 1421, 118.9, 1972, 2061, 155, 4188
SABBAI, 1116, 34.6, 61, 99, 14, 174
SabbathNight, 1752, 59.0, 978, 720, 106, 1804
sabirin, 1325, 36.1, 593, 423, 29, 1045
Sabnock, 1763, 40.2, 9816, 4255, 474, 14545
sabocat, 1141, 53.4, 754, 873, 82, 1709
Sabocley, 1167, 50.7, 652, 694, 39, 1385
sabun, 1369, 38.1, 5784, 4853, 425, 11062
Sachas, 1192, 43.0, 980, 1624, 59, 2663
sachilpapa, 1638, 42.6, 611, 432, 100, 1143
SachinRavi, 1441, 47.3, 876, 630, 81, 1587
SacredVision, 1431, 31.1, 5208, 6442, 319, 11969
SacriFish, 1385, 64.7, 2280, 1032, 135, 3447
SacSmith, 1415, 71.9, 114, 148, 12, 274
sadhaka, 1149, 77.2, 239, 733, 48, 1020
sadin, 1343, 83.6, 92, 70, 4, 166
saenger, 1164, 66.2, 957, 1534, 103, 2594
saetti, 1742, 64.9, 1419, 4469, 439, 6327
Safarin, 1242, 200.9, 3, 2, 1, 6
safeking, 1065, 34.7, 795, 1630, 30, 2455
safwanjawad, 1213, 123.0, 8, 13, 0, 21
saggitarian, 1336, 31.6, 3120, 3858, 160, 7138
saguni, 1339, 46.5, 3725, 3096, 348, 7169
saharapunewarrior, 1098, 165.0, 3, 4, 0, 7
sahistonline, 1103, 30.5, 2305, 2044, 66, 4415
Saidin, 1399, 43.9, 1673, 1166, 106, 2945
saifulxp, 1107, 264.3, 0, 2, 0, 2
Saigonkick, 1091, 118.9, 10, 62, 0, 72
Saikalyan, 1392, 28.1, 1055, 1087, 74, 2216
saimasawa, 1457, 38.7, 2620, 3024, 147, 5791
sainik, 1202, 31.5, 301, 515, 27, 843
saintjust, 1436, 28.1, 5335, 4416, 188, 9939
Saintromeo, 1378, 192.3, 8, 16, 3, 27
saip, 1464, 111.7, 316, 497, 33, 846
sairunyun, 976, 90.6, 14, 40, 2, 56
sajidlovechesss, 1282, 297.7, 1, 1, 0, 2
SajidulIslam, 936, 93.3, 42, 94, 4, 140
SAkeER, 1409, 30.5, 1710, 1510, 68, 3288
Saki, 1848, 35.1, 24839, 14426, 3059, 42324
SakitJiwa, 1456, 44.1, 237, 222, 5, 464
sakkiraly, 1789, 80.9, 330, 111, 30, 471
sakkjani, 1615, 106.9, 338, 274, 24, 636
Sakkoz, 1349, 28.0, 2520, 2754, 406, 5680
sakmaydik, 1435, 90.5, 232, 347, 13, 592
sakr, 1700, 69.1, 2681, 1530, 162, 4373
saksay, 1005, 257.2, 0, 2, 0, 2
salaccc, 1129, 44.9, 2007, 4888, 180, 7075
saladars, 1256, 30.4, 3227, 3850, 256, 7333
Salamans, 1245, 88.7, 57, 78, 3, 138
Salamon, 1273, 37.4, 5922, 7589, 600, 14111
SalGrebnedias, 1112, 95.3, 378, 552, 33, 963
Sali, 1459, 48.3, 10847, 9244, 776, 20867
salicylate, 1532, 133.1, 795, 485, 57, 1337
salihkaya, 1328, 58.3, 161, 188, 31, 380
salla, 1145, 61.9, 518, 843, 24, 1385
Salmacys, 1066, 23.2, 1322, 1755, 133, 3210
Salmix, 1075, 168.0, 23, 53, 3, 79
Salonika, 1259, 43.5, 840, 816, 44, 1700
salonsale, 1466, 247.3, 0, 3, 0, 3
SalseroUno, 1243, 32.5, 1884, 1721, 101, 3706
salsidiski, 1557, 30.4, 2496, 3615, 160, 6271
SaltilloCoah, 1439, 133.3, 11, 10, 0, 21
Saltmule, 1327, 37.7, 1206, 754, 78, 2038
saltofthearth, 1392, 48.9, 679, 390, 20, 1089
saltygrape, 1307, 28.8, 491, 1033, 74, 1598
salustiano, 1827, 22.3, 17201, 28221, 2664, 48086
salvanix, 1387, 42.1, 71, 30, 7, 108
salvemann, 1358, 45.1, 1165, 1290, 114, 2569
Salvenach, 894, 42.3, 601, 784, 16, 1401
samaraB, 1798, 92.2, 3736, 2265, 440, 6441
samarth, 1480, 52.0, 1107, 1046, 98, 2251
SambasTerigas, 1258, 159.5, 1, 12, 0, 13
samcost, 1507, 18.7, 18617, 21722, 1116, 41455
samdiego, 1374, 36.7, 234, 186, 16, 436
samdomagala, 1247, 33.9, 3125, 3314, 267, 6706
SamDooley, 1580, 35.5, 7980, 6102, 669, 14751
sameish, 1554, 44.9, 2742, 2571, 155, 5468
samisch, 889, 213.3, 3, 29, 0, 32
samlele, 1220, 49.5, 558, 573, 44, 1175
SammieXin, 1476, 95.7, 10, 51, 5, 66
SammySiljkovic, 1475, 60.7, 709, 1341, 91, 2141
sampathkumar, 1351, 26.1, 6610, 10798, 420, 17828
sampmas, 1244, 115.9, 148, 185, 8, 341
SAMPSONL, 1332, 54.6, 1770, 1629, 127, 3526
samshaunak, 1693, 129.9, 542, 396, 41, 979
samuelee, 1083, 132.7, 12, 26, 0, 38
samuli, 1084, 158.8, 222, 386, 12, 620
SamuraiJoe, 1724, 33.2, 8621, 4568, 810, 13999
SamuraySword, 1542, 104.8, 30, 14, 1, 45
samwa, 1046, 78.6, 276, 345, 24, 645
samweis, 1156, 38.7, 5102, 9587, 418, 15107
samwell, 1394, 38.5, 480, 386, 37, 903
sanash, 1161, 150.1, 3, 4, 0, 7
sandal, 1209, 33.6, 1305, 1065, 87, 2457
sandeepheera, 1391, 52.2, 101, 88, 9, 198
sandel, 1567, 32.3, 1489, 849, 104, 2442
SandersJim, 1339, 53.1, 2685, 2355, 203, 5243
Sando, 1110, 125.6, 556, 844, 79, 1479
sandogat, 1533, 96.6, 2610, 1374, 83, 4067
sandracottus, 966, 102.9, 83, 335, 2, 420
Sandrowue, 814, 126.1, 56, 225, 7, 288
sandunguero, 1404, 44.0, 2902, 3054, 307, 6263
sandycapivara, 1237, 39.1, 1949, 2735, 232, 4916
sandydadasaurav, 746, 123.1, 2, 25, 0, 27
sandyvillalon, 1534, 91.0, 1139, 1031, 71, 2241
sanfm, 1264, 30.9, 161, 171, 7, 339
sangalla, 1631, 34.2, 5190, 4623, 457, 10270
sangglier, 1465, 48.9, 1556, 1688, 167, 3411
sanguineentity, 1104, 110.5, 1039, 1907, 61, 3007
SANJAYDAS, 1244, 133.8, 39, 43, 5, 87
sanjeevgupta, 1289, 38.7, 3908, 5128, 389, 9425
sanketrocks, 1093, 110.8, 40, 31, 2, 73
Sannicandro, 1316, 33.3, 4464, 5974, 429, 10867
Sansart, 1226, 43.9, 7406, 11806, 366, 19578
sansusec, 1190, 50.1, 70, 120, 9, 199
sant, 1126, 100.9, 3342, 7360, 325, 11027
santamaria, 1405, 23.0, 6000, 6281, 322, 12603
santibenitez, 1094, 29.1, 269, 151, 12, 432
SantinoVC, 1053, 63.6, 1001, 1880, 71, 2952
santodomingo, 1380, 64.9, 1271, 2339, 156, 3766
SantoshFromIndia, 1329, 30.9, 2528, 2469, 151, 5148
santoshk, 1206, 35.4, 1780, 1886, 116, 3782
Santoshkswamy, 1211, 26.4, 8273, 15057, 955, 24285
Sanvigian, 1231, 25.8, 1113, 1207, 79, 2399
sApAtO, 1245, 40.4, 39, 66, 4, 109
Saqqe, 1344, 84.8, 15, 31, 5, 51
sarahdaniel, 1169, 27.4, 222, 274, 12, 508
sarahhh, 1507, 110.2, 11, 5, 0, 16
Sarajevski, 1828, 31.5, 1129, 1617, 123, 2869
Sarcasmo, 1693, 70.0, 287, 145, 13, 445
sargentrock, 927, 68.6, 225, 350, 16, 591
sargonsin, 1349, 27.6, 1497, 1525, 140, 3162
sargyle, 1250, 43.4, 2592, 2985, 168, 5745
Sarvikatu, 995, 47.7, 30, 47, 5, 82
sarweshs, 1429, 17.6, 6758, 6137, 698, 13593
SashaAnoshkin, 1720, 42.5, 978, 1045, 107, 2130
Sashe, 1514, 93.2, 108, 23, 1, 132
saskum, 1747, 54.5, 725, 792, 34, 1551
Sasqwatch, 1531, 89.5, 4011, 5067, 527, 9605
Sasscho, 1059, 43.5, 442, 567, 44, 1053
SaszkaD, 1500, 79.9, 3361, 2775, 238, 6374
satellitez, 1068, 120.4, 219, 332, 8, 559
sathiyan, 1366, 24.1, 2161, 2767, 167, 5095
Satiro, 1701, 20.4, 2172, 887, 96, 3155
satous, 1055, 23.3, 278, 359, 15, 652
saturnz, 1590, 72.8, 2442, 3355, 349, 6146
Satyavan, 1633, 27.0, 4342, 3091, 500, 7933
saubhik, 1301, 34.1, 2201, 3159, 248, 5608
SaulSiz, 1078, 133.9, 7, 19, 1, 27
Saulzar, 1327, 47.0, 2468, 3889, 153, 6510
saurabhj, 1211, 34.7, 108, 209, 13, 330
sauroncs, 1233, 72.4, 646, 1089, 45, 1780
sausas, 1198, 185.2, 0, 4, 0, 4
SavageMate, 1291, 80.0, 701, 537, 42, 1280
saveliev, 1229, 55.0, 1985, 2193, 146, 4324
SaveMyKing, 984, 164.5, 5, 16, 0, 21
savis, 1272, 44.1, 1252, 1143, 74, 2469
SaxManVA, 698, 64.8, 23, 243, 2, 268
saxpianocello, 1479, 30.9, 3832, 5321, 349, 9502
saybyetothisone, 1499, 60.1, 196, 364, 22, 582
sazechess, 1377, 31.6, 4502, 5101, 371, 9974
Sazzabi, 1727, 49.4, 1179, 666, 116, 1961
sbjnorm, 1492, 260.3, 1, 2, 0, 3
SBLW, 1930, 83.8, 309, 102, 42, 453
SBradford, 1788, 78.2, 104, 39, 6, 149
SBYCHOWSKI, 1318, 184.0, 24, 10, 1, 35
scacchigioc, 1567, 31.3, 2089, 1526, 103, 3718
ScaccoGentile, 1154, 33.9, 4745, 5316, 127, 10188
scamfest, 2013, 46.8, 1809, 1711, 321, 3841
Scareplay, 1781, 27.3, 922, 941, 46, 1909
ScarHead, 1532, 20.4, 2248, 1852, 105, 4205
SCARNEY, 1346, 26.7, 9202, 10878, 377, 20457
scarsetto, 995, 28.4, 2630, 4153, 126, 6909
scaryknight, 1470, 64.5, 253, 322, 27, 602
sceptic, 1347, 54.8, 3546, 4134, 305, 7985
schachchess, 1612, 25.2, 1689, 875, 64, 2628
Schachgeek, 1393, 44.5, 1098, 990, 137, 2225
schachgottt, 1860, 26.6, 3409, 1189, 126, 4724
schachlover, 1672, 88.1, 1129, 1250, 93, 2472
schaduwen, 1158, 149.1, 4, 7, 0, 11
Schakki, 1207, 30.5, 1615, 2044, 136, 3795
scharrelei, 1227, 70.4, 338, 371, 26, 735
schaudhuri, 1486, 43.7, 1414, 620, 197, 2231
scheller, 1742, 28.5, 2974, 3746, 305, 7025
Schereschevsky, 1192, 63.5, 813, 678, 65, 1556
Schieber, 1517, 45.0, 1034, 602, 83, 1719
Schiele, 1764, 39.3, 10824, 9613, 1394, 21831
schlackattack, 1334, 69.7, 2004, 2747, 162, 4913
SChlebowski, 1096, 78.0, 1022, 1057, 58, 2137
Schleef, 1591, 37.3, 1339, 1053, 68, 2460
schlemazzel, 1372, 84.0, 747, 450, 52, 1249
schlernap, 1618, 26.4, 6599, 5879, 512, 12990
schlotzky, 829, 145.3, 14, 34, 0, 48
schmalzi, 1335, 39.6, 1220, 1035, 64, 2319
schmeg, 1235, 63.4, 1756, 2441, 127, 4324
schmierfink, 1327, 25.3, 2547, 963, 117, 3627
schnicklefritz, 1356, 89.5, 1491, 1070, 227, 2788
schoenml, 1655, 34.4, 7120, 3395, 576, 11091
Schooled, 1984, 98.6, 633, 499, 79, 1211
schoorl, 1177, 33.6, 4448, 3947, 397, 8792
Schtango, 1093, 33.9, 1555, 1519, 70, 3144
schumi, 1345, 25.5, 16903, 19221, 1340, 37464
Schutor, 1222, 31.3, 1727, 2607, 226, 4560
SCHWARM, 1553, 48.7, 130, 375, 29, 534
schysm, 1486, 47.9, 3297, 3130, 221, 6648
sciacallo, 1416, 28.4, 12178, 13510, 1296, 26984
sciascia, 1738, 149.0, 4, 2, 0, 6
Sciolaro, 1779, 56.8, 3214, 2185, 384, 5783
Scognamiglio, 1144, 56.6, 297, 868, 24, 1189
scoobydum, 1440, 111.1, 6000, 6503, 619, 13122
scorchie, 1598, 159.4, 9, 11, 0, 20
ScorpionKnight, 1302, 86.3, 617, 612, 46, 1275
Scotknight, 1223, 44.9, 145, 205, 17, 367
ScottBedard, 807, 182.2, 2, 13, 0, 15
ScottHare, 1523, 58.3, 1689, 1589, 232, 3510
ScottishBlueHorse, 1113, 81.8, 469, 984, 26, 1479
scottjgilmour, 1107, 66.5, 54, 76, 6, 136
scottobrien, 1091, 82.9, 907, 2786, 175, 3868
Scottrick, 926, 77.7, 401, 363, 30, 794
SCOTTSKY, 1461, 22.6, 9786, 10170, 722, 20678
ScottTaylorMCPD, 1485, 30.0, 1029, 936, 74, 2039
scozzese, 1069, 37.7, 2089, 4055, 139, 6283
ScrabbleMonster, 1234, 28.6, 3483, 3937, 236, 7656
scrablor, 833, 161.1, 1, 10, 0, 11
scratchwalters, 1273, 117.5, 2591, 3598, 118, 6307
scratscrat, 1767, 29.5, 4049, 3352, 349, 7750
screaminghead, 1117, 69.6, 3074, 2362, 274, 5710
scrow, 1349, 71.3, 1163, 1162, 76, 2401
scrunchey, 1671, 48.8, 4065, 5677, 456, 10198
scttsikes, 962, 71.5, 376, 456, 36, 868
SCUGrad, 1106, 68.4, 126, 134, 9, 269
scullyman, 1216, 27.4, 642, 811, 53, 1506
Scylax, 1388, 32.6, 2521, 2249, 163, 4933
sczi, 1616, 21.5, 3632, 3203, 372, 7207
sdbra, 1398, 130.6, 3478, 3547, 224, 7249
sdgt, 1266, 28.8, 939, 866, 68, 1873
sdilis, 962, 102.2, 132, 522, 19, 673
sdjyq, 1704, 32.0, 277, 319, 35, 631
sdkenned, 1067, 51.7, 497, 1082, 50, 1629
sdockray, 1041, 41.8, 47, 58, 2, 107
SDPrasad, 1283, 67.7, 942, 818, 45, 1805
seafoodmaster, 1315, 59.7, 1045, 1055, 86, 2186
sealco, 948, 24.4, 621, 1428, 23, 2072
seancain, 1483, 32.6, 6615, 4092, 644, 11351
seanfalcon, 904, 123.8, 29, 55, 2, 86
seanmeir, 1325, 56.9, 1441, 1584, 92, 3117
searchingforgreg, 1164, 31.4, 1205, 1611, 84, 2900
seasya, 1135, 48.1, 12455, 19966, 1250, 33671
SebaQuai, 1353, 85.0, 242, 475, 38, 755
sebaspuig, 1300, 61.4, 173, 259, 15, 447
Sebastopol, 1286, 74.0, 473, 420, 43, 936
sebelk, 1201, 92.4, 2118, 5041, 314, 7473
SebSwo, 1523, 62.7, 27, 35, 6, 68
secondfloor, 1352, 177.1, 1, 4, 0, 5
SecondQueen, 884, 99.4, 28, 155, 5, 188
SecondTriwizard, 1163, 81.3, 356, 748, 68, 1172
SECRETSOCIETY, 1387, 39.6, 902, 1867, 130, 2899
securio, 1282, 57.5, 813, 841, 75, 1729
seebert, 1315, 124.0, 549, 1282, 85, 1916
seeed, 1066, 36.2, 278, 297, 13, 588
seetripuu, 1103, 280.0, 2, 5, 0, 7
Seewolfman, 1290, 21.3, 1340, 1683, 113, 3136
SeeZeroSky, 745, 52.3, 35, 239, 8, 282
segv, 1543, 23.7, 11106, 8777, 991, 20874
sehnsuchtjazz, 1531, 38.6, 1273, 1788, 204, 3265
seilerchess, 1066, 43.3, 189, 262, 16, 467
seinfan, 1245, 27.9, 648, 398, 31, 1077
seiwasser, 1069, 40.8, 106, 176, 11, 293
seiyid, 1085, 41.8, 1325, 1642, 93, 3060
sejacobs, 1404, 32.9, 1673, 1798, 165, 3636
sekocajb, 1556, 25.7, 294, 240, 30, 564
sektors, 573, 91.8, 17, 85, 2, 104
selti, 1660, 323.1, 0, 1, 0, 1
SemajWop, 779, 177.6, 0, 7, 0, 7
semikolenov, 1750, 81.3, 522, 533, 60, 1115
semix, 1398, 85.2, 7512, 8105, 530, 16147
semma, 1301, 36.8, 881, 1309, 92, 2282
semptrion, 1346, 32.4, 4112, 5733, 240, 10085
semsal, 1238, 103.0, 2868, 3004, 279, 6151
senggen, 1169, 135.1, 9, 17, 2, 28
Seniola, 1612, 52.5, 505, 498, 52, 1055
seniormoment, 1074, 230.3, 0, 3, 0, 3
senosen, 1185, 63.1, 338, 94, 8, 440
seolta, 1529, 26.0, 6906, 4382, 596, 11884
sepam, 1500, 125.9, 105, 54, 8, 167
seppak, 1436, 190.0, 5, 2, 0, 7
SeppSepp, 1388, 29.3, 602, 417, 49, 1068
sequillion, 1663, 62.7, 34, 31, 1, 66
Serame, 1021, 116.9, 73, 173, 2, 248
serber, 1760, 67.9, 3198, 4517, 850, 8565
serbianem, 1151, 115.8, 26, 116, 0, 142
serbianprince, 1055, 106.3, 203, 302, 13, 518
Serelia, 1923, 32.0, 5978, 4439, 1585, 12002
Seren, 1221, 29.6, 3785, 7584, 384, 11753
SereneThought, 1470, 30.2, 4010, 5552, 310, 9872
sergbond, 1428, 76.2, 6616, 4417, 722, 11755
serginho, 1523, 33.2, 1958, 2231, 185, 4374
sergioCDL, 1410, 31.8, 222, 298, 37, 557
Serhato, 1153, 69.6, 2230, 1312, 117, 3659
SERJAO, 1145, 58.0, 43, 81, 5, 129
serpantin, 1649, 25.2, 656, 940, 51, 1647
sertificator, 1350, 53.4, 487, 428, 24, 939
SERVAS, 999, 93.4, 56, 85, 2, 143
servigo, 1231, 51.1, 1321, 1117, 72, 2510
seta, 1417, 42.7, 13444, 12987, 919, 27350
sethb, 1845, 350.0, 107, 77, 9, 193
sethlong, 1370, 30.8, 697, 866, 33, 1596
SethSilChess, 1344, 96.7, 145, 231, 11, 387
seva, 1710, 36.2, 4970, 3797, 701, 9468
seved, 1642, 30.4, 4788, 5744, 395, 10927
Sevenseal, 1063, 190.2, 1, 4, 1, 6
sevensevens, 1415, 32.8, 8012, 12504, 651, 21167
sevensnobs, 1599, 25.1, 12155, 10445, 1431, 24031
Sevfros, 1705, 91.5, 1555, 1565, 274, 3394
Seward, 1201, 35.0, 1832, 2615, 165, 4612
sexbucket, 1174, 33.4, 251, 277, 24, 552
sexspir, 1385, 32.3, 8757, 12425, 743, 21925
sexyalishan, 864, 206.9, 0, 5, 0, 5
SexyMuffin, 2088, 209.3, 60, 48, 3, 111
sezori, 1304, 111.6, 145, 137, 24, 306
Sfaatw, 1508, 31.3, 2296, 5122, 207, 7625
sfcortes, 1649, 37.4, 609, 713, 51, 1373
sferaslav, 1680, 116.7, 441, 257, 12, 710
sfingo, 1669, 115.8, 36, 12, 3, 51
sfochamp, 1507, 36.7, 13331, 12882, 1050, 27263
Sfrums, 1790, 33.3, 405, 392, 64, 861
sfstate, 1266, 43.7, 1520, 628, 78, 2226
sgabor, 1310, 30.9, 900, 1323, 102, 2325
sgarci, 802, 83.4, 93, 240, 3, 336
sgh, 1546, 51.9, 4819, 2988, 338, 8145
sgodo, 1292, 178.0, 2, 5, 0, 7
sgs, 1369, 42.9, 1076, 728, 89, 1893
sgsawant, 1061, 46.6, 406, 601, 33, 1040
sgssergio, 1245, 40.5, 784, 1029, 58, 1871
Sgtnico, 1109, 52.0, 27, 32, 1, 60
SgtPork, 1316, 77.0, 264, 145, 27, 436
shabado, 1340, 44.4, 425, 324, 51, 800
Shackous, 1124, 72.4, 653, 1093, 19, 1765
shacmat, 1219, 36.8, 1551, 5268, 215, 7034
Shaderman, 1369, 45.9, 1217, 1234, 79, 2530
shadowCatuse, 748, 201.9, 0, 6, 0, 6
shadowHammer, 1150, 344.3, 0, 3, 0, 3
Shadowling, 1627, 26.7, 3300, 3172, 341, 6813
ShadowRFG, 1319, 25.0, 3077, 5917, 512, 9506
ShadowThinker, 1957, 103.6, 86, 52, 4, 142
Shafdawg, 1484, 101.6, 577, 415, 63, 1055
shafest, 1320, 33.0, 1014, 550, 68, 1632
shaguni, 1418, 24.1, 6604, 7524, 554, 14682
shahenshah, 1437, 29.5, 4690, 3387, 581, 8658
Shahin, 1440, 32.3, 5107, 3702, 436, 9245
shahmaut, 1387, 94.8, 266, 537, 42, 845
shahrokhajoodani, 1785, 34.8, 540, 556, 54, 1150
ShahRookKhan, 1223, 103.8, 172, 154, 5, 331
shahroze, 980, 170.9, 3, 6, 0, 9
Shaister, 1270, 29.2, 1196, 1437, 126, 2759
shajanam, 1262, 59.4, 80, 119, 2, 201
Shakagone, 1150, 41.9, 2542, 1650, 195, 4387
ShakaZahn, 1778, 40.3, 1879, 1642, 259, 3780
ShakerFounder, 1724, 40.6, 1009, 851, 59, 1919
shakerman, 1464, 28.3, 1997, 2609, 73, 4679
shakinbaconman, 1345, 33.7, 894, 536, 85, 1515
shakmahde, 1483, 44.5, 1395, 944, 90, 2429
shakmatsky, 1632, 37.3, 753, 302, 41, 1096
Shaleghi, 1230, 101.4, 216, 254, 21, 491
shallit, 1370, 44.3, 12751, 13520, 1385, 27656
shambhala, 1628, 29.2, 9945, 5566, 575, 16086
shamchess, 676, 136.3, 2, 13, 0, 15
shamelesspawn, 1398, 42.8, 7300, 3935, 581, 11816
shana, 2022, 49.2, 6932, 6684, 662, 14278
Shanikwua, 1006, 115.3, 10, 44, 1, 55
shankarar, 1153, 184.5, 2, 3, 0, 5
shankygowda, 828, 89.5, 7, 32, 0, 39
shantchess, 1394, 125.7, 1821, 905, 109, 2835
sharepointme, 1552, 111.8, 1741, 1645, 158, 3544
Sharked, 1036, 194.4, 15, 89, 5, 109
sharkjumper, 1359, 84.1, 529, 702, 86, 1317
SharkMcGreat, 1102, 56.5, 1538, 2069, 77, 3684
sharkmeister, 1686, 350.0, 58, 160, 15, 233
sharm, 1152, 23.9, 6435, 7658, 316, 14409
SharpGambit, 1411, 83.5, 948, 1701, 69, 2718
Sharpov, 1417, 46.0, 1362, 1348, 96, 2806
sharpqaz, 1443, 89.5, 778, 797, 105, 1680
ShasHeen, 1000, 97.9, 1273, 1948, 73, 3294
Shatrandj, 1767, 65.9, 195, 199, 22, 416
Shatranje, 1366, 36.4, 8425, 14829, 767, 24021
shatranjkhiladi, 1033, 192.8, 74, 133, 6, 213
Shatranzi, 1322, 25.6, 4264, 7080, 444, 11788
Shatrun, 1016, 39.9, 222, 339, 24, 585
shattun, 1010, 34.1, 593, 1011, 20, 1624
ShayEd, 1315, 94.8, 500, 584, 38, 1122
Shefeer, 1226, 33.9, 1702, 1726, 96, 3524
Sheikhzakir, 1228, 26.7, 212, 491, 0, 703
sheikurbooti, 1135, 44.9, 72, 81, 1, 154
shekharaaj, 982, 134.5, 7, 40, 0, 47
shekharaj, 987, 82.3, 27, 107, 1, 135
sheldonrampton, 1118, 37.0, 1447, 1706, 135, 3288
Shelobikan, 1431, 58.5, 416, 404, 25, 845
Sherdog, 1301, 28.6, 4487, 5965, 337, 10789
shere, 1155, 138.0, 54, 48, 4, 106
SherlockHolmes, 1482, 35.7, 10496, 9369, 593, 20458
shetty, 1358, 19.7, 5491, 3657, 371, 9519
ShieldMantis, 1498, 32.8, 2389, 1909, 148, 4446
Shierfoot, 1198, 83.5, 64, 81, 8, 153
shiftmate, 1412, 29.1, 13791, 13309, 912, 28012
shiftymongoose, 1623, 27.4, 10502, 11582, 476, 22560
shigun, 1315, 78.2, 46, 68, 1, 115
Shika, 1336, 39.7, 2790, 3719, 202, 6711
Shild, 704, 102.0, 6, 30, 0, 36
shimajirou, 1007, 47.0, 618, 483, 32, 1133
shindriboyz, 927, 65.5, 22, 57, 1, 80
shinethru, 1639, 25.0, 2600, 4841, 273, 7714
ShiningWoods, 971, 93.5, 3, 24, 0, 27
shinuhito, 1415, 44.7, 545, 1036, 64, 1645
shippo, 1507, 174.5, 4, 2, 0, 6
shipwrecked, 1138, 21.9, 948, 1007, 26, 1981
shiraren, 1458, 48.0, 6207, 3762, 338, 10307
shirogane, 2078, 31.3, 1735, 1528, 191, 3454
shiroto, 1330, 33.3, 368, 239, 15, 622
shivaroxxx, 1298, 86.7, 52, 119, 4, 175
Shlektor, 1539, 63.5, 4144, 2954, 355, 7453
Shlmysfb, 1337, 41.4, 1839, 1695, 120, 3654
shmeagel, 921, 269.0, 0, 3, 0, 3
shmeeter, 1051, 69.1, 40, 73, 2, 115
Shmitty, 1477, 27.3, 14515, 9987, 1197, 25699
shoaibalig, 1270, 45.1, 808, 787, 72, 1667
Shobhas, 1266, 102.4, 103, 158, 8, 269
Shochu, 1368, 229.4, 548, 513, 56, 1117
ShockMinD, 1195, 123.5, 279, 522, 6, 807
ShoeshineLenny, 1202, 23.1, 347, 339, 16, 702
shoggie, 1213, 37.8, 1179, 2239, 83, 3501
Shohoku, 1935, 118.1, 115, 23, 5, 143
Shonchan, 1145, 143.1, 38, 92, 0, 130
shortsands, 730, 41.0, 99, 351, 9, 459
shortytaco, 1049, 29.8, 2326, 3210, 154, 5690
shpoont, 1001, 34.2, 208, 512, 22, 742
shredongtr, 1112, 52.3, 642, 860, 31, 1533
ShriLRG, 1407, 111.8, 729, 1357, 93, 2179
shripadk, 881, 135.7, 44, 153, 3, 200
Shripathi, 1175, 40.9, 555, 483, 33, 1071
shrjyasheng, 1255, 32.8, 5313, 11235, 508, 17056
shropshireslasher, 1160, 73.3, 890, 9191, 245, 10326
ShuffleUp, 1475, 54.4, 70, 34, 4, 108
shul, 714, 111.5, 12, 59, 4, 75
shultzl, 1144, 34.9, 1068, 2187, 138, 3393
shumi, 1247, 72.6, 40975, 36971, 5947, 83893
Shurka, 1085, 77.2, 369, 496, 16, 881
shustermat, 1522, 49.1, 463, 690, 51, 1204
shvaughn, 1025, 175.1, 107, 227, 13, 347
shvein, 1584, 133.8, 23, 10, 0, 33
ShyamPatil, 1572, 22.3, 9715, 5736, 377, 15828
shyguywins, 1371, 33.1, 1647, 2625, 106, 4378
sickintentions, 1161, 37.1, 226, 1325, 52, 1603
Sidartha, 1134, 54.7, 425, 418, 40, 883
SideshowJoel, 1283, 39.2, 1770, 1397, 140, 3307
sidhartheng, 1499, 61.4, 730, 1072, 90, 1892
sidlakhotia, 738, 77.5, 4, 30, 0, 34
siege, 1416, 21.4, 10919, 9816, 730, 21465
SierraSette, 1239, 110.0, 164, 358, 16, 538
SIESTENGS, 1828, 45.7, 852, 524, 77, 1453
Siffcat, 872, 100.6, 14, 32, 2, 48
Sift, 1202, 75.7, 210, 276, 23, 509
Sigilo, 2005, 128.4, 408, 169, 23, 600
Sigmundur, 1291, 39.2, 901, 1310, 28, 2239
signum, 1332, 58.6, 252, 278, 33, 563
siho, 1509, 41.4, 6786, 6071, 647, 13504
siissiis, 2044, 70.6, 1742, 798, 158, 2698
sikender, 1383, 92.5, 663, 427, 16, 1106
SilentControl, 1867, 96.0, 862, 893, 79, 1834
siliwangi, 1452, 56.8, 564, 600, 54, 1218
Silknor, 924, 98.8, 232, 255, 21, 508
silvaiv, 1312, 106.5, 185, 209, 15, 409
silverfoxvixen, 916, 245.5, 0, 3, 0, 3
SilverGlobe, 957, 36.5, 213, 251, 7, 471
silverius, 1212, 29.5, 2963, 3100, 201, 6264
Silverlock, 1432, 81.4, 9728, 9142, 783, 19653
SilvrEagle, 1469, 27.0, 23574, 21822, 3564, 48960
Silwyr, 1554, 35.9, 6189, 3995, 401, 10585
SIMAHJOUB, 1089, 94.9, 148, 243, 17, 408
Simavo, 1385, 131.7, 804, 835, 101, 1740
SimeonSlimper, 1487, 195.4, 208, 178, 18, 404
simgadon, 1335, 106.1, 7544, 8767, 629, 16940
simiahun, 1105, 118.9, 125, 158, 15, 298
simonc, 1034, 147.8, 319, 377, 42, 738
SimonDaDiamond, 1183, 26.9, 4375, 2901, 147, 7423
SimonDedalus, 1187, 80.5, 722, 702, 75, 1499
simonlucas, 1811, 35.8, 1998, 1658, 360, 4016
simonv, 1290, 32.1, 2844, 2603, 265, 5712
Simpatico, 1204, 110.7, 2186, 4066, 252, 6504
simpel, 1318, 32.4, 713, 916, 61, 1690
simplexperiences, 1185, 25.4, 696, 785, 29, 1510
simplyknight, 1245, 93.6, 1579, 1417, 104, 3100
simpsonwayne, 1094, 27.7, 250, 281, 21, 552
simsan, 1362, 42.4, 3987, 3908, 365, 8260
Simtili, 1432, 62.1, 176, 89, 8, 273
Sina, 1251, 47.2, 3951, 5806, 460, 10217
sinabhi, 1346, 81.2, 1361, 1303, 98, 2762
sinalunga, 934, 40.6, 305, 554, 32, 891
sinceremin, 1174, 145.9, 9, 13, 2, 24
SineCosine, 1288, 35.7, 3825, 5603, 303, 9731
sinfonias, 1373, 63.8, 3995, 3326, 299, 7620
SingleSpiral, 1309, 60.0, 1033, 1096, 27, 2156
SingSing, 1115, 26.3, 3829, 6003, 535, 10367
sinichi, 816, 56.6, 43, 98, 4, 145
SiNNarJee, 1195, 69.2, 8, 28, 0, 36
Sinoda, 1090, 24.2, 1479, 2267, 71, 3817
Sioberg, 1603, 29.0, 6492, 6891, 615, 13998
SirAdder, 1412, 48.4, 5471, 5775, 412, 11658
siralofwo, 1634, 69.5, 51, 147, 9, 207
sirblack, 1695, 25.3, 12231, 23779, 999, 37009
sircaradoc, 1554, 139.8, 117, 144, 27, 288
SirCMP, 1619, 24.2, 6651, 6976, 1000, 14627
sirebrum, 1102, 93.4, 179, 173, 6, 358
Sirena, 1583, 35.5, 774, 1584, 81, 2439
SirFrankDrake, 1747, 133.7, 2260, 2062, 225, 4547
sirgoodknightsir, 1654, 50.7, 424, 222, 14, 660
SirioChess, 1570, 39.0, 1261, 798, 38, 2097
SirJant, 1671, 97.8, 29, 26, 3, 58
sirjoeanita, 1289, 39.8, 2021, 1181, 80, 3282
SirJT, 1321, 106.6, 443, 486, 56, 985
sirnesto, 1639, 25.5, 2379, 1310, 289, 3978
SirNighted, 1255, 38.2, 4037, 4624, 348, 9009
Sirpooba, 1141, 26.8, 661, 1119, 93, 1873
sirpoofluous, 1299, 81.5, 20, 47, 1, 68
sirpsionics, 1354, 113.0, 1137, 908, 106, 2151
Sirqueeny, 1228, 61.1, 309, 347, 31, 687
Sirrealz, 1172, 52.4, 1545, 2024, 115, 3684
sirschaap, 1357, 28.8, 6190, 4547, 694, 11431
SirVLCIV, 1652, 48.3, 31, 38, 0, 69
sisengbg, 1646, 132.1, 21, 89, 8, 118
Sisyphusrocks, 965, 40.9, 794, 857, 51, 1702
SithSithSith, 1493, 86.9, 1107, 756, 125, 1988
SixSplits, 1345, 105.5, 7, 9, 0, 16
Sizhuang, 1352, 69.9, 323, 259, 19, 601
sjcinclifford, 1241, 28.5, 6640, 7954, 635, 15229
sjdprods, 1145, 57.9, 320, 372, 28, 720
sjeijk, 1132, 28.2, 286, 329, 28, 643
sjmate, 775, 161.8, 23, 72, 3, 98
skaakmeester, 867, 130.0, 6, 19, 2, 27
skaazi, 1423, 75.0, 83, 131, 3, 217
skaik, 1455, 65.3, 5839, 11022, 479, 17340
Skando, 864, 105.4, 143, 203, 10, 356
Skasen, 1165, 31.8, 788, 985, 84, 1857
skaterchess, 1172, 48.5, 348, 716, 29, 1093
Skbanj, 1167, 75.9, 28, 112, 0, 140
Skelton, 1251, 75.9, 265, 299, 46, 610
skid, 1278, 36.9, 6535, 7179, 906, 14620
skiffle, 1446, 44.5, 1190, 1198, 84, 2472
skikrieger, 1034, 66.9, 220, 334, 13, 567
skillafied, 1010, 115.7, 20, 35, 3, 58
skimtnbikekayak, 1294, 23.6, 2859, 3640, 309, 6808
skinnytuxedo, 1389, 62.1, 1206, 1495, 119, 2820
Skiodaimon, 1494, 36.7, 221, 245, 20, 486
Skippio, 1206, 31.6, 188, 366, 35, 589
skipto, 1090, 66.1, 3024, 2687, 186, 5897
Skitterbug, 1421, 46.0, 567, 657, 73, 1297
skiviktor, 1325, 32.6, 1209, 1348, 165, 2722
sklewen, 1023, 63.3, 72, 153, 9, 234
skmd, 1351, 52.0, 156, 145, 4, 305
skogs, 1167, 92.3, 259, 308, 16, 583
SkoZay, 1043, 37.3, 246, 1063, 29, 1338
skrappythree, 1565, 51.6, 4635, 4984, 505, 10124
Skula, 1437, 36.8, 8302, 9178, 820, 18300
skullDragon, 1062, 344.3, 0, 1, 0, 1
skunkmaster, 1203, 233.8, 7, 14, 5, 26
Skvee, 1889, 29.2, 5410, 3455, 624, 9489
Skwerly, 1432, 65.6, 646, 356, 38, 1040
SkyCat, 1221, 55.0, 2098, 3798, 87, 5983
Skyfox, 1100, 350.0, 0, 1, 0, 1
SkyGull, 1480, 38.9, 8557, 11222, 637, 20416
SkyHunterJay, 1460, 27.2, 5703, 5473, 424, 11600
SkyJuice, 1302, 94.1, 1434, 1277, 69, 2780
SkyKevin, 969, 136.4, 55, 102, 5, 162
SkyLark, 1408, 99.9, 12369, 7917, 967, 21253
SkyMeadow, 997, 38.0, 871, 1223, 69, 2163
skysmile, 1067, 161.4, 2, 5, 0, 7
slabybolek, 1275, 70.7, 544, 764, 48, 1356
slaferry, 1056, 26.6, 332, 650, 22, 1004
Slamara, 1448, 51.5, 867, 336, 47, 1250
slammo, 1134, 28.2, 2348, 2883, 127, 5358
slapsky, 1856, 59.0, 23392, 23180, 2243, 48815
slapymex, 1468, 45.7, 1566, 1993, 263, 3822
slaran, 1257, 105.3, 611, 407, 58, 1076
slavattax, 1115, 30.5, 1625, 2740, 153, 4518
SLAVENKO, 1700, 38.8, 3766, 5169, 439, 9374
slavering, 1842, 31.9, 4202, 1696, 273, 6171
Slaytesics, 592, 142.8, 0, 15, 0, 15
slayyerr, 2000, 69.6, 77, 50, 9, 136
SleekMedia, 1161, 149.8, 13, 25, 1, 39
sleeperknight, 1499, 20.7, 3585, 5447, 747, 9779
sleepwalkerman, 1503, 23.1, 5018, 4050, 298, 9366
SleepyEyes, 1594, 94.3, 123, 89, 11, 223
slefranc, 918, 35.9, 342, 424, 9, 775
Slek, 1595, 112.2, 3004, 2980, 210, 6194
slichess, 1495, 32.1, 2973, 4179, 510, 7662
slightlyBetter, 1378, 50.7, 1059, 851, 58, 1968
slitherNsloth, 1497, 34.1, 6276, 9907, 782, 16965
SliverXII, 1004, 180.9, 123, 150, 4, 277
slluttor, 1994, 46.7, 2374, 1128, 274, 3776
slmouradian, 1311, 42.3, 1357, 1175, 143, 2675
SlobberKnocker, 1403, 28.2, 1346, 1354, 64, 2764
slobodan, 1759, 77.5, 716, 521, 78, 1315
slobulus, 1729, 55.3, 347, 160, 26, 533
slomotion, 1598, 239.7, 1, 1, 0, 2
slomov, 1967, 18.8, 9589, 11210, 1296, 22095
Sloot, 1757, 24.3, 20779, 14574, 2369, 37722
slouhend, 1484, 21.7, 15661, 13392, 782, 29835
SlowDog, 1393, 35.8, 11635, 6994, 1186, 19815
SlowDrift, 1215, 26.7, 1517, 1338, 119, 2974
slowgamer, 1362, 34.8, 1377, 1176, 219, 2772
SlowTrain, 1456, 34.1, 3789, 4250, 962, 9001
SlumpAttack, 1328, 31.2, 634, 1181, 28, 1843
SlyNinja, 1371, 67.6, 343, 249, 18, 610
slyrakis, 1671, 39.8, 1008, 535, 54, 1597
SMACKS, 1096, 75.6, 939, 4956, 138, 6033
smallblackcat, 1710, 36.2, 2043, 1647, 253, 3943
smalldreams, 837, 134.4, 17, 68, 1, 86
smallpuppy, 1498, 31.4, 9286, 8849, 713, 18848
smartabs, 1709, 26.3, 8302, 8868, 1278, 18448
smartmac, 1229, 91.8, 1401, 1734, 90, 3225
smartpawn, 1519, 30.6, 12476, 8422, 934, 21832
SmashBrosBrawl, 1038, 38.9, 64, 95, 7, 166
SMAST, 879, 103.8, 4, 29, 1, 34
SmellYaLater, 1561, 257.1, 0, 1, 0, 1
smellyfish, 1818, 50.7, 10068, 18068, 1755, 29891
smenke, 1690, 30.6, 3452, 3415, 278, 7145
smerk, 1190, 129.5, 51, 87, 11, 149
Smetty, 1258, 86.2, 25, 37, 0, 62
smidge, 1066, 40.6, 204, 231, 18, 453
smif, 1964, 173.7, 9505, 6016, 640, 16161
smiikel, 1425, 37.2, 1553, 1557, 102, 3212
smiletolead, 889, 147.6, 3, 30, 2, 35
smilingpolitely, 1156, 110.2, 230, 280, 19, 529
smohsin, 940, 108.5, 4, 35, 0, 39
smokedaddy, 1362, 188.4, 1, 3, 0, 4
smoketwojoints, 1025, 58.7, 309, 471, 15, 795
Smokeyfire, 589, 146.6, 7, 87, 1, 95
smokingmonkey, 1469, 41.3, 1573, 1135, 338, 3046
smokinjimmyv, 1756, 25.1, 5541, 12628, 1329, 19498
smoozer, 1308, 33.9, 6452, 6853, 744, 14049
smorr, 1208, 258.1, 0, 2, 0, 2
smryab, 1709, 130.0, 582, 588, 69, 1239
Smurfbot, 1329, 309.9, 1, 1, 0, 2
smwchevelle, 1201, 167.1, 1, 4, 1, 6
SmyslovTheSlayer, 1590, 40.1, 441, 207, 23, 671
snaggerss, 1038, 29.7, 155, 226, 10, 391
snailbrain, 846, 58.4, 396, 1378, 9, 1783
Snarchie, 1106, 31.1, 409, 403, 30, 842
snauggie, 1239, 38.4, 809, 623, 53, 1485
snazzzzzz, 941, 112.1, 105, 169, 7, 281
Sneaky, 1354, 117.8, 1788, 1266, 108, 3162
sneakyness, 983, 98.6, 10, 33, 2, 45
snek, 1414, 23.4, 5150, 4854, 389, 10393
snexi, 1718, 41.5, 5036, 2385, 338, 7759
sniklegs, 1314, 46.1, 5272, 6192, 354, 11818
sniktawiii, 1313, 26.7, 208, 110, 19, 337
Snipebog, 771, 182.3, 1, 9, 0, 10
snob, 1445, 23.4, 16860, 17679, 966, 35505
Snoopix, 1223, 34.5, 2328, 8267, 575, 11170
SnoopyKing, 1155, 116.8, 31, 338, 2, 371
snorkledorf, 1298, 54.4, 2450, 1961, 162, 4573
snoskier, 780, 77.2, 42, 188, 7, 237
snowday, 1496, 32.0, 2904, 4395, 333, 7632
Snowrealm, 1894, 90.4, 1908, 771, 152, 2831
snowseal, 1757, 112.4, 1199, 665, 45, 1909
Snuggyebaby, 1066, 131.2, 8, 90, 0, 98
Snuis, 1382, 102.0, 976, 842, 39, 1857
snycal, 1511, 30.0, 19399, 25312, 1281, 45992
snyderb, 1164, 59.8, 1186, 1363, 67, 2616
snyk, 1435, 28.8, 3261, 3217, 244, 6722
Sobong, 1129, 97.8, 15, 32, 3, 50
Sociologist, 1446, 44.2, 5429, 5876, 835, 12140
Sociopath, 1434, 63.4, 18, 32, 2, 52
socios, 1135, 28.7, 774, 991, 72, 1837
SocksManly, 1407, 60.4, 546, 528, 35, 1109
socod, 1412, 136.6, 161, 128, 18, 307
Sodar, 1392, 27.5, 400, 425, 75, 900
sodel, 1933, 38.1, 6329, 4807, 1028, 12164
Sodumb, 1933, 27.7, 964, 810, 186, 1960
sofias, 1543, 93.9, 1782, 3458, 132, 5372
softmark, 1135, 53.4, 48, 151, 2, 201
SoICanSwim, 1467, 90.4, 130, 95, 14, 239
sojourner, 1318, 28.3, 12822, 13425, 892, 27139
Sol, 1873, 65.3, 7862, 5083, 592, 13537
SolarisTC, 1531, 39.4, 4360, 4039, 506, 8905
SolBadGuy, 1126, 105.8, 80, 152, 10, 242
soldadofiel, 1396, 126.5, 215, 198, 18, 431
solidgold, 1010, 59.9, 3016, 5297, 245, 8558
SolidStrike, 1593, 104.7, 28, 32, 0, 60
solkta, 1081, 33.2, 786, 920, 54, 1760
solodzol, 943, 264.1, 6, 16, 0, 22
SoloePensoso, 1403, 37.8, 177, 116, 11, 304
solorunningsolo, 1128, 33.7, 3007, 4892, 378, 8277
SOLRIWOS, 839, 114.3, 466, 856, 42, 1364
soltor, 975, 123.6, 391, 770, 41, 1202
SolVita, 1809, 22.4, 8446, 8758, 1004, 18208
somannair, 1461, 27.2, 5091, 8962, 940, 14993
someguysome, 960, 256.8, 0, 2, 0, 2
somejoseph, 1121, 97.0, 970, 722, 83, 1775
somethinghere, 1444, 38.3, 4537, 3327, 281, 8145
somethingwitty, 1220, 72.1, 2264, 3090, 154, 5508
SomewhatSane, 1136, 124.8, 13, 22, 0, 35
Sonare, 1325, 23.4, 4137, 6104, 287, 10528
sonareclipse, 1658, 34.1, 7174, 6028, 479, 13681
songamonga, 1755, 37.6, 3497, 4630, 439, 8566
sonikf, 1523, 34.3, 19589, 27765, 1845, 49199
sonnehbj, 1745, 29.9, 2643, 1872, 346, 4861
sonnychess, 1078, 108.0, 196, 366, 10, 572
sonofegypt, 1676, 26.6, 1168, 943, 115, 2226
SonofNimzovitch, 1516, 42.5, 1540, 813, 139, 2492
sonoftal, 1567, 49.0, 1171, 812, 150, 2133
SONTOLOYO, 761, 89.6, 3, 46, 1, 50
sonus, 1483, 32.2, 2783, 2111, 275, 5169
soody, 878, 94.2, 280, 1578, 54, 1912
soondraw, 1575, 26.4, 470, 371, 40, 881
soopaman, 1157, 29.5, 1182, 1554, 67, 2803
SophieSweet, 1480, 101.0, 2193, 3612, 181, 5986
Sophistique, 1126, 73.6, 2126, 4294, 191, 6611
Sorazal, 1084, 105.8, 109, 140, 11, 260
sorcererw, 1383, 57.2, 244, 388, 29, 661
sordello, 719, 190.4, 6, 31, 0, 37
Sorengo, 1462, 32.1, 7450, 5139, 482, 13071
soreny, 1357, 80.4, 6675, 8054, 875, 15604
sosmogyoro, 1326, 87.1, 1304, 2217, 221, 3742
SoSOscar, 1173, 73.7, 53, 87, 7, 147
sosser, 1735, 19.8, 2134, 3905, 235, 6274
SotoG, 1483, 69.5, 2805, 2042, 201, 5048
Soubotai, 1337, 29.7, 1199, 1256, 90, 2545
soucyj, 1090, 108.8, 26, 72, 3, 101
soukourin, 1362, 90.3, 412, 478, 38, 928
Souldin, 1724, 34.9, 1303, 1384, 101, 2788
soulman, 968, 164.5, 19, 73, 2, 94
Soulpower, 1806, 32.4, 2693, 2259, 277, 5229
SourTurkey, 925, 109.2, 183, 206, 21, 410
Sousa, 1213, 37.8, 5324, 4561, 290, 10175
SouthernAlberta, 1183, 79.6, 46, 73, 5, 124
southernjumper, 1057, 31.4, 691, 980, 50, 1721
southwarkcop, 1546, 27.2, 1400, 674, 14, 2088
sovajoe, 1484, 70.4, 2526, 3092, 250, 5868
soysiete, 1230, 26.8, 1128, 2362, 61, 3551
sozu, 1226, 133.2, 23, 49, 2, 74
spacab, 1038, 167.4, 2, 21, 0, 23
SpaceBound, 1917, 130.8, 9, 8, 2, 19
spacefizzicist, 1419, 37.4, 1074, 1387, 108, 2569
Spacefly, 1438, 35.4, 7882, 7569, 993, 16444
spacemanspliff, 1425, 30.7, 1811, 1151, 128, 3090
spacemonster, 1645, 57.1, 821, 797, 100, 1718
Spahi, 2023, 57.5, 679, 339, 42, 1060
spalpeen, 1805, 24.7, 12597, 18235, 1329, 32161
Spamsky, 1678, 72.4, 6869, 6553, 660, 14082
spanksyou, 1477, 40.2, 1287, 823, 54, 2164
spanner, 1265, 31.4, 3581, 4472, 271, 8324
SpareUs, 1543, 55.1, 5129, 3697, 541, 9367
sparis, 746, 339.8, 119, 406, 15, 540
Sparkers, 1277, 39.7, 1307, 1514, 103, 2924
spartanmanor, 1108, 97.2, 9, 13, 0, 22
spase, 1124, 49.0, 32, 96, 0, 128
Spasiba, 1481, 162.1, 204, 141, 16, 361
spatri, 1443, 56.0, 989, 374, 60, 1423
SpazBotTwoKOneOne, 850, 96.0, 8, 11, 0, 19
spazky, 1372, 35.4, 1984, 2352, 203, 4539
specialhj, 1362, 33.8, 7037, 8663, 518, 16218
SpecialX, 898, 78.9, 85, 195, 4, 284
speciesxxx, 2003, 118.3, 537, 443, 31, 1011
specks, 1158, 25.6, 3859, 5942, 210, 10011
speedyf, 1306, 23.6, 7213, 7498, 418, 15129
spencewah, 977, 66.5, 166, 339, 5, 510
spenjch, 1166, 41.7, 347, 384, 21, 752
Spessotto, 1455, 34.4, 2288, 2857, 169, 5314
SPhillips, 1206, 85.4, 269, 331, 18, 618
sphinx, 1543, 28.1, 23795, 14678, 1807, 40280
SphinxMoth, 1057, 102.2, 269, 688, 56, 1013
SpicyRizzak, 1121, 70.9, 208, 241, 12, 461
Spiehler, 1262, 40.6, 578, 877, 97, 1552
Spielmacher, 1829, 84.9, 1596, 764, 236, 2596
Spinny, 1101, 26.7, 3542, 3328, 365, 7235
Spinosa, 1550, 43.2, 2929, 2136, 298, 5363
sPion, 895, 69.5, 867, 1255, 58, 2180
spip, 1342, 36.0, 1207, 1774, 106, 3087
Spiraltrap, 1263, 80.1, 129, 113, 13, 255
SpiritFox, 1306, 97.6, 30, 28, 3, 61
SpiritSoaked, 727, 145.6, 6, 60, 1, 67
SpiritsWord, 1187, 57.2, 213, 142, 16, 371
SpiritXL, 863, 33.4, 297, 1206, 13, 1516
splinteredthought, 1422, 26.3, 2671, 3062, 133, 5866
splitbrain, 1431, 25.0, 9760, 11610, 918, 22288
SplitWood, 1297, 48.7, 799, 973, 52, 1824
splixxer, 1846, 100.8, 785, 261, 47, 1093
Spluff, 894, 166.5, 1, 7, 0, 8
spng, 1827, 117.1, 1172, 613, 106, 1891
spockmercur, 1257, 62.3, 149, 186, 14, 349
Spohr, 1900, 129.6, 666, 286, 74, 1026
spontex, 1101, 86.6, 408, 482, 36, 926
SpoonA, 2104, 20.6, 27333, 18984, 2241, 48558
SpoonerBJ, 1638, 55.6, 356, 369, 65, 790
sprbrnng, 1525, 22.1, 3760, 2908, 257, 6925
spuskyer, 1160, 120.9, 0, 19, 0, 19
Spybeach, 834, 184.1, 1, 7, 1, 9
spydersweb, 1035, 29.6, 8240, 13221, 573, 22034
spykid, 1825, 94.0, 1463, 1224, 145, 2832
SpyrosAthens, 1224, 45.5, 540, 751, 52, 1343
spyvsspy, 1244, 167.9, 75, 100, 2, 177
squarecentral, 1241, 129.0, 20, 30, 1, 51
SquareDancing, 1466, 99.1, 269, 469, 40, 778
squareit, 1315, 39.7, 2322, 2521, 184, 5027
Squarsh, 1202, 45.6, 6375, 5039, 339, 11753
Squeedle, 1478, 29.5, 1137, 756, 81, 1974
squeers, 1267, 39.5, 2970, 3245, 153, 6368
Squidy, 1050, 65.0, 27, 35, 4, 66
squilliam, 1507, 23.5, 5256, 5503, 405, 11164
Squirrelj, 1611, 26.6, 1436, 1498, 132, 3066
Squishes, 1180, 58.0, 593, 984, 60, 1637
Squishey, 1116, 24.9, 501, 1006, 55, 1562
sraffa, 1255, 29.2, 2490, 4950, 277, 7717
srak, 933, 171.6, 599, 670, 65, 1334
sramanujan, 1496, 44.3, 2008, 2011, 183, 4202
sraobs, 1310, 28.0, 1866, 2688, 71, 4625
srapjan, 1342, 39.6, 2514, 2072, 226, 4812
Srbo, 2006, 59.8, 750, 496, 148, 1394
SRCorney, 1237, 54.4, 106, 95, 12, 213
sreeneni, 1676, 22.4, 11640, 4054, 815, 16509
srettirc, 1437, 107.4, 2192, 1327, 216, 3735
Sriada, 1526, 60.1, 1400, 1064, 88, 2552
SRIDHARM, 1058, 51.0, 244, 424, 10, 678
srikantann, 1079, 116.2, 55, 29, 1, 85
srinisha, 1022, 52.9, 126, 192, 18, 336
SrinVas, 1478, 58.6, 1624, 1262, 157, 3043
sriramajayam, 1057, 249.3, 1, 3, 0, 4
srivas, 1222, 125.2, 2774, 3358, 338, 6470
Srixon, 1350, 23.3, 2696, 6733, 238, 9667
srmsdad, 1128, 35.6, 272, 204, 7, 483
srschanakya, 1039, 259.7, 0, 2, 0, 2
ssaammmm, 1394, 29.9, 3532, 3580, 429, 7541
ssez, 1345, 31.6, 686, 1057, 68, 1811
ssgg, 1342, 25.1, 11098, 11548, 747, 23393
ssirovi, 1186, 68.0, 828, 980, 46, 1854
ssjoshi, 1440, 59.7, 277, 155, 22, 454
sslchess, 943, 71.0, 518, 812, 68, 1398
ssprotein, 1603, 23.1, 6477, 8637, 552, 15666
sssmashy, 1069, 25.0, 1063, 1797, 48, 2908
sssssssssssssssss, 1317, 90.7, 345, 379, 8, 732
stada, 1621, 25.3, 19936, 13709, 1259, 34904
sTAE, 1471, 118.4, 2520, 2634, 244, 5398
staffon, 1619, 38.8, 1365, 1069, 112, 2546
stafilowilly, 1130, 42.2, 4202, 5026, 197, 9425
stalebread, 1285, 30.8, 1637, 3826, 177, 5640
Stalkov, 1334, 41.8, 2522, 2451, 164, 5137
stallemonster, 866, 107.9, 142, 190, 7, 339
stama, 1283, 55.2, 2787, 1493, 207, 4487
stanbeck, 839, 225.6, 0, 3, 0, 3
stanbox, 1282, 35.4, 2588, 3979, 187, 6754
stange, 1313, 44.6, 2306, 2550, 136, 4992
StanGetz, 901, 53.2, 1552, 2290, 80, 3922
stankwagon, 1602, 115.1, 81, 77, 10, 168
StanShaw, 933, 47.4, 34, 87, 2, 123
Stantastic, 1558, 306.1, 0, 1, 0, 1
Staples, 1389, 42.0, 6846, 7920, 479, 15245
starbuxz, 1184, 222.1, 1, 2, 0, 3
starchip, 742, 114.2, 699, 1896, 49, 2644
starfishSuprise, 1493, 30.5, 7476, 8721, 495, 16692
stargazyr, 1149, 277.6, 1, 2, 0, 3
starkley, 1475, 41.6, 7770, 5526, 467, 13763
starkvdub, 1507, 93.6, 121, 97, 7, 225
StarrC, 880, 127.0, 8, 26, 0, 34
STATHIWISE, 797, 75.0, 5, 39, 0, 44
staticforce, 1010, 55.6, 22, 34, 2, 58
StAtlas, 1202, 207.4, 4, 3, 0, 7
statstrader, 1412, 162.1, 378, 663, 29, 1070
stautxie, 1464, 252.2, 2, 2, 1, 5
Stayback, 1246, 33.4, 1049, 1696, 63, 2808
staywitit, 719, 110.6, 11, 74, 2, 87
STBASILEXTIAN, 992, 201.5, 5, 12, 0, 17
stcamillis, 950, 29.6, 961, 1804, 57, 2822
Steady, 1159, 38.8, 4826, 6531, 621, 11978
SteakTartare, 1619, 28.9, 25211, 17911, 2226, 45348
stealthbomber, 1323, 28.5, 14997, 21295, 1330, 37622
stealwolf, 936, 123.4, 8, 31, 3, 42
Stedak, 1457, 27.9, 11799, 10629, 508, 22936
Steeldef, 1549, 57.3, 263, 291, 35, 589
SteelKnife, 1398, 72.1, 181, 186, 25, 392
stefaan, 1444, 41.9, 16049, 15646, 1828, 33523
StefaNSokoloV, 1281, 39.4, 2900, 2645, 167, 5712
stefanzo, 2082, 115.7, 233, 136, 19, 388
stefolder, 1096, 33.3, 2200, 4189, 265, 6654
Steftcho, 1578, 27.0, 4811, 4098, 523, 9432
steghost, 1412, 78.6, 607, 1149, 91, 1847
Steinbock, 1052, 32.2, 496, 477, 24, 997
stejacob, 1222, 90.2, 503, 463, 49, 1015
stellarremix, 1307, 104.0, 712, 415, 59, 1186
stelligerpolus, 869, 35.0, 364, 542, 35, 941
stelmah, 766, 35.2, 104, 341, 10, 455
Stenn, 1428, 28.9, 13714, 12284, 1159, 27157
stephenm, 1476, 32.7, 1520, 2309, 150, 3979
sterner, 1525, 48.3, 1515, 1509, 102, 3126
Sternschach, 1747, 61.4, 181, 125, 22, 328
steuwer, 1421, 39.8, 5046, 5501, 335, 10882
steveches, 1233, 41.9, 731, 531, 85, 1347
SteveGregory, 1434, 59.0, 556, 317, 81, 954
stevekos, 1157, 37.2, 1124, 2515, 106, 3745
SteveLeeds, 1586, 57.7, 29, 15, 1, 45
StevenD, 1375, 29.1, 11124, 7009, 997, 19130
Stevenmulenga, 1222, 116.4, 78, 92, 7, 177
stevensito, 1914, 48.6, 1953, 2396, 283, 4632
stevensonma, 1428, 232.8, 1, 2, 0, 3
steventlamb, 1503, 28.0, 1393, 1055, 109, 2557
Steveolio, 1607, 31.0, 1850, 2736, 76, 4662
stevewalker, 1425, 55.7, 753, 1006, 77, 1836
steveyg, 910, 47.4, 59, 300, 3, 362
StevieWWW, 1600, 37.4, 1983, 1439, 163, 3585
stevish, 1179, 69.0, 75, 46, 4, 125
steward, 1058, 33.9, 742, 1255, 41, 2038
StewJac, 1245, 117.2, 774, 1039, 22, 1835
STHOR, 1694, 32.9, 6004, 3678, 348, 10030
StickMans, 968, 83.1, 180, 317, 7, 504
StickyGreen, 833, 132.5, 16, 54, 2, 72
StickyPawn, 1451, 66.7, 330, 183, 25, 538
stihaki, 1234, 29.3, 860, 887, 38, 1785
StiliDimitrov, 1820, 54.4, 1585, 1338, 240, 3163
Stimuli, 1062, 102.2, 16, 35, 0, 51
Stinga, 2110, 163.4, 1955, 962, 130, 3047
stingfish, 1252, 87.5, 232, 185, 9, 426
stinkenbadbishop, 1300, 46.5, 512, 504, 50, 1066
stinkinbishop, 1143, 35.6, 165, 70, 4, 239
stixnsand, 1682, 28.0, 8606, 8550, 876, 18032
stjohnteacher, 1735, 28.1, 508, 355, 42, 905
stjur, 1470, 25.7, 17800, 19475, 1696, 38971
stnemes, 1126, 93.9, 218, 466, 27, 711
StoffelS, 1686, 112.0, 2422, 1631, 371, 4424
stol, 1769, 55.0, 2153, 2452, 313, 4918
stomassetti, 1106, 111.9, 9, 11, 0, 20
StonedImmaculate, 958, 134.5, 212, 414, 14, 640
StoneFish, 1335, 78.4, 732, 648, 66, 1446
Stonehouse, 975, 105.3, 587, 632, 27, 1246
StoneMonkey, 1752, 31.4, 9506, 5973, 764, 16243
stonylove, 1165, 40.5, 2067, 4889, 124, 7080
StopVinceYoung, 1402, 87.5, 111, 101, 10, 222
storforgoad, 1233, 49.2, 562, 1043, 41, 1646
stormj, 1025, 80.1, 599, 792, 27, 1418
stormm, 1603, 24.9, 338, 339, 32, 709
Stormyisback, 1703, 97.1, 952, 836, 104, 1892
stota, 838, 110.4, 11, 45, 2, 58
Stoukas, 1847, 51.8, 50, 18, 0, 68
sTpny, 1337, 27.5, 6271, 9593, 122, 15986
straatschoffie, 1644, 25.2, 805, 585, 40, 1430
strahinus, 1548, 38.8, 1585, 1829, 160, 3574
Straineryou, 1490, 25.4, 8991, 7064, 937, 16992
StrandBum, 1050, 58.8, 685, 855, 20, 1560
strangeweather, 1840, 45.7, 496, 157, 35, 688
Stratetactics, 1182, 123.8, 122, 131, 11, 264
stratisnikiforos, 1263, 226.0, 10, 10, 0, 20
Strativari, 1509, 106.3, 121, 101, 12, 234
StratPlan, 1363, 38.3, 6147, 6540, 833, 13520
straycatstrut, 1653, 33.3, 4460, 3313, 260, 8033
Strbarrytree, 1110, 74.4, 601, 647, 36, 1284
streamvn, 1024, 127.1, 31, 65, 1, 97
Strelz, 1360, 61.9, 1778, 1289, 147, 3214
stretto, 1362, 29.6, 5602, 6285, 285, 12172
strgym, 1383, 143.4, 8, 7, 0, 15
stricken, 1241, 66.4, 528, 767, 21, 1316
StrikeEagleMugsy, 1199, 34.5, 1157, 921, 133, 2211
Strikko, 1523, 43.5, 8819, 9694, 970, 19483
StringEmpty, 1338, 194.3, 3, 5, 0, 8
Strix, 1484, 77.1, 14859, 12734, 1117, 28710
strjo, 1167, 46.4, 967, 1221, 57, 2245
Strk, 1152, 93.8, 1507, 1796, 96, 3399
strobane, 1206, 43.7, 3199, 3132, 386, 6717
strobeen, 1517, 28.6, 116, 144, 17, 277
strobexii, 1356, 89.3, 2441, 4672, 195, 7308
STROBOCHESS, 1584, 33.5, 15654, 6292, 477, 22423
stroms, 1108, 31.2, 853, 1020, 56, 1929
Strongguy, 1458, 28.6, 9568, 11991, 379, 21938
strongking, 1761, 26.7, 33421, 20647, 2292, 56360
Struuut, 1658, 30.9, 1609, 1769, 182, 3560
stryke, 1790, 40.4, 157, 166, 23, 346
StStephen, 989, 46.8, 553, 371, 41, 965
stuartjduff, 1220, 31.4, 1218, 1136, 210, 2564
StudleyHungwell, 1274, 48.7, 3654, 6665, 138, 10457
sturgeon, 1315, 87.9, 337, 431, 40, 808
Styria, 1637, 27.9, 23341, 14890, 785, 39016
SUBARUMAN, 1323, 23.4, 1517, 3003, 125, 4645
subkanzler, 1044, 140.5, 100, 143, 7, 250
submartingale, 1305, 52.1, 2254, 3561, 143, 5958
SubzeroDD, 1207, 64.4, 193, 275, 16, 484
sucaba, 1898, 23.4, 5074, 3292, 781, 9147
suckermc, 1280, 31.1, 10051, 8190, 665, 18906
SuckyMcSlowster, 1600, 147.9, 46, 25, 3, 74
Sudar, 1338, 25.8, 880, 1379, 108, 2367
suddenlydead, 1439, 37.5, 393, 222, 35, 650
SudhirGupta, 1405, 26.6, 2771, 3008, 641, 6420
sudhirsingh, 1512, 81.3, 3093, 5313, 257, 8663
suejane, 897, 62.5, 740, 1292, 91, 2123
suequntf, 1142, 65.8, 2851, 3130, 203, 6184
SufferingBruin, 1065, 26.3, 903, 773, 62, 1738
Sufler, 2302, 53.2, 881, 87, 72, 1040
Sugarhill, 1166, 37.4, 434, 426, 32, 892
suicidesquirrel, 1360, 46.5, 3339, 4057, 237, 7633
SullenBishop, 2222, 176.7, 2997, 1585, 398, 4980
sullrich, 1018, 47.0, 60, 58, 5, 123
Sullyman, 1380, 28.4, 345, 645, 53, 1043
sulus, 1005, 138.0, 2, 7, 1, 10
sumadartson, 1533, 25.0, 7535, 10690, 768, 18993
Suman, 964, 220.5, 1, 5, 1, 7
sumitanand, 1063, 24.9, 478, 1524, 59, 2061
sumraj, 1335, 56.8, 1423, 1279, 165, 2867
sumuttaja, 1962, 40.6, 1577, 1108, 203, 2888
SunburntAZ, 1337, 26.9, 292, 291, 7, 590
SunburstStrat, 1318, 40.2, 87, 209, 7, 303
sunday, 1725, 26.1, 9521, 7539, 818, 17878
sunesoft, 1186, 76.1, 82, 97, 7, 186
sungangyi, 986, 49.4, 43, 67, 1, 111
sunnny, 802, 184.6, 0, 6, 0, 6
SunnyLim, 1529, 73.6, 921, 1002, 225, 2148
sunnymoon, 1056, 39.8, 135, 140, 14, 289
sunnyy, 964, 98.1, 11, 33, 1, 45
sunodissey, 1287, 30.3, 309, 348, 22, 679
sunodrome, 1941, 61.6, 690, 666, 90, 1446
sunrhades, 1621, 34.4, 3024, 3875, 225, 7124
suntze, 1284, 29.6, 522, 977, 86, 1585
supajut, 1171, 28.3, 1473, 1523, 72, 3068
superassassin, 1057, 66.4, 61, 62, 3, 126
Superbadass, 1559, 110.9, 107, 160, 8, 275
superbee, 1570, 28.7, 4531, 4921, 280, 9732
supercarpetman, 1298, 330.1, 0, 1, 0, 1
supercky, 1193, 215.1, 17, 23, 2, 42
SuperDaemon, 1756, 33.4, 4099, 3654, 407, 8160
superdreamkilla, 1254, 44.1, 161, 144, 5, 310
SuperEight, 821, 83.7, 16, 69, 0, 85, 1514, 58.9, 3242, 3091, 403, 6736
superlopez, 1211, 36.2, 3763, 4112, 344, 8219
SUPERMANpunch, 1028, 105.6, 111, 232, 4, 347
supersache, 1949, 28.1, 5407, 4189, 414, 10010
Superselector, 1687, 40.8, 9012, 6166, 667, 15845
Supertanco, 1673, 77.0, 534, 629, 58, 1221
SuperTony, 1198, 39.6, 421, 550, 26, 997
SupPrime, 1013, 148.4, 285, 286, 29, 600
SUPPRISE, 1041, 26.3, 1038, 3583, 326, 4947
supradeepa, 1023, 42.3, 92, 166, 10, 268
suprnova, 1649, 69.2, 1189, 1635, 340, 3164
supyall, 1230, 59.0, 202, 228, 25, 455
Surely, 1701, 149.8, 598, 458, 63, 1119
surfertony, 1404, 35.8, 6148, 5858, 418, 12424
surfman, 1126, 93.2, 998, 1249, 91, 2338
Surrey, 2012, 54.9, 5110, 2442, 413, 7965
Survivorman, 1476, 24.5, 1199, 1150, 110, 2459
suryadarma, 1346, 21.9, 755, 1388, 65, 2208
susant, 988, 36.9, 959, 1006, 36, 2001
susanta, 1044, 81.8, 31, 73, 1, 105
Susej, 1573, 36.3, 4486, 5700, 712, 10898
susjan, 1032, 193.6, 2, 5, 0, 7
sutlej, 1470, 152.2, 58, 48, 5, 111
suzgsxr, 1101, 147.0, 107, 188, 5, 300
suzhathevar, 848, 90.6, 5, 23, 0, 28
suzybizzle, 878, 154.4, 128, 386, 7, 521
svaage, 1359, 49.0, 6111, 5590, 865, 12566
svadhisthana, 1131, 66.5, 351, 403, 21, 775
SvAlAn, 1659, 40.3, 765, 470, 99, 1334
Svenisntb, 1286, 122.2, 12, 14, 2, 28
svensp, 1665, 48.8, 1451, 1076, 157, 2684
svkodiak, 1312, 48.4, 1408, 965, 54, 2427
Svrbt, 1588, 52.6, 3068, 1484, 195, 4747
swamit, 1250, 70.8, 46, 33, 1, 80
Swampuskitty, 1121, 38.6, 312, 544, 15, 871
Swany, 1413, 77.2, 507, 537, 34, 1078
Swarnadeep, 1035, 73.3, 79, 232, 7, 318
swatson, 1221, 92.6, 608, 1083, 48, 1739
Swedenone, 1047, 38.3, 794, 1010, 30, 1834
SweeneyTodd, 1519, 63.1, 1858, 1372, 154, 3384
sweetb, 584, 142.0, 3, 38, 1, 42
sweetnighter, 1701, 29.7, 6417, 5868, 854, 13139
SweetSweetback, 1203, 34.8, 2656, 4593, 528, 7777
Sweeturoll, 1139, 39.8, 1504, 1640, 91, 3235
swethapedda, 951, 31.0, 236, 471, 14, 721
swhersey, 1513, 75.6, 264, 156, 18, 438
Swiftcheck, 1192, 42.6, 876, 1228, 23, 2127
SwiftKiller, 1873, 21.0, 7146, 10034, 1045, 18225
swingkyd, 1160, 86.0, 619, 619, 44, 1282
SWLL, 1141, 40.1, 116, 134, 1, 251
swordrascal, 1516, 25.0, 4757, 7375, 468, 12600
sXsOnAR, 1463, 69.6, 481, 654, 40, 1175
Sybilly, 1421, 54.7, 1206, 866, 58, 2130
sydbarretlives, 1509, 45.1, 142, 148, 19, 309
Symbelmyne, 1237, 244.8, 0, 8, 0, 8
synews, 1407, 54.2, 2504, 4747, 329, 7580
syoungconway, 1339, 107.0, 123, 182, 16, 321
SyrenM, 1429, 28.0, 211, 133, 18, 362
sysmack, 1132, 167.6, 234, 438, 19, 691
Systematistic, 1620, 86.1, 122, 71, 9, 202
szabadgyalog, 1234, 26.8, 1360, 1929, 113, 3402
szachmatt, 1143, 46.6, 2574, 3016, 233, 5823
szafirr, 1505, 34.0, 579, 565, 62, 1206
szotsgeri, 1098, 121.1, 170, 230, 16, 416
Sztegi, 1145, 45.7, 303, 330, 30, 663
Taadow, 1713, 105.5, 476, 600, 43, 1119
tabbit, 1348, 30.0, 1400, 979, 148, 2527
taberneiro, 1434, 73.2, 5248, 3503, 382, 9133
tabore, 1693, 46.9, 401, 230, 44, 675
TaccyChan, 1350, 28.9, 8897, 10432, 634, 19963
tacitjiangsu, 1690, 43.4, 709, 1093, 164, 1966
Tacticalinsertion, 1232, 53.9, 334, 316, 15, 665
TACTICALLYBLIND, 1270, 44.4, 1627, 1757, 106, 3490
tacticalone, 1267, 106.6, 6697, 4918, 423, 12038
TacticianPro, 1311, 24.2, 5047, 4203, 513, 9763
TacticsRUs, 1778, 64.7, 1362, 734, 61, 2157
tactictoe, 1120, 55.1, 442, 938, 27, 1407
tactifly, 1303, 41.0, 851, 840, 170, 1861
tadspoles, 1399, 49.4, 1551, 2439, 165, 4155
taguMite, 1520, 47.2, 534, 844, 43, 1421
tahsine, 1452, 45.0, 2971, 3816, 394, 7181
tahuilan, 1307, 34.0, 618, 920, 53, 1591
taiberg, 1581, 38.5, 3772, 3458, 265, 7495
Taint, 1788, 83.8, 418, 260, 38, 716
Tajek, 1534, 54.9, 3940, 2673, 273, 6886
TakeMyPawn, 650, 145.6, 2, 26, 0, 28
takesalot, 1109, 160.7, 6, 7, 0, 13
TakeTwo, 1270, 123.5, 114, 107, 5, 226
takezo, 1433, 49.4, 4978, 6228, 615, 11821
Takhisis, 1630, 56.1, 635, 250, 22, 907
TakishimaKei, 1384, 144.3, 30, 34, 2, 66
Talismanrose, 1570, 154.2, 4, 33, 0, 37
Tallasker, 1608, 116.7, 493, 487, 121, 1101
talleres, 1350, 26.9, 10355, 16520, 1033, 27908
TallPrince, 1131, 147.3, 74, 133, 10, 217
tallrook, 1421, 38.6, 1929, 2304, 166, 4399
TallSteve, 1413, 30.6, 5421, 7885, 481, 13787
tallyhoe, 1241, 32.5, 2838, 2296, 150, 5284
Tallyhofox, 1498, 29.7, 2136, 1415, 149, 3700
TalToBe, 1495, 52.7, 1083, 1065, 83, 2231
TalYourFace, 1247, 86.5, 86, 84, 4, 174
talyousef, 1538, 97.8, 664, 357, 45, 1066
Tamarit, 1326, 88.9, 180, 98, 9, 287
tamera, 1444, 77.8, 1201, 1166, 89, 2456
tamerlanoz, 1713, 58.9, 1917, 2166, 197, 4280
tamilan, 1127, 35.7, 655, 892, 70, 1617
tampayankees, 966, 39.3, 87, 135, 6, 228
tamuchin, 1163, 53.3, 432, 904, 26, 1362
tanda, 800, 60.5, 11, 123, 1, 135
tanerture, 1259, 100.3, 132, 162, 12, 306
tanev, 1150, 65.2, 3224, 3340, 108, 6672
Tanfara, 1284, 128.6, 17, 25, 0, 42
tank, 1097, 76.6, 1372, 1669, 120, 3161
Tano, 1327, 53.6, 1762, 1645, 99, 3506
Tanru, 1381, 40.6, 4736, 3012, 367, 8115
Tantemagge, 1280, 22.8, 4173, 4415, 190, 8778
tantriz, 1272, 107.4, 15080, 16565, 1187, 32832
Tanuki, 1774, 26.7, 5190, 5984, 717, 11891
TanukiTensai, 1619, 106.8, 72, 41, 1, 114
tao, 1777, 31.7, 7097, 9066, 705, 16868
taote, 1141, 69.4, 1717, 2051, 100, 3868
TaoWuTzu, 1193, 122.1, 55, 106, 4, 165
tapan, 1452, 74.9, 14388, 14596, 733, 29717
Tapioca, 1050, 61.0, 926, 1709, 46, 2681
Tapori, 1400, 27.6, 2736, 4684, 441, 7861
taqa, 1925, 65.3, 1222, 1217, 150, 2589
taqrim, 1115, 41.7, 122, 214, 5, 341
Taquajunior, 1155, 31.5, 82, 100, 13, 195
tarabas, 1339, 99.3, 2197, 2117, 178, 4492
TarAnktar, 1482, 29.1, 2878, 1423, 159, 4460
tarasboulba, 1737, 80.3, 3957, 3694, 387, 8038
tarasbulbak, 1533, 35.4, 14097, 14890, 1578, 30565
targetyard, 1092, 102.9, 935, 2014, 94, 3043
tarkabab, 1506, 34.5, 4780, 4998, 338, 10116
tarkinsky, 1391, 39.7, 4070, 2615, 222, 6907
tarkopih, 1432, 32.0, 1920, 2162, 148, 4230
taroak, 1368, 49.3, 239, 185, 16, 440
tashipidi, 1195, 154.4, 10, 20, 0, 30
tassiloVON, 1209, 25.3, 858, 639, 70, 1567
tasteslikechicken, 1637, 36.1, 2311, 1769, 227, 4307
tater, 1567, 65.8, 1979, 1108, 110, 3197
taung, 1740, 41.2, 1856, 2121, 258, 4235
taviman, 1493, 31.8, 3714, 3264, 373, 7351
Tavoo, 1721, 33.2, 1701, 1481, 318, 3500
tbhanson, 1363, 53.3, 3214, 2958, 253, 6425
TBOav, 1181, 78.4, 321, 291, 38, 650
tboi, 1338, 45.8, 3521, 3024, 225, 6770
Tchaiko, 1166, 73.8, 18, 16, 2, 36
tcharge, 1374, 29.1, 4754, 3129, 448, 8331
tcheloco, 1361, 32.9, 2355, 4027, 149, 6531
tchouapip, 1360, 31.0, 2277, 3849, 292, 6418
TChrist, 940, 78.5, 36, 94, 0, 130
tcpai, 1215, 29.1, 873, 1299, 131, 2303
tcs, 1110, 39.1, 2285, 1825, 139, 4249
tctitans, 1465, 56.6, 1537, 1026, 94, 2657
tdemedts, 1688, 55.7, 3893, 2542, 288, 6723
tdhep, 1542, 49.2, 4951, 2533, 302, 7786
tealeafreader, 1117, 33.0, 630, 849, 36, 1515
Teamaster, 1306, 30.5, 20774, 7184, 981, 28939
tearbear, 1376, 26.4, 7531, 5906, 494, 13931
TearsForNations, 1469, 69.3, 279, 205, 14, 498
Technogenio, 1436, 82.2, 1164, 1313, 78, 2555
TechnoGuyRob, 1649, 45.6, 2469, 2358, 140, 4967
TedBelanoff, 2012, 77.1, 832, 777, 68, 1677
teddya, 1369, 67.9, 957, 551, 48, 1556
TeddyBaer, 1717, 23.8, 7410, 6881, 559, 14850
Teddykoala, 1496, 68.9, 390, 618, 83, 1091
tedhort, 1605, 24.3, 6163, 3372, 197, 9732
tedjowongso, 1264, 23.4, 1165, 1998, 67, 3230
Tedysuyatna, 1166, 28.0, 163, 268, 7, 438
teemac, 932, 57.4, 49, 79, 3, 131
TEFILLIN, 1431, 50.4, 1615, 916, 148, 2679
tefo, 1208, 30.0, 3333, 5357, 142, 8832
tegetgecti, 2041, 27.6, 2605, 3329, 250, 6184
Tehpwner, 991, 52.2, 249, 763, 22, 1034
tejasuresh, 1575, 54.7, 69, 70, 7, 146
Teknocore, 733, 69.4, 48, 276, 6, 330
TeKrachtig, 815, 167.1, 2, 10, 0, 12
telamon, 1904, 31.9, 5605, 2749, 615, 8969
Teleman, 1638, 53.7, 3451, 1844, 192, 5487
telemwecomin, 1797, 24.9, 790, 832, 70, 1692
Telepuzik, 1208, 31.2, 6307, 8525, 398, 15230
telestar, 1542, 30.8, 3583, 4860, 421, 8864
telmich, 812, 118.9, 34, 73, 4, 111
tembikai, 1280, 23.6, 482, 618, 33, 1133
temburni, 1561, 28.7, 1814, 1749, 107, 3670
tempelier, 1558, 30.9, 1874, 2617, 123, 4614
temping, 1580, 24.3, 326, 1620, 70, 2016
TEMPLADOGANAR, 1369, 32.4, 915, 1555, 153, 2623
TemporalGambit, 1805, 27.1, 28224, 10594, 1977, 40795
Tenakoe, 1408, 85.5, 625, 739, 51, 1415
Tengoshi, 1384, 76.6, 791, 932, 72, 1795
tenlittle, 1228, 73.6, 3033, 3989, 284, 7306
Tenma, 1284, 45.9, 5416, 5385, 405, 11206
TennBoy, 1466, 36.3, 4703, 4576, 697, 9976
tennischamp, 1373, 26.9, 266, 333, 40, 639
tennischess, 985, 90.0, 319, 319, 32, 670
Tensecterror, 1164, 39.3, 705, 1232, 103, 2040
tentandodenovo, 1450, 67.5, 433, 508, 32, 973
tentornados, 1322, 29.8, 860, 1365, 18, 2243
TEntropy, 1255, 45.7, 219, 388, 32, 639
tentsewang, 1327, 31.3, 826, 1187, 135, 2148
Teodorakis, 1457, 112.8, 710, 478, 58, 1246
Teofilo, 1450, 34.0, 4103, 3250, 376, 7729
teoretik, 1738, 26.1, 4035, 5067, 943, 10045
teovas, 1021, 130.7, 6, 25, 1, 32
TEPERCAN, 860, 45.1, 92, 199, 5, 296
terapleutre, 1334, 28.8, 2783, 3154, 349, 6286
Teravos, 1498, 115.2, 405, 396, 44, 845
terawan, 912, 203.0, 1, 7, 0, 8
terbeek, 1415, 27.6, 3630, 3447, 208, 7285
terjjo, 1405, 211.2, 9, 4, 0, 13
terma, 1663, 39.2, 20533, 13755, 1583, 35871
TerminatorII, 1562, 39.3, 918, 1053, 90, 2061
terna, 1530, 23.0, 5294, 5901, 590, 11785, 1977, 36.4, 9195, 6070, 933, 16198
Terrafirma, 1729, 63.5, 974, 410, 102, 1486
Terrapin, 1851, 33.8, 12421, 8395, 717, 21533
TerribleTim, 1216, 44.7, 3624, 4376, 349, 8349
terryfly, 1174, 48.4, 161, 309, 26, 496
terryo, 1502, 44.9, 2481, 2478, 271, 5230
terryoe, 1109, 107.8, 68, 102, 3, 173
Testator, 1804, 65.5, 9489, 8886, 956, 19331
testb, 1558, 290.5, 1, 1, 0, 2
testc, 1882, 290.5, 1, 0, 0, 1
testina, 1794, 61.7, 2068, 1799, 181, 4048
testosteron, 1551, 33.9, 7729, 5470, 887, 14086
Tetoris, 1288, 223.8, 0, 4, 0, 4
Teuton, 1435, 60.3, 763, 481, 107, 1351
texascrewed, 943, 262.1, 0, 2, 0, 2
TexasLaw, 1225, 84.3, 1275, 1600, 119, 2994
TexasOilMan, 945, 29.8, 1448, 2614, 54, 4116
TexTechy, 920, 53.2, 926, 874, 55, 1855
Teyko, 1656, 85.8, 643, 610, 30, 1283
teypecktsu, 1481, 57.2, 925, 1125, 87, 2137
tfirn, 1405, 35.7, 3986, 3572, 461, 8019
tfmaciel, 1209, 58.4, 2929, 3235, 450, 6614
tfrio, 908, 62.3, 574, 1146, 25, 1745
tgtigris, 1783, 31.6, 4716, 4593, 619, 9928
Thabibombs, 1353, 43.9, 1883, 2106, 56, 4045
Thadal, 1218, 105.9, 625, 1205, 108, 1938
Thaian, 1331, 49.1, 1373, 1309, 63, 2745
thakgi, 1018, 78.1, 10, 29, 1, 40
Thalagor, 1563, 79.7, 1294, 931, 115, 2340
Thalidomide, 1430, 30.8, 3177, 5049, 413, 8639
thanamall, 890, 156.4, 6, 39, 1, 46
ThanksForPlaying, 1491, 96.6, 401, 284, 16, 701
Thantos, 1043, 66.2, 192, 354, 21, 567
tharadili, 937, 36.2, 135, 297, 8, 440
Tharun, 1238, 52.3, 2918, 2620, 121, 5659
thatgirl, 1445, 48.9, 319, 797, 37, 1153
ThatIsThePlan, 1403, 50.8, 1807, 1634, 169, 3610
THAVA, 1262, 32.9, 1018, 1898, 146, 3062
TheAlarm, 1439, 31.8, 515, 889, 84, 1488
TheArnold, 1685, 58.2, 270, 125, 21, 416
thebalz, 1015, 132.8, 328, 926, 8, 1262
TheBartender, 1590, 74.7, 5148, 4999, 372, 10519
thebibert, 1387, 28.1, 9666, 10756, 744, 21166
thebigblackBAT, 1294, 58.2, 48, 271, 8, 327
theBIGking, 1192, 62.2, 960, 707, 54, 1721
TheBigMexican, 1459, 80.3, 828, 1250, 153, 2231
TheBishopSweden, 1356, 50.9, 1875, 781, 120, 2776
thebrickwall, 1124, 33.4, 3481, 3902, 201, 7584
THEBROLY, 834, 117.5, 5, 36, 0, 41
TheBuccaneer, 1603, 78.3, 2425, 1599, 105, 4129
thecamo, 824, 117.8, 20, 66, 3, 89
TheCave, 1582, 65.8, 75, 82, 6, 163
THECELLDWELLER, 952, 82.8, 212, 990, 7, 1209
TheCelt, 1827, 32.4, 7208, 7351, 794, 15353
TheCenter, 1182, 42.2, 1546, 1177, 92, 2815
thechange, 1949, 56.9, 2789, 1547, 302, 4638
thechesschampion, 976, 141.3, 18, 49, 0, 67
TheChessiah, 1177, 33.1, 767, 1054, 21, 1842
TheChessMachine, 1498, 83.6, 1652, 1381, 226, 3259
thechessnnoob, 1473, 47.9, 258, 323, 21, 602
TheChosenOneII, 1243, 120.6, 12036, 12249, 831, 25116
TheCirclesEdge, 1523, 67.7, 312, 845, 73, 1230
thecliqueinc, 992, 64.5, 312, 656, 20, 988
TheComputerBlue, 1239, 97.2, 55, 45, 1, 101
thecrecarc, 872, 207.5, 1, 5, 0, 6
TheDarkKing, 1126, 31.5, 838, 1886, 92, 2816
thedilettante, 1110, 46.4, 107, 358, 5, 470
TheDumbDane, 1656, 29.4, 1161, 536, 87, 1784
TheEgoKiller, 1509, 30.4, 1865, 1835, 202, 3902
TheElffud, 1242, 22.1, 5804, 4733, 428, 10965
TheElg, 1371, 54.6, 1791, 1480, 144, 3415
theep, 1578, 91.6, 12723, 15599, 2254, 30576
theerawate, 1434, 27.1, 2728, 1910, 204, 4842
Theeroyalfork, 1480, 47.3, 452, 384, 62, 898
theerror, 1126, 92.5, 3, 45, 2, 50
theferno, 1062, 101.6, 699, 821, 44, 1564
THEfirstACE, 1034, 73.0, 17, 34, 0, 51
thefourthhorseman, 1094, 37.0, 915, 1014, 76, 2005
thefrogspitit, 1297, 57.1, 4767, 8734, 664, 14165
theFword, 1148, 47.6, 91, 135, 6, 232
thegathering, 1430, 41.6, 2503, 4323, 165, 6991
TheGoodKnight, 1436, 82.5, 6061, 3442, 581, 10084
thegreatfoos, 1523, 27.9, 4676, 5727, 492, 10895
thegripper, 1143, 51.8, 166, 205, 4, 375
thehippo, 1443, 34.5, 4764, 3865, 412, 9041
TheHonkie, 1459, 25.1, 11535, 10041, 1019, 22595
TheHumanGod, 1427, 40.0, 1631, 1161, 197, 2989
theImole, 861, 132.2, 11, 28, 1, 40
theironsheik, 1403, 29.3, 666, 636, 40, 1342
thejivaro, 1227, 37.9, 102, 374, 9, 485
TheJusticeBao, 1553, 40.2, 2219, 2094, 221, 4534
thekenfliege, 1765, 291.5, 185, 187, 18, 390
thekidd, 1346, 21.4, 19070, 17406, 1687, 38163
thekilldeer, 1483, 25.9, 4056, 4302, 783, 9141
thekillerchickens, 1801, 20.4, 9333, 3743, 1009, 14085
thekillerking, 1184, 93.8, 120, 33, 13, 166
thekinghtfork, 1370, 87.1, 3330, 5801, 446, 9577
thekingpinking, 1332, 91.6, 580, 468, 55, 1103
TheKorean, 1938, 115.2, 324, 310, 51, 685
TheLagger, 1635, 90.9, 1028, 741, 103, 1872
TheLarch, 1553, 116.8, 1110, 1070, 124, 2304
thelastemptation, 1222, 118.5, 102, 169, 6, 277
thelaughingman, 1428, 41.8, 1493, 1627, 172, 3292
TheLock, 1207, 35.9, 6855, 7327, 438, 14620
TheLongOne, 1620, 186.4, 547, 398, 23, 968
TheLuckyDon, 1232, 56.6, 291, 441, 17, 749
TheMadFiddler, 1690, 86.1, 11575, 11582, 568, 23725
TheMadWhig, 1214, 35.4, 1228, 1270, 96, 2594
themagicbean, 1183, 105.3, 352, 410, 40, 802
themanpross, 861, 86.8, 126, 274, 8, 408
themfc, 1285, 85.7, 441, 351, 34, 826
Themike, 1510, 43.3, 1154, 1121, 212, 2487
themindset, 1875, 113.7, 1051, 849, 26, 1926
TheMirage, 996, 52.8, 962, 2476, 71, 3509
themisk, 1369, 26.7, 8066, 11672, 1710, 21448
themoveR, 1096, 30.2, 2388, 4355, 188, 6931
TheMulatto, 1407, 114.7, 173, 160, 21, 354
TheMuler, 1546, 28.8, 675, 395, 55, 1125
thenextstevebaker, 1170, 26.7, 827, 1284, 117, 2228
thenightcrawler, 1674, 58.0, 325, 409, 31, 765
TheNumberThirteen, 1417, 56.8, 296, 217, 24, 537
TheoMeyer, 1660, 70.6, 216, 95, 13, 324
theopener, 887, 190.4, 0, 7, 0, 7
theophil, 970, 46.4, 130, 403, 8, 541
theoriz, 1244, 21.7, 1502, 2320, 158, 3980
THEOwned, 861, 120.7, 11, 59, 0, 70
ThePawntif, 1542, 23.4, 7176, 9967, 524, 17667
theperfectchap, 1537, 91.8, 980, 784, 43, 1807
ThePlanner, 1188, 109.2, 144, 184, 5, 333
theplutotian, 1041, 123.0, 4, 8, 1, 13
ThePoisonedPawn, 1227, 68.5, 766, 672, 63, 1501
ThePredater, 775, 180.4, 0, 6, 0, 6
theprof, 1343, 231.8, 4965, 1921, 208, 7094
TheProgicalSon, 868, 63.2, 13, 61, 0, 74
ThePure, 1315, 33.8, 2186, 1530, 142, 3858
TheRealTexasFatz, 1569, 338.9, 3, 1, 0, 4
therecanbonlyone, 2005, 103.7, 648, 535, 30, 1213
TheRedBlckOne, 1016, 83.7, 580, 2074, 66, 2720
TheReignOfKindo, 1253, 35.6, 644, 693, 59, 1396
TheResident, 1651, 30.3, 11106, 12558, 1106, 24770
TheRisingPawn, 1874, 51.9, 37, 33, 5, 75
Thermodynamics, 1333, 182.6, 10, 16, 1, 27
therogitz, 1408, 64.0, 2375, 775, 52, 3202
TheRooksac, 1290, 68.4, 278, 295, 27, 600
TheSconeRanger, 1031, 34.7, 1104, 1490, 45, 2639
TheseusI, 1845, 40.3, 1001, 829, 94, 1924
theshammgod, 1110, 87.4, 11, 41, 2, 54
thesmartone, 1092, 84.6, 93, 176, 22, 291
Thesnakemanpr, 1327, 27.8, 301, 338, 25, 664
thesonicvision, 1534, 31.5, 2831, 3832, 345, 7008
thesonofsaul, 1338, 59.5, 578, 501, 47, 1126
TheSoulOfChess, 1278, 44.2, 153, 298, 14, 465
thetaxman, 1022, 37.5, 1554, 2656, 121, 4331
TheTwelfthKnight, 1618, 40.4, 430, 541, 60, 1031
theUkrainian, 1374, 92.6, 148, 214, 17, 379
TheUltraSharpe, 1585, 89.9, 1821, 2201, 169, 4191
Thevdia, 1608, 27.1, 1532, 1169, 101, 2802
thevines, 1910, 26.1, 4612, 4203, 292, 9107
TheWake, 1158, 46.7, 103, 139, 8, 250
THEWALL, 1648, 42.0, 3260, 2646, 200, 6106
TheWarden, 1613, 37.7, 9298, 7125, 1030, 17453
Thewordshere, 1363, 106.1, 18, 25, 2, 45
thewu, 805, 118.4, 45, 139, 2, 186
TheYakster, 1511, 61.7, 420, 215, 27, 662
TheYoungVeins, 1400, 35.0, 378, 384, 35, 797
thgibbs, 1455, 43.8, 810, 601, 74, 1485
thgom, 1209, 59.3, 593, 956, 61, 1610
thhZ, 1516, 30.1, 18633, 17427, 2392, 38452
thierryw, 1271, 25.7, 564, 866, 59, 1489
ThijsVermeir, 1187, 115.4, 528, 530, 28, 1086
THINBLUEFLAME, 1006, 275.1, 1, 2, 0, 3
thingummywut, 1531, 88.5, 764, 779, 119, 1662
ThinkBlack, 1656, 48.7, 122, 118, 5, 245
ThinkerLover, 1639, 57.8, 743, 795, 71, 1609
ThinkFast, 1630, 56.9, 5488, 2800, 315, 8603
ThinklingsBird, 907, 115.6, 76, 143, 6, 225
ThinOldMan, 1049, 268.8, 45, 105, 5, 155
thiopental, 1199, 46.2, 3213, 3965, 407, 7585
third, 1350, 26.6, 4748, 2520, 623, 7891
ThirteenStars, 1242, 313.4, 0, 1, 0, 1
thiruece, 1041, 129.8, 80, 80, 2, 162
Thirumaran, 1206, 51.1, 82, 96, 3, 181
thohai, 1606, 46.1, 1339, 1207, 132, 2678
thohog, 878, 39.1, 1151, 1444, 65, 2660
thomasalexander, 1411, 69.5, 5880, 3936, 323, 10139
ThomasPace, 1209, 26.4, 309, 568, 17, 894
ThomasR, 1276, 27.4, 3240, 5039, 228, 8507
thomass, 1679, 30.5, 20816, 19834, 3584, 44234
thomasthebold, 1235, 46.3, 100, 124, 15, 239
Thomes, 1508, 111.8, 258, 248, 13, 519
thomson, 1533, 33.5, 3153, 2827, 387, 6367
thomux, 1447, 36.0, 7204, 4882, 582, 12668
Thoras, 1597, 29.9, 2396, 2487, 145, 5028
ThorCDT, 1834, 29.8, 2375, 2536, 119, 5030
Thorgon, 1203, 48.1, 3541, 2364, 305, 6210
thorntdc, 1438, 40.2, 849, 401, 46, 1296
THORTHEVIKING, 862, 31.9, 187, 677, 18, 882
Thorvaldwastaken, 1567, 29.3, 4192, 3249, 250, 7691
thosd, 1542, 27.5, 2899, 3603, 452, 6954
Thottakkara, 1161, 49.7, 422, 767, 25, 1214
thotthescribe, 817, 194.4, 2, 12, 0, 14
THPDSWAT, 971, 63.9, 101, 141, 8, 250
Thraco, 1012, 36.3, 390, 483, 16, 889
thrajin, 1274, 36.1, 665, 566, 46, 1277
threedog, 1116, 114.0, 79, 215, 10, 304
ThreeMovesAhead, 917, 56.6, 41, 91, 4, 136
Throck, 1064, 70.8, 798, 1035, 35, 1868
thrombomodulin, 1388, 58.1, 4710, 3671, 285, 8666
throwback, 1610, 32.1, 15575, 10116, 1950, 27641
Thryge, 1191, 167.8, 86, 201, 8, 295
thunderballs, 1121, 325.1, 6, 10, 0, 16
thunderbomb, 1319, 25.5, 1638, 1486, 173, 3297
ThunderHead, 1246, 34.7, 2140, 1870, 164, 4174
thurgy, 1217, 91.3, 296, 220, 19, 535
tiagorom, 1020, 33.4, 838, 1786, 47, 2671
Tiawa, 1076, 32.0, 365, 496, 27, 888
tibul, 1037, 131.5, 4, 13, 0, 17
tiburcio, 1407, 25.2, 11465, 11321, 951, 23737
tictoctictoc, 1258, 66.9, 149, 174, 19, 342
tiditi, 865, 111.1, 36, 96, 1, 133
tidybowl, 1569, 94.3, 1973, 3148, 257, 5378
TiGaL, 1518, 36.0, 2472, 3032, 297, 5801
tigersnake, 1344, 47.5, 1938, 3788, 313, 6039
TigerWang, 1249, 112.7, 349, 827, 56, 1232
TIGERWOODS, 1647, 33.7, 1606, 589, 87, 2282
TiggerPooh, 1695, 29.2, 4190, 977, 100, 5267
tightfist, 1380, 240.4, 1, 9, 0, 10
TigranJ, 1398, 36.9, 896, 251, 43, 1190
Tigrann, 1602, 33.1, 11164, 8955, 1127, 21246, 1965, 31.8, 1352, 977, 308, 2637
TigreBlanco, 1582, 138.8, 66, 40, 8, 114
tigreton, 1325, 25.3, 3124, 6282, 478, 9884
tigrok, 1466, 67.2, 111, 112, 13, 236
tigrotto, 1539, 39.3, 5557, 3366, 493, 9416
tihibuda, 1751, 24.1, 2006, 2473, 204, 4683
tijean, 1203, 49.7, 432, 477, 46, 955
TijsH, 929, 93.6, 1043, 1653, 107, 2803
TIKING, 851, 26.3, 590, 1342, 93, 2025
tilli, 1228, 28.3, 3496, 7772, 179, 11447
timburch, 1495, 58.1, 4152, 4438, 531, 9121
timdnguyen, 1301, 35.7, 775, 542, 39, 1356
timeconstrained, 1544, 41.8, 9746, 8909, 589, 19244
timegents, 1358, 35.3, 439, 390, 44, 873
Timelesss, 1600, 53.5, 242, 154, 23, 419
timeofnoreply, 1842, 32.6, 1157, 375, 63, 1595
timetowin, 1185, 17.9, 1212, 3122, 154, 4488
timisrejoicing, 1126, 67.0, 21, 51, 3, 75
TimJonez, 1394, 215.9, 4, 4, 1, 9
TimmBrooks, 1242, 28.9, 582, 666, 45, 1293
TimMcCants, 1474, 28.2, 255, 329, 29, 613
Timmesen, 1374, 29.7, 1607, 1869, 188, 3664
Timogen, 1542, 100.3, 3246, 3488, 340, 7074
Timoka, 1824, 20.2, 5465, 8056, 750, 14271
Timothy, 1333, 24.0, 23790, 29419, 3305, 56514
Timoton, 1209, 67.3, 146, 106, 7, 259
Timurjan, 1472, 30.6, 1417, 2406, 128, 3951
tingi, 713, 149.6, 3, 41, 0, 44
tinkebel, 1392, 32.8, 1802, 1703, 84, 3589
tinoareno, 1499, 29.2, 893, 890, 72, 1855
TiNours, 1378, 57.9, 699, 670, 97, 1466
Tintomara, 1240, 35.5, 5062, 4892, 336, 10290
tiofunga, 1143, 80.0, 62, 75, 2, 139
TioHoracio, 2078, 27.0, 29532, 23836, 3096, 56464
tipareth, 917, 123.5, 18, 71, 3, 92
tipitip, 1619, 47.2, 1740, 1255, 159, 3154
tipko, 1223, 26.4, 557, 806, 99, 1462
tiptho, 1294, 35.0, 248, 152, 15, 415
tiptongrange, 1293, 40.1, 189, 160, 9, 358
TipZilla, 1181, 59.7, 141, 224, 3, 368
tiranas, 1132, 36.2, 554, 1957, 63, 2574
tirsa, 1058, 31.9, 435, 1549, 35, 2019
tirupatibalaji, 752, 136.2, 31, 160, 2, 193
tishou, 1144, 114.9, 31, 34, 4, 69
titin, 1139, 104.5, 14, 31, 0, 45
Titoba, 1435, 48.9, 1190, 888, 112, 2190
titohoffa, 859, 111.2, 3, 16, 1, 20
TitoNey, 1391, 76.8, 1455, 1747, 171, 3373
titoyack, 1406, 38.9, 2112, 2005, 132, 4249
Tittentei, 1551, 32.4, 6758, 8584, 625, 15967
TIZOC, 1362, 21.4, 3878, 4242, 490, 8610
Tjall, 1638, 22.2, 5608, 3150, 275, 9033
TJaysTA, 1459, 62.1, 173, 146, 12, 331
tjbdocs, 1264, 67.9, 859, 1328, 127, 2314
Tjerk, 1368, 31.0, 5927, 6354, 742, 13023
TJMax, 1045, 78.7, 44, 76, 3, 123
Tjofs, 1248, 40.4, 1261, 971, 79, 2311
tjops, 1288, 36.5, 134, 112, 1, 247
tjordanchat, 1222, 31.2, 579, 787, 47, 1413
TJPOT, 1058, 37.5, 2037, 2229, 80, 4346
tjsudan, 1147, 58.8, 165, 282, 4, 451
tkheovmians, 1332, 29.4, 964, 904, 51, 1919
tkm, 1709, 35.6, 4543, 6532, 674, 11749
tlacatl, 1395, 41.9, 4113, 5680, 362, 10155
tlanders, 1241, 112.1, 9, 4, 0, 13
TLAvery, 1779, 37.4, 1314, 1347, 140, 2801
tlayne, 1193, 36.8, 5372, 5952, 594, 11918
tleylan, 1123, 48.3, 1926, 4088, 563, 6577
TlonUqbar, 1316, 32.0, 4235, 7084, 681, 12000
Tlslevens, 1240, 24.8, 1856, 2255, 110, 4221
Tmadness, 1553, 94.5, 198, 92, 13, 303
tmcnic, 1076, 39.4, 105, 120, 4, 229
tngerb, 1718, 68.1, 37, 37, 3, 77
tnorback, 1041, 140.5, 385, 332, 30, 747
tntlimited, 1166, 207.6, 28, 26, 2, 56
toasti, 1470, 33.5, 449, 264, 36, 749
ToastmasterFlex, 621, 175.6, 1, 5, 3, 9
Tobak, 1415, 62.9, 1198, 1372, 112, 2682
tobolt, 1413, 31.3, 2999, 3719, 338, 7056
tobydammett, 1480, 27.5, 5538, 8458, 448, 14444
tobytats, 962, 35.6, 1523, 3063, 95, 4681
tocak, 1702, 28.3, 972, 2179, 356, 3507
Toddniven, 1497, 41.7, 4826, 3847, 367, 9040
toddytyke, 1455, 122.3, 2030, 1205, 181, 3416
todieisgain, 1587, 24.7, 1990, 2427, 270, 4687
toditx, 1429, 63.8, 114, 43, 5, 162
Tody, 1996, 239.9, 629, 403, 46, 1078
toe, 1367, 28.7, 12329, 11960, 1275, 25564
toffy, 1591, 62.2, 2195, 2391, 142, 4728
Tofpa, 1764, 32.8, 702, 444, 124, 1270
tokare, 1339, 39.3, 3312, 3086, 304, 6702
tokotico, 1011, 91.3, 9, 11, 2, 22
Tokyo, 2211, 106.3, 5353, 2156, 768, 8277
TOLAG, 1252, 33.8, 1494, 2792, 142, 4428
tolbster, 1017, 87.1, 11, 23, 0, 34
tolchok, 1195, 60.8, 319, 303, 16, 638
Tolenskij, 1794, 29.9, 418, 377, 45, 840
tolisk, 1741, 33.6, 7359, 9701, 1180, 18240
tolou, 1242, 122.5, 598, 640, 28, 1266
tomasrc, 1414, 26.8, 1158, 836, 46, 2040
tombombadilo, 1399, 25.6, 1328, 1211, 78, 2617
Tomce, 985, 223.6, 1, 6, 0, 7
tomerzarfaty, 1058, 32.3, 1733, 3309, 120, 5162
tomg, 1018, 94.6, 132, 147, 9, 288
Tomjon, 1237, 25.9, 871, 1036, 53, 1960
tomky, 1495, 16.8, 579, 651, 36, 1266
tommiskt, 1353, 43.0, 3595, 5052, 314, 8961
tomorrowdies, 709, 58.3, 20, 106, 2, 128
tomosaki, 1460, 25.3, 12726, 15173, 1342, 29241
tompet, 1304, 33.3, 3027, 2577, 295, 5899
tomphils, 1143, 40.1, 3096, 2851, 214, 6161
tomson, 1277, 41.9, 4174, 3919, 341, 8434
TomStev, 1452, 83.2, 662, 371, 53, 1086
tomwes, 1089, 50.5, 979, 1627, 89, 2695
toneRock, 926, 43.9, 32, 89, 0, 121
Tonggol, 1653, 57.6, 618, 254, 17, 889
tonit, 1673, 106.2, 2561, 2770, 444, 5775
tontie, 1046, 69.5, 190, 144, 13, 347
TontoMachine, 1331, 36.7, 3153, 2419, 395, 5967
tonya, 1416, 31.8, 3694, 3357, 297, 7348
TonyDeakin, 1098, 28.0, 5553, 15709, 270, 21532
tonyh, 1339, 70.0, 1774, 998, 113, 2885
TonyKII, 1734, 39.1, 1575, 1379, 226, 3180
TonyLeMesmer, 1397, 71.9, 531, 424, 34, 989
tonystar, 684, 169.9, 2, 19, 0, 21
tonyz, 1304, 33.4, 11166, 11880, 639, 23685
tonyzz, 1298, 39.0, 1216, 986, 71, 2273
tooeasymate, 905, 84.5, 384, 1404, 35, 1823
toomtoom, 1568, 42.5, 954, 794, 112, 1860
ToonV, 1226, 44.3, 1949, 2633, 287, 4869
ToothlessAttack, 1463, 35.2, 2002, 1118, 145, 3265
TooTsCXXXVI, 1243, 38.5, 1032, 773, 61, 1866
topaz, 1507, 32.4, 10281, 11933, 835, 23049
Topbrains, 1445, 27.4, 8025, 2704, 516, 11245
topcopmich, 1472, 38.5, 1613, 1606, 187, 3406
topfuel, 1238, 109.5, 2, 13, 1, 16
TopHat, 1079, 189.1, 171, 238, 15, 424
topherpalmtree, 858, 77.6, 290, 687, 8, 985
topjack, 1315, 26.9, 15615, 16922, 936, 33473
toplolino, 1261, 36.5, 388, 477, 19, 884
topogigio, 1721, 30.0, 9212, 3894, 630, 13736
TopoJeejo, 1496, 83.0, 2479, 2835, 187, 5501
toppcatt, 1446, 37.7, 4254, 3831, 344, 8429
Toppcheff, 1031, 115.9, 52, 135, 0, 187
topspinserve, 1510, 92.0, 398, 475, 40, 913
Toptygin, 1638, 77.4, 247, 302, 25, 574
torad, 1445, 27.0, 678, 714, 62, 1454
torchess, 1518, 60.4, 6063, 4367, 476, 10906
tordi, 1049, 89.4, 39, 216, 3, 258
Torenvalk, 1128, 41.6, 2878, 2610, 95, 5583
torlattimore, 1831, 92.8, 3439, 1028, 175, 4642
torlo, 678, 83.7, 16, 61, 2, 79
tormentil, 1538, 20.6, 9039, 15260, 1492, 25791
tornadoK, 1332, 33.8, 908, 1247, 92, 2247
Tornek, 2044, 100.0, 6844, 1987, 286, 9117
tornet, 1337, 63.7, 1575, 912, 145, 2632
Tornitore, 780, 250.7, 1, 9, 0, 10
tornmatten, 1631, 54.2, 1196, 583, 132, 1911
Torny, 1478, 32.5, 7055, 5875, 399, 13329
torombolo, 881, 68.2, 25, 105, 3, 133
TORONEGRO, 1202, 150.5, 170, 171, 16, 357
Torrependente, 1489, 33.1, 751, 1173, 91, 2015
TorresBSMX, 1119, 45.8, 264, 573, 22, 859
Torrk, 1530, 82.6, 2552, 3594, 551, 6697
torterie, 779, 59.5, 6, 47, 0, 53
Tortious, 1506, 34.8, 960, 1248, 34, 2242
tospringer, 1638, 20.2, 13296, 13464, 1454, 28214
TOT, 1627, 34.2, 3690, 1091, 146, 4927
totalamateur, 1089, 111.0, 329, 370, 28, 727
totdreher, 1233, 48.1, 1321, 1450, 104, 2875
totodh, 1228, 41.8, 665, 736, 74, 1475
TotoLeTak, 1475, 28.1, 1305, 956, 61, 2322
totolezero, 1058, 84.2, 253, 529, 21, 803
TOTREP, 1563, 24.5, 35122, 28294, 3047, 66463
toughsid, 1734, 24.3, 2072, 2354, 257, 4683
toupToup, 944, 125.8, 1, 9, 0, 10
TowMater, 1222, 96.0, 54, 73, 7, 134
ToxicWaste, 1406, 36.2, 1708, 494, 71, 2273
ToyMan, 1298, 40.5, 2946, 4341, 289, 7576
Toyta, 1758, 25.1, 3788, 2370, 289, 6447
toytown, 1274, 39.2, 324, 285, 19, 628
tpefz, 1579, 251.5, 1, 1, 0, 2
TPGYRENE, 1539, 31.3, 10312, 6427, 736, 17475
tplachkich, 1442, 29.9, 9128, 1409, 291, 10828
Tpyc, 1204, 160.1, 1, 4, 0, 5
tracychess, 1644, 26.4, 7095, 7184, 696, 14975
TRADICIONAL, 651, 171.4, 4, 57, 1, 62
Traemasters, 808, 94.2, 100, 658, 5, 763
tragle, 969, 98.8, 175, 349, 8, 532
trajamohan, 1224, 36.2, 2052, 1571, 107, 3730
tramxler, 1407, 57.3, 464, 754, 63, 1281
transitman, 1512, 35.9, 6654, 6350, 663, 13667
Transylvanian, 1802, 51.0, 1480, 1561, 140, 3181
TrappedPawn, 1534, 35.7, 1326, 851, 119, 2296
Trasimene, 1461, 28.6, 22900, 15806, 851, 39557
trautman, 1413, 47.0, 590, 585, 75, 1250
traversc, 1356, 73.3, 3496, 3117, 284, 6897
TravisW, 1080, 99.5, 134, 161, 13, 308
travstroe, 1342, 33.3, 1288, 1013, 91, 2392
TraxusIV, 888, 84.1, 63, 159, 9, 231
Trd, 1289, 62.6, 4298, 5058, 211, 9567
trebbor, 1865, 97.2, 9673, 9578, 990, 20241
Treblehorse, 1122, 82.9, 115, 127, 1, 243
trebmi, 1141, 50.2, 1014, 1006, 86, 2106
treemanjames, 1255, 33.5, 1138, 1022, 123, 2283
treewoods, 834, 121.7, 12, 182, 0, 194
treezen, 728, 133.8, 144, 728, 7, 879
Trellos, 1454, 44.7, 2826, 4740, 207, 7773
Tremeoc, 864, 180.3, 1, 69, 0, 70
TrentonTheSecond, 973, 28.4, 1984, 2725, 90, 4799
treplo, 1379, 98.0, 498, 589, 49, 1136
TresMinutosMeVale, 1757, 20.5, 6522, 2152, 336, 9010
Trevfour, 1355, 40.4, 4405, 3517, 482, 8404
Trevi, 1165, 52.1, 110, 129, 6, 245
Tricentiel, 1225, 161.4, 45, 277, 10, 332
trickortreatx, 1197, 36.1, 2097, 3494, 120, 5711
TrickyAl, 1292, 118.6, 275, 280, 12, 567
Trickyking, 1037, 156.3, 1, 7, 0, 8
tricoster, 1272, 62.9, 262, 352, 12, 626
TriLighT, 1312, 24.8, 516, 709, 32, 1257
Trillman, 1569, 31.0, 1027, 921, 71, 2019
trimegistos, 1245, 72.2, 729, 659, 27, 1415
TriMind, 1444, 30.2, 16089, 12923, 1236, 30248
trimmer, 1126, 125.5, 218, 308, 19, 545
trino, 1751, 34.1, 2887, 2229, 448, 5564
TripleCero, 1220, 46.1, 1478, 1072, 98, 2648
TripleS, 1030, 98.0, 453, 587, 50, 1090
Tripuraantakaaya, 1334, 43.1, 1399, 1188, 129, 2716
trisakti, 1464, 50.1, 873, 2237, 92, 3202
trishaclary, 1132, 54.9, 669, 1124, 60, 1853
trismegisto, 1536, 27.0, 14873, 15362, 1725, 31960
TRITRICA, 1392, 36.0, 2985, 8288, 133, 11406
TriumphAdler, 1570, 42.0, 219, 234, 31, 484
trlk, 1798, 31.6, 186, 122, 13, 321
trmii, 1050, 39.7, 1483, 1961, 92, 3536
Troggie, 1342, 116.7, 44, 88, 2, 134
Trojanx, 1148, 30.4, 447, 642, 87, 1176
Trojn, 1005, 55.5, 882, 914, 87, 1883
trolinus, 1467, 40.2, 7716, 7158, 579, 15453
TrolleSwe, 1381, 32.8, 708, 835, 100, 1643
Trombadinhas, 1088, 33.1, 266, 660, 23, 949
trommy, 1403, 52.5, 1358, 2569, 152, 4079
TrondSvane, 1716, 32.1, 3729, 3061, 312, 7102
Tronski, 1070, 57.2, 5345, 13575, 830, 19750
Trooky, 925, 89.3, 20, 80, 0, 100
trosten, 1111, 41.5, 2909, 5453, 201, 8563
TrouDeBozouls, 1516, 29.2, 378, 486, 42, 906
troycm, 1040, 153.4, 15, 26, 0, 41
TroyKa, 1186, 32.1, 2161, 725, 111, 2997
TroyLambert, 1161, 124.3, 816, 1260, 65, 2141
Troylen, 2174, 58.4, 6849, 1909, 385, 9143
trss, 1369, 62.4, 46, 77, 6, 129
Truckdriver, 1560, 21.6, 15785, 9067, 1111, 25963
trupain, 993, 69.1, 17, 37, 0, 54
TRUPLAYA, 1490, 34.1, 1831, 1283, 104, 3218
TrustyPawn, 1489, 30.7, 7062, 5425, 946, 13433
truuf, 1410, 36.3, 1405, 1088, 88, 2581
TryAnything, 1326, 90.7, 396, 224, 21, 641
tryhard, 1108, 200.3, 90, 153, 10, 253
Trypanossoma, 1308, 90.3, 108, 104, 19, 231
trytest, 1199, 37.5, 5259, 9312, 411, 14982
tsagaropoulos, 1729, 108.2, 339, 128, 17, 484
tschup, 873, 27.2, 2637, 6655, 321, 9613
Tseatsy, 1650, 28.7, 1416, 1270, 104, 2790
tsfm, 1100, 195.3, 3, 10, 0, 13
tsgfan, 964, 117.4, 50, 86, 3, 139
tsibme, 1226, 72.0, 86, 117, 7, 210
tsoue, 761, 40.7, 416, 1169, 25, 1610
TStrobaugh, 1245, 29.1, 3410, 4074, 302, 7786
Tsubo, 1908, 88.4, 140, 72, 10, 222
tsuname, 1610, 32.6, 2902, 4301, 194, 7397
Tsunamisan, 1349, 81.9, 162, 135, 13, 310
Tsvetkov, 1540, 30.3, 2186, 2910, 396, 5492
tsztabho, 1060, 87.4, 14, 41, 0, 55
ttasso, 1148, 28.4, 435, 445, 35, 915
Ttbbtt, 1294, 66.1, 2781, 1744, 94, 4619
ttddttdd, 1571, 65.2, 326, 544, 48, 918
ttfortm, 1262, 35.3, 552, 482, 58, 1092
Ttrree, 1396, 97.1, 150, 249, 9, 408
ttsuchi, 1093, 68.9, 414, 461, 24, 899
tuan, 1570, 27.9, 17310, 29107, 1985, 48402
tubelight, 931, 179.8, 1, 5, 0, 6
Tuber, 1204, 35.6, 9331, 3969, 361, 13661
tuffmom, 1047, 32.7, 3219, 3408, 188, 6815
tuffnut, 1022, 26.8, 14487, 22194, 1987, 38668
Tufkaman, 1448, 64.4, 491, 429, 60, 980
Tuga, 1377, 25.4, 5597, 2983, 421, 9001
tuguin, 1524, 38.6, 2192, 1804, 154, 4150
tuimapieru, 1250, 39.7, 990, 1466, 129, 2585
Tulloch, 1703, 110.7, 331, 245, 26, 602
tumbletoe, 1352, 89.7, 446, 349, 27, 822
Tumuu, 1364, 65.4, 1442, 2756, 114, 4312
tunali, 1613, 27.8, 2504, 2807, 232, 5543
tungtong, 920, 147.0, 2, 10, 1, 13
tuninho, 879, 86.3, 5, 17, 1, 23
Tuobdog, 1712, 53.9, 873, 936, 60, 1869
tupapa, 1470, 29.4, 7414, 4572, 509, 12495
turgoyak, 1337, 35.9, 1875, 2176, 230, 4281
turkeyboy, 1557, 27.4, 10866, 7710, 651, 19227
TurkishTickler, 1772, 94.9, 449, 390, 37, 876
turquele, 1309, 27.5, 2178, 2429, 130, 4737
turr, 1794, 32.8, 2280, 2282, 207, 4769
turtel, 1658, 19.7, 14983, 8116, 949, 24048
turtlecat, 1119, 54.3, 716, 1142, 76, 1934
turtlemaniac, 1554, 25.7, 3769, 2157, 124, 6050
Tutuy, 1252, 67.0, 4371, 5394, 315, 10080
TUURI, 1282, 42.5, 6124, 4738, 498, 11360
tuvo, 1177, 29.9, 885, 1734, 71, 2690
TuxThePenguin, 1481, 59.7, 1786, 1516, 167, 3469
Tuzzo, 1720, 45.7, 2226, 2476, 245, 4947
tvaellen, 1325, 74.7, 1231, 1013, 90, 2334
tvbrito, 1131, 107.2, 613, 640, 41, 1294
tvg, 883, 148.9, 141, 232, 13, 386
tvrdjava, 1357, 25.6, 611, 415, 55, 1081
TwentiethMaine, 1352, 27.0, 1926, 3107, 262, 5295
TwentsKnight, 1288, 26.8, 8015, 11388, 738, 20141
TWG, 1534, 27.4, 10182, 8616, 890, 19688
twigalicious, 1035, 53.1, 195, 238, 7, 440
Twirl, 1499, 275.0, 1, 1, 0, 2
TwitchBlade, 849, 39.6, 44, 123, 3, 170
twitz, 1761, 23.3, 5696, 4090, 268, 10054
twobi, 1864, 71.2, 3200, 3305, 313, 6818
Twong, 2178, 54.4, 498, 330, 68, 896
twoods, 1002, 38.6, 752, 861, 49, 1662
twotorches, 874, 98.8, 38, 90, 1, 129
txartist, 1234, 35.3, 1468, 808, 119, 2395
txbeda, 1771, 23.7, 5534, 6292, 492, 12318
TXtolstoy, 1457, 45.9, 55, 61, 7, 123
tychonew, 1672, 89.9, 1294, 1164, 119, 2577
tyk, 716, 64.1, 32, 183, 3, 218
tylan, 943, 85.1, 8, 17, 0, 25
tylerwsu, 972, 172.4, 35, 98, 3, 136
tymart, 1353, 98.7, 44, 24, 0, 68
tynguyen, 1512, 79.7, 3967, 7117, 471, 11555
typerys, 1212, 46.0, 1515, 2013, 104, 3632
typhoon, 1594, 42.3, 884, 660, 44, 1588
Tyr, 1323, 73.2, 7173, 5246, 792, 13211
Tyrant, 1246, 73.0, 6589, 5651, 509, 12749
Tyrantt, 1310, 52.7, 792, 782, 58, 1632
tyrionsapprentice, 1631, 123.3, 772, 780, 61, 1613
TyroLoco, 1231, 28.1, 1260, 1614, 107, 2981
tyumen, 1612, 35.7, 3307, 6956, 372, 10635
tzarchess, 1588, 20.5, 2016, 4376, 308, 6700
uba, 1748, 31.2, 11987, 13218, 1023, 26228
uber, 1109, 255.0, 1, 3, 0, 4
UberKitty, 1539, 66.1, 4295, 4172, 552, 9019
UberMate, 1098, 39.1, 1554, 2263, 95, 3912
ubicomp, 1341, 28.1, 5962, 6300, 607, 12869
ububub, 984, 119.3, 13, 40, 3, 56
Ubuntero, 1015, 41.5, 47, 44, 2, 93
ucastrobr, 982, 111.7, 28, 74, 5, 107
Uckington, 859, 90.4, 216, 500, 1, 717
uclabrruin, 1203, 117.7, 41, 28, 5, 74
udanand, 1132, 40.3, 1084, 2002, 103, 3189
Uddo, 1327, 27.5, 1855, 2037, 123, 4015
udofink, 1039, 30.4, 1724, 1440, 119, 3283
Udon, 1373, 36.7, 2267, 2970, 325, 5562
udovych, 1394, 27.4, 5005, 8097, 657, 13759
UENBGC, 1381, 25.3, 4152, 4724, 549, 9425
ugadawgs, 1002, 112.1, 353, 1440, 47, 1840
UGAFootball, 1512, 31.2, 9283, 8880, 1177, 19340
UglyducK, 1412, 51.6, 1027, 962, 95, 2084
ugodiggi, 1151, 49.7, 1769, 2260, 147, 4176
Uguns, 1407, 32.3, 2135, 4533, 560, 7228
UHaveNoChance, 1583, 80.2, 261, 198, 21, 480
uhcaldeirao, 1234, 44.7, 559, 763, 59, 1381
UhOh, 1765, 22.8, 34711, 23806, 2842, 61359
uill, 1414, 106.7, 100, 114, 10, 224
UiR, 1728, 94.8, 4057, 4236, 521, 8814
Uirapuru, 1728, 20.1, 50087, 30960, 3190, 84237
ujjwal, 1289, 134.6, 109, 161, 11, 281
ujujang, 838, 123.3, 1, 13, 0, 14
ukcbajr, 1293, 65.0, 285, 245, 15, 545
ukecat, 1391, 195.4, 0, 12, 0, 12
uko, 1392, 36.9, 3196, 3545, 351, 7092
Ukokosha, 1685, 32.1, 3851, 3832, 350, 8033
ukschach, 1430, 51.8, 1251, 868, 87, 2206
Uksu, 1665, 38.7, 3188, 3415, 370, 6973
Uleeeeeero, 1593, 51.5, 2579, 2367, 253, 5199
Ulisse, 1983, 54.2, 1272, 1373, 140, 2785
Uljanow, 1585, 32.5, 22294, 11787, 1424, 35505
Ulltimo, 800, 140.0, 16, 59, 1, 76
Ulmya, 1285, 36.3, 628, 604, 19, 1251
ulpianus, 1338, 114.4, 310, 279, 41, 630
ulsasidhar, 1599, 43.5, 1205, 1688, 96, 2989
Ultraben, 1237, 32.1, 298, 320, 13, 631
UltraMN, 1413, 48.9, 2774, 2892, 156, 5822
ultranet, 926, 136.4, 23, 114, 2, 139
umassboston, 1626, 102.6, 1823, 1439, 164, 3426
umbeebmu, 994, 35.9, 1414, 2303, 197, 3914
Umboione, 1773, 25.9, 4293, 4040, 259, 8592
umeshblr, 1783, 60.9, 165, 87, 2, 254
umnoff, 1453, 65.8, 157, 247, 21, 425
Umustbdreaming, 1463, 297.6, 1, 1, 0, 2
unanimo, 1323, 184.5, 5618, 6350, 380, 12348
unceraint, 1428, 33.5, 209, 247, 10, 466
UncleEric, 1414, 48.8, 2642, 2021, 187, 4850
UncleHerschel, 1536, 39.5, 668, 515, 44, 1227
UncleM, 1601, 93.7, 8996, 7355, 905, 17256
UncleSoo, 1404, 30.2, 795, 1075, 92, 1962
UncleVova, 1068, 157.8, 4, 5, 0, 9
unclewilly, 1764, 33.0, 2199, 1134, 180, 3513
uncleZiba, 1352, 46.9, 2614, 3088, 221, 5923
Undahdogg, 860, 165.1, 0, 9, 0, 9
UndefeatedMonkey, 1853, 50.5, 1272, 978, 123, 2373
underestimted, 946, 42.0, 268, 505, 8, 781
UnDniableTalent, 1060, 225.5, 1, 3, 0, 4
unggoy, 1367, 170.7, 72, 60, 7, 139
unhappy, 1966, 171.7, 694, 306, 88, 1088
unica, 1400, 56.6, 57, 38, 2, 97
Unicorn, 1933, 229.2, 1534, 1156, 108, 2798
UNiiiT, 1403, 39.7, 508, 584, 28, 1120
Uninaut, 1170, 78.2, 1956, 1599, 196, 3751
UNINVIITED, 1235, 78.4, 839, 1170, 121, 2130
uniqli, 1401, 37.2, 1493, 923, 127, 2543
uniqueid, 961, 77.1, 680, 1115, 43, 1838
universalself, 1316, 115.8, 79, 110, 3, 192
unixace, 1634, 112.5, 631, 312, 28, 971
unloupdessteppes, 1038, 68.1, 537, 655, 44, 1236
unnamed, 1243, 35.4, 4957, 5982, 577, 11516
unnikumar, 1430, 84.5, 506, 422, 5, 933
unnivadakkan, 1386, 81.7, 599, 2525, 120, 3244
unojimbo, 801, 177.6, 31, 51, 1, 83
UNPREDICTABLE, 1243, 21.5, 17791, 21564, 1749, 41104
unrandomsam, 1322, 32.2, 4101, 5625, 410, 10136
UnratedOne, 1396, 31.8, 1677, 1956, 93, 3726
UnsoundHero, 1716, 52.4, 899, 329, 71, 1299
unturnedstone, 1216, 34.6, 3925, 4198, 435, 8558
Unununium, 1939, 48.7, 2269, 1116, 246, 3631
UofM, 1390, 29.1, 795, 1216, 164, 2175
upabon, 1366, 30.3, 1795, 1851, 95, 3741
upcomingplayer, 977, 37.6, 82, 122, 2, 206
UpGump, 711, 134.2, 3, 22, 0, 25
upperdeck, 1329, 40.2, 2394, 3741, 142, 6277
uppersnatch, 1264, 55.6, 483, 566, 29, 1078
UPRISING, 1466, 35.2, 3998, 5203, 301, 9502
upshaw, 1181, 121.4, 771, 891, 76, 1738
UpwardMouth, 1342, 92.6, 9, 11, 1, 21
Urbino, 1715, 56.7, 5374, 4715, 634, 10723
urbnaslt, 656, 135.1, 2, 17, 0, 19
urdapilleta, 1627, 75.2, 790, 963, 78, 1831
UrGameOver, 1421, 24.3, 2076, 1872, 135, 4083
urgggh, 1226, 123.2, 30, 37, 5, 72
urgoodbutimbetter, 1365, 25.4, 1345, 1446, 58, 2849
UrijGreen, 1552, 172.8, 9, 6, 3, 18
urilikescrack, 1176, 99.5, 65, 317, 0, 382
urineluck, 1517, 48.1, 550, 224, 23, 797
Uris, 1303, 76.0, 86, 153, 7, 246
ursatz, 1332, 63.7, 747, 621, 45, 1413
ursusraven, 1174, 57.5, 72, 85, 8, 165
urug, 1428, 38.5, 3936, 4382, 248, 8566
URUTODO, 1130, 37.2, 1182, 1299, 75, 2556
usachessmaster, 1408, 61.1, 83, 65, 5, 153
UsamaFoad, 1339, 55.7, 2519, 2524, 128, 5171
usarob, 1501, 35.7, 1997, 1775, 158, 3930
usclambox, 1310, 42.0, 1404, 1159, 137, 2700
useche, 1123, 132.2, 213, 213, 6, 432
uslee, 1327, 42.0, 344, 279, 15, 638
ustliS, 910, 89.0, 18, 56, 1, 75
UsuallySleepy, 1273, 69.8, 40, 44, 1, 85
usura, 1415, 219.2, 1, 3, 0, 4
USURP, 1178, 24.1, 493, 640, 47, 1180
utactics, 1040, 124.6, 64, 55, 6, 125
uthman, 1385, 37.8, 789, 1358, 88, 2235
Uthr, 1387, 44.9, 2582, 2350, 177, 5109
utigard, 1125, 147.8, 34, 33, 0, 67
Utini, 965, 65.1, 103, 264, 5, 372
utjazzfan, 1114, 43.4, 386, 226, 32, 644
utomjording, 1304, 62.2, 149, 196, 11, 356
utphamthanh, 1490, 37.7, 1545, 4691, 201, 6437
UtsavRajpara, 1084, 83.7, 16, 56, 3, 75
uvsravikiran, 1511, 74.6, 654, 914, 87, 1655
Uzuma, 1882, 342.6, 1, 0, 0, 1
Vacabrava, 1428, 66.5, 58, 53, 10, 121
vacaloka, 1633, 179.3, 16, 1, 1, 18
Vachopet, 2009, 99.2, 3496, 2483, 367, 6346
Vadio, 1674, 32.8, 942, 490, 47, 1479
vadnn, 1524, 27.8, 4704, 3605, 383, 8692
vailent, 1354, 67.1, 5410, 6057, 410, 11877
Vajrapani, 1204, 46.4, 223, 195, 15, 433
Valacuga, 1443, 34.9, 943, 488, 85, 1516, 1359, 56.6, 1315, 710, 174, 2199
ValenceJordan, 1533, 49.0, 1135, 1209, 149, 2493
valenzuelaalvaro, 1395, 34.6, 414, 393, 33, 840
valeri, 1402, 29.7, 3688, 4443, 343, 8474
Valiantangel, 1570, 32.7, 9328, 9581, 1055, 19964
ValidusPotens, 1756, 29.4, 6922, 5556, 560, 13038
valkon, 1066, 73.3, 2785, 2226, 135, 5146
vallabai, 1373, 90.5, 832, 669, 37, 1538
valpovo, 1865, 42.0, 158, 112, 12, 282
Valric, 1089, 42.6, 98, 159, 7, 264
ValV, 1023, 65.4, 137, 156, 4, 297
vampirium, 1310, 53.6, 4044, 4806, 392, 9242
VaMPyReSLaYeR, 1707, 264.7, 243, 261, 31, 535
Vancechess, 1770, 63.1, 5441, 3580, 356, 9377
VanceIII, 2162, 261.1, 257, 334, 69, 660
vancinad, 1184, 105.5, 411, 450, 30, 891
vancouverBC, 1033, 105.4, 1999, 2320, 207, 4526
vancouvsux, 1442, 25.1, 2478, 1804, 162, 4444
VandelayChess, 1202, 33.7, 1453, 1480, 105, 3038
vanderMur, 1550, 49.3, 732, 345, 51, 1128
vanDolgom, 1328, 72.3, 193, 241, 23, 457
vangna, 986, 39.5, 48, 77, 2, 127
Vangy, 1944, 73.0, 4012, 1379, 271, 5662
VanHobbit, 1843, 97.4, 20589, 13777, 1179, 35545
vanillaskyleap, 1332, 120.4, 1935, 1970, 74, 3979
vannman, 702, 175.7, 1, 20, 0, 21
vanpelt, 1313, 25.4, 3045, 3758, 287, 7090
vanucci, 1243, 59.4, 102, 100, 9, 211
vanzep, 1504, 122.8, 1179, 979, 75, 2233
vaporlock, 1622, 33.8, 8713, 7370, 1244, 17327
vardhan, 1187, 45.6, 1234, 1964, 51, 3249
varkster, 1271, 40.0, 1966, 1450, 81, 3497
vars, 1346, 27.3, 4537, 4220, 419, 9176
varsavia, 1761, 29.6, 2122, 1894, 614, 4630
Varsta, 1654, 34.7, 5574, 6308, 579, 12461
Vartui, 1029, 180.0, 25, 50, 2, 77
Vasallo, 1561, 22.4, 2131, 2033, 143, 4307
vasantenclave, 1060, 102.9, 2896, 7367, 174, 10437
vasif, 1335, 52.1, 495, 443, 39, 977
Vassis, 1076, 39.4, 388, 610, 22, 1020
VasTech, 1080, 103.1, 1062, 3758, 151, 4971
vastius, 1112, 87.2, 45, 85, 0, 130
vastlov, 827, 65.3, 110, 368, 6, 484
vatsalya, 1495, 31.0, 10590, 7796, 950, 19336
VattiO, 1279, 47.1, 262, 208, 18, 488
vaxerdec, 1093, 265.2, 2, 8, 0, 10
vbartenev, 926, 41.8, 675, 969, 46, 1690
VBC, 1294, 27.6, 14288, 8416, 513, 23217
vchust, 1451, 41.8, 294, 237, 62, 593
VDarkWizard, 1394, 44.3, 1595, 1798, 150, 3543
VDisMyBDcuzImBD, 947, 81.8, 143, 158, 0, 301
vdixit, 840, 108.4, 31, 106, 2, 139
vdoutchouk, 2071, 39.1, 5248, 3773, 513, 9534
vdub, 956, 202.7, 1, 4, 0, 5
vectorspace, 955, 229.7, 11, 40, 1, 52
vecvec, 1491, 24.1, 2047, 2246, 133, 4426
veeandy, 1315, 33.3, 808, 791, 65, 1664
veechess, 1284, 67.4, 3404, 3509, 292, 7205
Veenram, 1235, 39.5, 151, 546, 14, 711
VeganModel, 1977, 55.4, 205, 182, 21, 408
Vegaz, 1090, 78.9, 98, 81, 5, 184
vegedog, 1675, 50.4, 3073, 2346, 421, 5840
vegetables, 1652, 32.2, 3703, 2805, 410, 6918
vegp, 1449, 34.2, 10130, 12157, 564, 22851
veigas, 1108, 25.3, 2129, 4127, 173, 6429
Veit, 1556, 85.0, 5442, 3555, 412, 9409
veivaaja, 1306, 102.9, 6, 12, 3, 21
Vela, 1960, 124.8, 4090, 3676, 327, 8093
velkypes, 1277, 96.7, 1556, 1862, 150, 3568
Velobender, 1056, 39.4, 697, 736, 70, 1503
Velocityzone, 1274, 26.9, 846, 797, 62, 1705
VENATORMAX, 1062, 62.8, 114, 122, 10, 246
venazvz, 1814, 24.8, 17973, 17882, 2740, 38595
vendemiatrix, 1619, 32.3, 26612, 10172, 1543, 38327
venechess, 987, 77.4, 46, 78, 3, 127
Vengatesh, 1019, 89.0, 5, 26, 0, 31
venkiraviforever, 604, 74.8, 9, 122, 2, 133
venkobrother, 1697, 330.0, 0, 1, 0, 1
ventricule, 944, 128.8, 13, 24, 2, 39
venue, 1566, 26.1, 3429, 4334, 567, 8330
venugopal, 1409, 65.9, 6864, 6223, 360, 13447
VequalsIR, 1483, 60.7, 131, 163, 18, 312
verajanavel, 1251, 47.3, 1741, 1184, 102, 3027
verballistic, 634, 121.4, 4, 66, 2, 72
verboten, 1459, 30.2, 4634, 4688, 516, 9838
verdilac, 1316, 27.3, 691, 931, 57, 1679
verh, 1357, 49.9, 238, 250, 12, 500
verikt, 1618, 23.4, 22562, 23563, 1822, 47947
Verkkis, 1940, 46.4, 7862, 8830, 1061, 17753
vernita, 1723, 32.6, 2457, 1114, 115, 3686
Versiano, 1343, 204.5, 165, 197, 12, 374
vertiginous, 1675, 103.6, 54, 11, 1, 66
verymuchmale, 1666, 70.2, 8783, 8151, 636, 17570
vestibules, 1507, 61.2, 596, 689, 68, 1353
vetle, 1349, 34.6, 3585, 3960, 491, 8036
vetr, 1260, 38.0, 17296, 17801, 1885, 36982
vetteboy, 1012, 59.4, 1132, 5074, 35, 6241
Vexmeister, 1222, 38.9, 1958, 1981, 164, 4103
veziro, 1136, 162.0, 1, 4, 0, 5
vfuente, 1380, 137.4, 77, 104, 4, 185
vgakrishnan, 1105, 83.6, 1085, 965, 53, 2103
vgGritz, 1401, 36.7, 849, 771, 90, 1710
vhalperin, 1434, 40.3, 161, 187, 7, 355
VHelsing, 1237, 52.7, 5817, 5357, 420, 11594
Viamendz, 1112, 24.8, 1447, 2250, 63, 3760
viboraNegra, 1560, 98.4, 357, 263, 27, 647
Vicchess, 920, 179.5, 11, 39, 2, 52
vicentiko, 1601, 21.4, 3090, 2490, 229, 5809
vicentiu, 1401, 18.0, 2810, 3430, 131, 6371
vichesss, 1577, 22.3, 13430, 16584, 2017, 32031
Vichingo, 1584, 32.3, 2037, 1690, 79, 3806
vicohart, 1465, 29.1, 1440, 1384, 127, 2951
vicool, 1756, 27.5, 13712, 14139, 899, 28750
vicoyot, 1318, 31.9, 311, 288, 30, 629
Vicsher, 1383, 157.6, 176, 319, 29, 524
Victaum, 1288, 65.9, 604, 1048, 104, 1756
VictorOKN, 1442, 100.3, 2052, 2290, 201, 4543
videlle, 899, 29.1, 272, 551, 5, 828
vidman, 1013, 181.3, 1, 3, 0, 4
vidyapati, 1293, 19.4, 647, 667, 53, 1367
ViennaMike, 1104, 51.0, 632, 646, 50, 1328
vieque, 1675, 36.8, 11042, 7024, 581, 18647
viesta, 1409, 27.1, 3874, 4272, 524, 8670
VietPhoBoyz, 1200, 86.6, 606, 1075, 54, 1735
Vigoss, 1009, 257.3, 0, 2, 0, 2
vijendra, 861, 120.5, 5, 15, 0, 20
vikassri, 1270, 70.8, 387, 660, 25, 1072
vikramtiwari, 1457, 25.6, 5834, 4721, 387, 10942
viktorb, 1566, 33.9, 2997, 3562, 312, 6871
VIKTORK, 1720, 57.4, 1841, 1831, 90, 3762
vikushf, 1019, 42.8, 506, 716, 41, 1263
vilinar, 1727, 32.8, 5705, 4425, 379, 10509
villobas, 1107, 35.5, 413, 658, 26, 1097
ViMe, 1530, 31.6, 3648, 6308, 421, 10377
Vinamarino, 1462, 24.7, 5313, 6773, 781, 12867
vinandale, 718, 42.6, 42, 115, 0, 157
vinayj, 1176, 50.2, 138, 137, 12, 287
vinayvenky, 1555, 29.1, 5612, 4437, 284, 10333
VindexPopuli, 971, 39.3, 68, 86, 4, 158
ViniZan, 1245, 90.6, 1355, 1761, 122, 3238
Vinkie, 1271, 44.6, 1045, 1490, 176, 2711
vinkin, 1420, 48.2, 1598, 2078, 147, 3823
Vinnny, 588, 198.9, 0, 8, 0, 8
VinnyP, 725, 131.5, 1, 8, 0, 9
Vinor, 1880, 38.5, 2844, 3698, 567, 7109
vinstayl, 1330, 71.3, 649, 975, 47, 1671
vinyletourist, 1320, 39.3, 1838, 2693, 130, 4661
Vinylfix, 1316, 88.4, 1134, 1598, 66, 2798
vinzanity, 1467, 130.6, 16, 24, 0, 40
ViperStrike, 1879, 113.2, 16, 13, 0, 29
Virabhadra, 713, 138.6, 8, 27, 3, 38
virax, 900, 90.5, 29, 70, 3, 102
Virdis, 1551, 34.2, 2088, 2095, 203, 4386
virgilfox, 1216, 111.0, 1073, 1422, 112, 2607
VirginSoul, 1108, 62.8, 936, 1340, 51, 2327
virgo, 1415, 44.5, 2586, 2223, 183, 4992
Viriatus, 1499, 46.5, 6130, 3571, 398, 10099
visalp, 1395, 44.4, 11879, 12328, 403, 24610
visc, 1336, 72.7, 1716, 1888, 113, 3717
Viscis, 1038, 51.2, 439, 839, 24, 1302
visentin, 1846, 32.4, 1638, 2191, 231, 4060
vises, 1652, 82.1, 2097, 1233, 86, 3416
vishalulu, 1323, 60.9, 175, 152, 14, 341
vishghost, 1072, 109.7, 800, 1007, 52, 1859
vishnukumarkushwa, 757, 126.5, 2, 44, 2, 48
Visio, 1673, 94.3, 1326, 1100, 118, 2544
vistor, 1257, 66.2, 980, 974, 39, 1993
vistula, 1556, 26.8, 4585, 3999, 670, 9254
visualis, 1383, 26.7, 8159, 13493, 768, 22420
visualseven, 1418, 45.7, 5285, 3354, 490, 9129
viswa, 1256, 111.4, 561, 931, 35, 1527
vitalion, 1559, 24.5, 19024, 18643, 1289, 38956
VitaliyR, 1272, 34.4, 198, 496, 30, 724
vitalvital, 1621, 68.3, 4302, 1997, 186, 6485
vitoreiji, 1375, 28.5, 2563, 2840, 197, 5600
Vitsaus, 1497, 46.9, 380, 625, 73, 1078
vizikk, 1598, 45.5, 3525, 4380, 299, 8204
Vizzier, 1694, 40.9, 293, 401, 48, 742
vjgreen, 1294, 22.4, 3622, 4921, 178, 8721
vkan, 1510, 22.0, 9356, 9380, 1021, 19757
vkariy, 1530, 31.7, 1524, 714, 116, 2354
vkmehta, 1363, 45.3, 4928, 5600, 323, 10851
Vlaado, 1622, 30.5, 10203, 10572, 1375, 22150
Vlacov, 1287, 49.4, 35, 99, 1, 135
VladaAmater, 1457, 26.4, 4588, 6709, 876, 12173
vladchess, 1223, 23.9, 1507, 1436, 46, 2989
vladicaboy, 1169, 118.4, 246, 174, 13, 433
VladimirAbakan, 1602, 22.0, 12237, 14090, 1610, 27937
Vladimirko, 1517, 74.7, 1581, 1054, 88, 2723
vladimirOo, 1155, 93.2, 44, 41, 5, 90
VladimirV, 1458, 70.8, 1086, 1008, 138, 2232
VladislavH, 1368, 35.7, 1488, 1347, 122, 2957
vladmerino, 1231, 130.8, 903, 1123, 102, 2128
vladod, 1299, 27.0, 9588, 11376, 665, 21629
vladoto, 1473, 44.5, 4261, 7615, 339, 12215
VladPal, 1650, 32.7, 4833, 4697, 658, 10188
VMCHO, 1016, 35.1, 401, 1104, 24, 1529
vmdpz, 2035, 34.2, 1881, 1602, 201, 3684
vmedina, 773, 91.2, 110, 328, 3, 441
VMihailov, 1357, 33.9, 2157, 1566, 191, 3914
vmk, 995, 23.6, 404, 826, 70, 1300
VMM, 1804, 31.9, 1659, 1653, 194, 3506
vmqg, 1365, 45.5, 128, 210, 23, 361
vnorby, 1269, 62.2, 886, 1365, 87, 2338
Vocis, 1378, 117.6, 6660, 7627, 929, 15216
voderi, 1311, 38.6, 6983, 8574, 335, 15892
Vogner, 1413, 30.6, 1390, 810, 59, 2259
Voices, 1433, 39.4, 8354, 8526, 405, 17285
VoicesLeadMe, 1386, 84.1, 489, 324, 42, 855
voidpointer, 1110, 44.8, 264, 534, 23, 821
VojFromMars, 1796, 26.0, 1394, 839, 174, 2407
volandd, 1373, 31.6, 5521, 6909, 941, 13371
volcano, 1631, 103.9, 5636, 3981, 383, 10000
voldo, 1242, 40.9, 2553, 2084, 181, 4818
volkenla, 1028, 36.4, 844, 819, 19, 1682
Volks, 1449, 21.5, 12574, 10517, 658, 23749
Volohh, 1119, 146.3, 4, 10, 0, 14
volucer, 1472, 29.5, 4053, 3370, 318, 7741
VOM, 1113, 63.0, 69, 129, 4, 202
vonBayerisch, 1390, 30.1, 492, 445, 33, 970
voodoodragon, 1802, 61.4, 1167, 718, 109, 1994
Voodoospiral, 2003, 51.1, 1727, 294, 81, 2102
Vorlon, 1181, 96.5, 1172, 2190, 101, 3463
voteforzaphod, 1945, 37.4, 150, 125, 17, 292
votsor, 1359, 53.9, 1111, 1087, 87, 2285
VovaWest, 1320, 97.6, 207, 343, 36, 586
vparvath, 1110, 187.7, 29, 22, 0, 51
vprimorac, 1340, 96.7, 15, 49, 5, 69
vrahimov, 1481, 28.1, 3558, 2374, 236, 6168
vriendelijke, 1725, 45.2, 10264, 8514, 736, 19514
VRL, 1417, 22.1, 4747, 5419, 411, 10577
VrloJakMK, 2059, 23.0, 8669, 6146, 916, 15731
VrloVeliki, 1362, 99.2, 82, 90, 6, 178
vrond, 1273, 35.7, 272, 285, 9, 566
Vrykonik, 1588, 81.5, 406, 438, 54, 898
vsedk, 1204, 97.3, 307, 209, 51, 567
vshamis, 1619, 52.4, 5052, 6270, 402, 11724
Vslu, 1042, 112.5, 6, 36, 1, 43
vssp, 1639, 115.8, 118, 181, 10, 309
VStrider, 1492, 22.0, 5353, 5272, 303, 10928
Vsus, 1009, 122.3, 79, 76, 5, 160
vsvor, 1371, 33.9, 542, 452, 19, 1013
vtrdude, 1315, 101.9, 3430, 3480, 202, 7112
vtretyak, 1339, 128.4, 176, 257, 12, 445
vuhb, 1555, 42.0, 4612, 6059, 733, 11404
Vulnus, 1592, 70.9, 3384, 2749, 322, 6455
vvoix, 1391, 46.1, 1948, 1488, 229, 3665
VVoody, 1042, 227.6, 0, 3, 0, 3
VVVinci, 1255, 32.8, 3323, 2628, 235, 6186
vvvvvvv, 1708, 46.1, 1194, 2020, 199, 3413
vxj, 1364, 43.8, 5424, 7549, 723, 13696
vxstorm, 1242, 32.5, 47, 166, 3, 216
Vyg, 1176, 67.4, 676, 749, 43, 1468
Wacara, 1823, 262.8, 2, 0, 0, 2
wackytackypatzer, 1539, 30.4, 5454, 2991, 316, 8761
WadeWilsonDP, 1918, 257.5, 1, 0, 0, 1
wagant, 1455, 238.3, 2, 2, 0, 4
wageslave, 1556, 34.9, 2044, 1300, 148, 3492
wagnerbi, 1810, 63.6, 449, 331, 63, 843
wagun, 1755, 40.9, 789, 909, 112, 1810
wahoonc, 1449, 24.3, 10716, 9585, 757, 21058
Waldemir, 914, 335.1, 0, 2, 0, 2
waldner, 1842, 24.6, 8491, 7400, 915, 16806
waldoelrey, 860, 131.6, 5, 45, 1, 51
Waldur, 1793, 33.5, 6681, 4866, 1150, 12697
waleedElbadawi, 1327, 30.0, 4935, 8089, 499, 13523
walger, 958, 122.5, 8, 32, 1, 41
walkingterrapin, 1575, 99.5, 632, 303, 42, 977
walkinthespirit, 1148, 27.6, 4283, 4070, 242, 8595
walkytalky, 1442, 96.9, 546, 846, 29, 1421
Wallase, 1122, 103.2, 1912, 1904, 85, 3901
walls, 1423, 30.4, 4749, 5338, 459, 10546
wallysands, 1206, 35.6, 2322, 5645, 276, 8243
waltc, 1665, 90.8, 1433, 757, 97, 2287
walton, 1321, 42.4, 2920, 2174, 180, 5274
wam, 1512, 28.3, 8220, 7482, 788, 16490
WANGDAYE, 1242, 38.6, 1119, 1015, 105, 2239
WangZugz, 1110, 46.7, 843, 1028, 67, 1938
wannalearn, 1110, 75.1, 8, 27, 1, 36
wanorita, 1153, 50.2, 1461, 2147, 155, 3763
waponata, 2015, 18.0, 9484, 8316, 969, 18769
warbly, 1251, 68.9, 3521, 3754, 181, 7456
warcorp, 1459, 31.8, 931, 746, 78, 1755
warehouse, 1211, 30.3, 6834, 12815, 821, 20470
warezlite, 1408, 75.3, 99, 81, 9, 189
warfarer, 1588, 27.3, 2085, 1179, 165, 3429
Waris, 909, 129.7, 25, 64, 1, 90
warrenwhite, 1397, 66.8, 4822, 4390, 438, 9650
warriorness, 1131, 109.8, 225, 273, 11, 509
warroom, 1165, 27.0, 2487, 2511, 197, 5195
Warthog, 1518, 56.0, 3303, 2932, 505, 6740
WASFOX, 1366, 26.0, 8638, 9859, 560, 19057
wassupwiddat, 1688, 51.0, 92, 74, 8, 174
watchoutfishy, 1195, 95.3, 2618, 2316, 326, 5260
waterprof, 1605, 26.4, 15881, 18073, 1765, 35719
Waterskizzle, 1275, 33.6, 600, 757, 42, 1399
Watlers, 1561, 72.5, 5200, 2544, 383, 8127
watnu, 1488, 37.0, 10487, 6569, 691, 17747
watsoncs, 1439, 30.4, 2275, 2158, 145, 4578
watsonthecat, 1150, 65.7, 307, 454, 22, 783
watsunami, 1563, 47.4, 1046, 683, 74, 1803
wauserl, 941, 122.5, 5, 14, 0, 19
wavesofpleasure, 1096, 33.4, 524, 613, 19, 1156
wawawiwa, 887, 75.2, 24, 37, 4, 65
wawrzy, 1614, 24.8, 3940, 1842, 187, 5969
wayhome, 1270, 35.0, 4144, 4443, 292, 8879
waynemcdougall, 1317, 34.0, 2219, 3257, 149, 5625
Wayner, 1412, 31.2, 4258, 3807, 318, 8383
waynerox, 599, 151.8, 0, 16, 0, 16
WayneS, 1121, 35.7, 1810, 1830, 101, 3741
wayuat, 1284, 28.6, 8091, 7799, 629, 16519
wazex, 1853, 27.2, 4443, 4317, 412, 9172
WCES, 1372, 35.8, 2112, 3627, 240, 5979
wcf, 1035, 45.5, 2130, 3930, 227, 6287
wdywdpusher, 1232, 21.7, 8480, 7961, 660, 17101
weaker, 1055, 35.7, 1771, 1370, 183, 3324
weakicus, 1612, 43.6, 5451, 2718, 304, 8473
weakpawn, 1906, 172.9, 3780, 3203, 357, 7340
WeakPlay, 1258, 123.5, 29, 61, 0, 90
weakplayer, 1478, 35.7, 6196, 4631, 364, 11191
weashwin, 1106, 32.1, 912, 1390, 33, 2335
Weathal, 1322, 101.6, 14, 33, 5, 52
webdog, 1570, 44.5, 3213, 979, 82, 4274
Webgohar, 1828, 57.1, 321, 73, 8, 402
webworks, 783, 127.8, 9, 32, 1, 42
wedro, 1357, 65.6, 12329, 11700, 888, 24917
weekend, 1531, 117.5, 3662, 2643, 253, 6558
WeensWint, 1618, 58.6, 13540, 11663, 1288, 26491
Wegaman, 1353, 41.5, 3179, 3964, 290, 7433
weidenstr, 1455, 25.8, 6063, 10762, 1046, 17871
weihuguo, 792, 104.0, 6, 21, 3, 30
WeiJ, 1367, 61.9, 708, 528, 40, 1276
weilansejidi, 1594, 56.7, 182, 202, 25, 409
weilming, 1657, 145.5, 596, 613, 55, 1264
weirdaliscool, 1611, 45.0, 73, 39, 4, 116
Weizen, 1467, 66.7, 908, 586, 100, 1594
weizzer, 1137, 107.9, 896, 860, 54, 1810
WellHung, 1642, 74.0, 4077, 3241, 357, 7675
wellthoughtplan, 1351, 31.8, 2750, 2405, 127, 5282
Wellu, 1014, 68.5, 230, 523, 27, 780
wengles, 1019, 111.4, 143, 206, 5, 354
weno, 1590, 59.4, 1699, 1003, 124, 2826
Werdnap, 1402, 41.6, 2330, 1651, 147, 4128
Werttt, 886, 77.2, 43, 131, 0, 174
wesleyfan, 1534, 43.1, 1421, 1817, 79, 3317
WesleyL, 1407, 123.4, 204, 93, 18, 315
Wesson, 1072, 46.5, 4059, 7662, 260, 11981
westdale, 1213, 36.2, 2398, 3085, 289, 5772
westplayer, 946, 40.6, 1213, 1297, 56, 2566
westrise, 1005, 79.5, 52, 117, 6, 175
weststern, 878, 130.2, 26, 59, 2, 87
westworld, 1508, 86.4, 19284, 22430, 2648, 44362
wfletcher, 1250, 65.0, 429, 1141, 31, 1601
Wfullmer, 1338, 88.5, 75, 64, 8, 147
WGodel, 1408, 75.3, 1573, 891, 118, 2582
WhackaNum, 1337, 24.3, 840, 806, 52, 1698
whackme, 1228, 40.0, 560, 663, 37, 1260
whardawg, 1326, 63.6, 115, 151, 8, 274
whatcostvictory, 839, 139.0, 26, 47, 4, 77
whathappened, 1212, 141.0, 39, 29, 3, 71
WhatHeUpToo, 1602, 80.5, 822, 478, 59, 1359
WhatRook, 1172, 96.3, 12, 20, 4, 36
WhatSayYou, 991, 107.3, 32, 57, 1, 90
WHATSUP, 1075, 38.4, 1678, 2418, 113, 4209
whatthefez, 1584, 110.0, 199, 183, 21, 403
whimsy, 1273, 60.1, 269, 281, 12, 562
WhipMe, 1523, 43.1, 1097, 631, 49, 1777
Whipmeister, 1220, 34.2, 2776, 6092, 256, 9124
Whis, 1426, 70.1, 2256, 2037, 230, 4523
WhiteCastle, 1267, 49.6, 5131, 6641, 636, 12408
whiteguardian, 1575, 28.5, 14375, 9371, 849, 24595
whitejediknight, 1277, 36.1, 673, 1076, 26, 1775
WhiteKnightX, 1285, 37.4, 422, 334, 54, 810
WhiteLightEntity, 1156, 100.7, 139, 117, 9, 265
whitepandora, 931, 37.5, 1033, 1753, 80, 2866
WhitePatriot, 1427, 40.3, 120, 165, 26, 311
whitepirate, 1510, 26.1, 1262, 1326, 124, 2712
whiterook, 1307, 32.4, 36802, 17345, 2788, 56935
whizmo, 1145, 40.3, 419, 425, 21, 865
whodatdare, 919, 197.1, 1, 4, 0, 5
whoflungdung, 1297, 33.7, 2362, 3229, 186, 5777
whosnextrule, 1157, 146.5, 235, 257, 13, 505
whowantsamessage, 974, 35.9, 2017, 4710, 179, 6906
whytenight, 1141, 81.4, 745, 1066, 46, 1857
Whyzor, 1732, 350.0, 1, 0, 0, 1
wiber, 968, 25.4, 356, 524, 15, 895
Wicho, 1198, 36.2, 2301, 1943, 151, 4395
Widzu, 1664, 57.0, 1724, 1350, 193, 3267
wierdaj, 1285, 46.5, 2216, 2328, 291, 4835
wiiwii, 1433, 34.2, 789, 744, 94, 1627
wilberforce, 1874, 350.0, 797, 486, 80, 1363
Wilberto, 1206, 38.9, 2299, 3315, 104, 5718
wildcathughes, 1164, 57.2, 484, 494, 35, 1013
wildcrop, 1168, 25.6, 1847, 2276, 116, 4239
Wildguy, 1445, 87.3, 4302, 4784, 437, 9523
wildplum, 1437, 50.7, 6212, 4637, 1409, 12258
WildPudge, 1775, 78.5, 3983, 2314, 425, 6722
wildturkeyz, 1118, 46.4, 532, 1043, 26, 1601
WildUtah, 1045, 90.3, 141, 194, 12, 347
wileyone, 1163, 181.9, 3, 6, 0, 9
WilhelmTell, 1398, 67.5, 399, 407, 39, 845
willbatron, 1536, 50.1, 83, 46, 9, 138
WillByron, 1013, 42.6, 415, 850, 15, 1280
WilldaBeast, 647, 117.9, 16, 145, 0, 161
WilliamManahan, 1291, 26.4, 5438, 4380, 587, 10405
williewilliams, 924, 32.9, 517, 842, 72, 1431
WillK, 1367, 24.0, 10104, 6967, 725, 17796
Willou, 1468, 29.5, 2051, 1767, 248, 4066
willplay, 1227, 87.8, 5614, 8390, 525, 14529
willpowers, 1092, 53.9, 441, 1010, 40, 1491
willrc, 1463, 40.4, 1425, 1598, 158, 3181
WillTStevenson, 1809, 124.8, 8878, 1936, 198, 11012
wilnietis, 1397, 73.9, 396, 315, 26, 737
wilsondagreat, 1483, 102.3, 1513, 1222, 81, 2816
Wimbo, 1306, 145.2, 11, 47, 1, 59
wimperette, 1511, 21.5, 15352, 14844, 1106, 31302
wimpypawn, 878, 158.9, 815, 1312, 36, 2163
wimster, 786, 124.7, 6, 36, 1, 43
windbumwino, 1255, 29.8, 3904, 4209, 380, 8493
windfinder, 1452, 119.9, 1098, 784, 52, 1934
windhover, 1355, 113.1, 2960, 3347, 254, 6561
Windicate, 1669, 28.0, 1806, 1670, 135, 3611
Windraven, 1691, 38.0, 9809, 5862, 988, 16659
WindsOfThor, 1564, 27.5, 11974, 9057, 763, 21794
wineranger, 1014, 69.7, 205, 256, 13, 474
Wingedserpent, 1522, 35.2, 78, 108, 0, 186
Winginaguy, 1817, 20.5, 3053, 3511, 466, 7030
winkypickles, 1465, 21.6, 4887, 3898, 420, 9205
WinnegansFake, 1282, 57.7, 2716, 4877, 472, 8065
winningperson, 1350, 59.0, 284, 205, 12, 501
Winnipeger, 829, 94.3, 172, 625, 6, 803
winpower, 1450, 51.6, 294, 317, 58, 669
WinsomeKnight, 1877, 54.4, 232, 292, 33, 557
WinterChess, 1101, 37.9, 484, 666, 98, 1248
winterpswin, 1335, 28.1, 2683, 1581, 207, 4471
WireFire, 897, 128.2, 43, 179, 3, 225
WISEAGIS, 1516, 30.4, 2505, 1061, 320, 3886
Wiseguy, 1330, 33.3, 5415, 5721, 255, 11391
wisham, 1148, 110.3, 57, 67, 4, 128
WishIAnand, 1390, 58.1, 367, 245, 23, 635
Wiszard, 1423, 153.5, 8, 11, 0, 19
Witzel, 1176, 30.8, 1624, 2362, 110, 4096
wizardman, 1164, 52.0, 586, 772, 90, 1448
Wizardofcali, 1263, 58.3, 66, 55, 1, 122
WIZARDofOZ, 1331, 32.4, 6770, 5618, 549, 12937
WizardX, 1407, 93.8, 12278, 17682, 665, 30625
wjn, 1452, 26.4, 9006, 6857, 682, 16545
Wladanco, 1398, 24.8, 6841, 8584, 800, 16225
wlc, 849, 71.6, 18, 57, 0, 75
wleite, 1752, 74.4, 152, 93, 17, 262
wlljmsgllghr, 1054, 47.1, 243, 259, 8, 510
WlNTERMUTE, 1288, 56.7, 351, 446, 15, 812
WLS, 1475, 39.9, 5707, 4375, 567, 10649
wluking, 1362, 76.9, 1225, 2175, 146, 3546
wmahan, 1802, 184.4, 7630, 5716, 535, 13881
WMDenny, 1151, 55.3, 1091, 991, 65, 2147
wmfellows, 1169, 25.4, 3626, 6185, 333, 10144
WMK, 1059, 242.0, 0, 2, 0, 2
wmrangel, 1117, 130.0, 4, 24, 0, 28
wnneir, 1445, 37.0, 119, 72, 10, 201
Wobblier, 1569, 103.6, 3325, 2271, 211, 5807
WobblyMan, 1444, 27.0, 2467, 1860, 178, 4505
woblurns, 1104, 105.7, 73, 97, 4, 174
woden, 1942, 237.5, 595, 421, 37, 1053
wodger, 1393, 72.1, 2349, 1997, 184, 4530
wolfehhgg, 1342, 62.0, 198, 126, 12, 336
Wolfeman, 1776, 45.8, 2852, 1858, 252, 4962
wolffman, 1164, 29.4, 6513, 4189, 526, 11228
WolfgangAMozart, 1378, 38.6, 3641, 2883, 151, 6675
Wolfi, 1766, 30.0, 9107, 7126, 1440, 17673
wolfpackking, 856, 109.3, 91, 241, 7, 339
WolfWalker, 1519, 31.1, 14658, 12697, 1040, 28395
wolfwolf, 1506, 38.6, 5783, 6441, 367, 12591
wollongonian, 1173, 41.2, 4475, 3367, 221, 8063
WonMonkey, 857, 44.0, 331, 1925, 31, 2287
WontResign, 1666, 55.8, 22, 24, 1, 47
woobers, 1526, 49.5, 587, 896, 62, 1545
woodbeast, 1456, 23.3, 12817, 11973, 1238, 26028
Woodbungler, 1329, 33.1, 12622, 16960, 1081, 30663
woodreed, 1442, 109.1, 497, 364, 5, 866
woodrowcw, 1337, 69.1, 1642, 2204, 213, 4059
woodstove, 908, 128.6, 301, 429, 9, 739
WoodyPeanuts, 1266, 30.6, 4127, 4995, 341, 9463
woof, 1844, 128.3, 1255, 1003, 110, 2368
woofy, 1266, 27.1, 550, 615, 35, 1200
woozycat, 1240, 31.0, 2478, 2671, 236, 5385
wordpasss, 1133, 157.0, 749, 981, 76, 1806
wordspoken, 1768, 176.4, 4171, 3385, 538, 8094
WorkOrChess, 1563, 63.6, 325, 260, 28, 613
worldpower, 1408, 71.9, 460, 629, 20, 1109
Wormholes, 1140, 139.9, 156, 371, 11, 538
woronc, 1176, 33.2, 2000, 4155, 126, 6281
worstplayer, 1239, 58.7, 1650, 1668, 119, 3437
woshimimi, 1310, 84.0, 78, 172, 13, 263
wouayo, 1231, 64.5, 106, 104, 4, 214
wowboy, 1336, 18.5, 1465, 1359, 73, 2897
wowdewow, 1367, 55.6, 84, 96, 8, 188
wowgirl, 1389, 34.3, 1462, 1376, 68, 2906
wqre, 1485, 26.1, 7189, 3805, 336, 11330
WRBA, 1384, 32.3, 2436, 3213, 372, 6021
wred, 982, 30.6, 461, 946, 13, 1420
wrfama, 1551, 41.1, 1226, 980, 182, 2388
wrzgut, 1408, 22.1, 12862, 18681, 936, 32479
wsilaen, 1395, 39.1, 1562, 1758, 178, 3498
WsWarrior, 1380, 105.4, 525, 295, 46, 866
wsx, 1303, 99.4, 321, 437, 20, 778
wsxqaz, 1517, 99.3, 126, 182, 10, 318
wterka, 904, 69.6, 11, 26, 3, 40
wtew, 1161, 194.1, 0, 7, 0, 7
WTFISAHANDLE, 1345, 72.3, 212, 396, 17, 625
wtfpawned, 1258, 75.3, 1464, 1511, 104, 3079
wthfk, 1214, 37.6, 771, 1636, 49, 2456
WTMike, 943, 42.4, 32, 71, 0, 103
WuHoUnited, 1340, 39.8, 912, 419, 37, 1368
WulfB, 1125, 39.1, 49, 40, 3, 92
wundtsapawnintime, 1310, 72.0, 787, 597, 58, 1442
wuschi, 1460, 32.0, 8615, 8227, 1037, 17879
wushaomin, 1206, 43.7, 109, 36, 1, 146
wutangwong, 1427, 24.0, 659, 698, 61, 1418
wutever, 948, 42.9, 77, 110, 5, 192
wuvo, 1741, 43.9, 2929, 7297, 603, 10829
wwhatevermann, 1202, 48.5, 420, 502, 27, 949
wwwZHILINSru, 957, 30.6, 112, 198, 13, 323
wxvr, 2114, 75.7, 3700, 1827, 323, 5850
wyattb, 1388, 52.8, 602, 791, 46, 1439
wycliff, 1266, 46.9, 2151, 2872, 244, 5267
wyeo, 1249, 66.1, 818, 931, 66, 1815
wymyczakr, 818, 207.7, 2, 11, 0, 13
wysowa, 1478, 23.6, 5435, 5306, 310, 11051
wyzgie, 1116, 77.4, 173, 181, 7, 361
xadrezedificil, 1321, 23.3, 1421, 2027, 83, 3531
xadrezonline, 1257, 79.1, 1530, 2782, 214, 4526
xadrezrs, 1709, 23.5, 3388, 3409, 454, 7251
xainish, 1399, 298.6, 0, 1, 0, 1
Xakka, 2037, 111.4, 275, 90, 18, 383
xamid, 1596, 17.5, 916, 1588, 236, 2740
xanshin, 876, 75.3, 222, 214, 19, 455
xArkansanx, 992, 114.2, 5, 13, 0, 18
xattackx, 1370, 140.3, 20452, 21231, 1235, 42918
XavierBriche, 1400, 29.7, 7646, 7624, 456, 15726
xbichon, 1406, 60.0, 2074, 1169, 256, 3499
Xbroom, 1581, 25.9, 6226, 6565, 264, 13055
Xchat, 1025, 72.3, 2832, 3332, 272, 6436
xclusive, 1152, 88.7, 18, 30, 2, 50
xcsaber, 1668, 28.0, 1491, 749, 117, 2357
xdmorris, 1204, 39.4, 1913, 2150, 199, 4262
Xeanu, 1820, 96.9, 197, 95, 10, 302
xebos, 1347, 54.4, 639, 453, 27, 1119
xellxx, 1324, 86.6, 1091, 792, 71, 1954
xenoglot, 1042, 88.0, 1162, 2169, 66, 3397
Xeones, 1479, 78.5, 1376, 1503, 88, 2967
xeqm, 1094, 41.0, 2513, 3206, 150, 5869
Xeres, 2047, 61.4, 1408, 1358, 139, 2905
Xeriox, 1210, 328.6, 0, 1, 0, 1
xeroxorex, 1944, 19.4, 606, 660, 82, 1348
XFregate, 1527, 22.2, 6878, 18025, 1477, 26380
XiangHe, 1213, 31.2, 816, 1573, 82, 2471
xiaoffu, 1546, 71.0, 1808, 1661, 155, 3624
Xiaoluo, 1349, 49.7, 209, 162, 21, 392
xiaoxiacanada, 1648, 116.7, 624, 912, 77, 1613
xilabre, 1177, 87.9, 19, 17, 1, 37
xitimela, 1266, 74.0, 480, 396, 41, 917
xivarmy, 1496, 53.3, 3472, 2623, 238, 6333
xiyangyang, 814, 80.2, 36, 155, 3, 194
xjphil, 1396, 33.8, 382, 529, 17, 928
Xlander, 965, 81.3, 1041, 2069, 53, 3163
xmadmax, 929, 69.8, 488, 1284, 15, 1787
xmaletof, 1449, 65.2, 167, 121, 14, 302
xmusketeer, 873, 135.7, 4, 18, 1, 23
xnepom, 2083, 27.0, 2331, 1701, 365, 4397
XNeto, 1180, 47.0, 243, 325, 21, 589
xntllctlvlncx, 1003, 52.5, 226, 311, 20, 557
xoftahiti, 983, 42.1, 154, 331, 9, 494, 1583, 42.7, 3250, 3212, 328, 6790
Xong, 1415, 33.3, 5667, 1647, 472, 7786
xoptimusx, 1420, 120.6, 22, 26, 5, 53
xorronhorror, 1172, 35.2, 139, 220, 1, 360
xosepineda, 1025, 30.3, 181, 121, 6, 308
xprexx, 1036, 88.4, 64, 112, 3, 179
xprho, 1450, 26.8, 1016, 2041, 138, 3195
xqsme, 1296, 27.6, 2132, 7659, 309, 10100
XRayIndia, 1444, 22.9, 2348, 1764, 205, 4317
Xrcs, 1695, 66.6, 1113, 1043, 98, 2254
xreal, 1147, 32.5, 7538, 12786, 530, 20854
xrtpop, 938, 132.9, 393, 397, 15, 805
xsersychi, 1097, 63.9, 135, 233, 10, 378
xSHYNE, 1657, 67.3, 872, 1223, 67, 2162
Xsii, 1483, 40.9, 794, 570, 62, 1426
xstillillx, 1041, 88.3, 698, 1677, 66, 2441
XSTOF, 1186, 22.9, 6636, 9201, 550, 16387
XTERMINATER, 1328, 30.5, 2121, 1498, 128, 3747
xtheduke, 1158, 60.9, 2074, 3599, 127, 5800
xubee, 1070, 27.9, 787, 802, 36, 1625
xufei, 1442, 52.8, 6624, 4013, 598, 11235
xutaommm, 1637, 121.9, 661, 181, 51, 893
xvivaldix, 1414, 96.2, 4733, 5520, 504, 10757
xxCentauroxx, 1750, 132.5, 252, 103, 8, 363
xxCheckmatexx, 1059, 137.5, 16, 27, 2, 45
xxice, 1516, 30.7, 540, 692, 66, 1298
xxinoxx, 1285, 39.6, 1583, 2416, 134, 4133
xxIsabel, 1197, 332.8, 0, 1, 0, 1
xxLori, 1521, 23.5, 22189, 29118, 3202, 54509
xxNeoNxx, 1746, 104.9, 1363, 613, 46, 2022
xxNexus, 1279, 85.8, 2220, 1611, 136, 3967
xxRookiexx, 1979, 46.9, 672, 571, 109, 1352
XxTechHeadxX, 1085, 46.5, 220, 354, 14, 588
xXxAceGuyxXx, 1183, 63.9, 66, 63, 2, 131
xxxNeoNxxx, 1664, 80.9, 1229, 584, 38, 1851
XXXXTOOLXXXX, 1955, 29.2, 755, 389, 43, 1187
XYLUM, 1017, 93.5, 215, 630, 18, 863
xyrus, 1494, 37.8, 2971, 3033, 217, 6221
xzone, 1550, 23.7, 6196, 4122, 328, 10646
Yaboynyp, 1138, 70.0, 392, 286, 21, 699
yahoojames, 1478, 26.2, 4029, 4357, 456, 8842
Yahowa, 1702, 25.6, 1204, 1229, 104, 2537
YahtzeeDE, 1098, 95.8, 86, 103, 13, 202
yairlv, 1351, 40.1, 1376, 1043, 115, 2534
Yaki, 1538, 40.2, 5784, 4310, 511, 10605
yakovgreen, 1555, 30.6, 805, 1149, 157, 2111
YAKOVT, 1166, 34.3, 757, 705, 33, 1495
Yakshhh, 813, 91.9, 26, 138, 4, 168
Yaku, 1215, 32.1, 2914, 3890, 262, 7066
Yakusoku, 1315, 93.8, 55, 71, 8, 134
Yalex, 1554, 120.7, 375, 177, 10, 562
yamahahunter, 735, 132.9, 2, 19, 0, 21
Yamatoster, 1567, 42.2, 1434, 1466, 120, 3020
yamitl, 1309, 57.8, 121, 191, 24, 336
yamuday, 1158, 28.7, 9455, 19960, 902, 30317
Yandrov, 1753, 48.6, 1970, 1577, 200, 3747
yangon, 1390, 28.2, 2830, 2653, 268, 5751
Yannickovitch, 1588, 113.0, 8193, 5533, 946, 14672
yanosan, 1477, 58.9, 250, 511, 36, 797
yapwnedme, 1302, 66.2, 376, 390, 36, 802
Yarahmadi, 1068, 100.8, 88, 120, 3, 211
Yarmatee, 1560, 123.2, 713, 490, 86, 1289
yarmoe, 1724, 28.6, 12567, 5867, 541, 18975
Yaro, 1622, 306.1, 959, 678, 45, 1682
yaronusa, 1203, 73.7, 1072, 1411, 85, 2568
yarony, 1524, 30.1, 3182, 2244, 169, 5595
Yaroz, 1215, 34.2, 247, 263, 18, 528
yasargil, 1648, 114.4, 22, 38, 6, 66
yassoutiger, 1789, 21.4, 7352, 10457, 881, 18690
yatch, 936, 70.1, 18, 71, 2, 91
Yaughan, 1147, 41.5, 458, 488, 97, 1043
yayabzq, 1180, 123.6, 11, 18, 1, 30
yayforabortion, 1370, 36.4, 1426, 1495, 127, 3048
yazel, 1674, 170.1, 1577, 2755, 218, 4550
Ychromosome, 1489, 38.3, 835, 876, 105, 1816
ycliu, 1436, 39.0, 659, 431, 35, 1125
yddy, 1421, 31.9, 4239, 4518, 343, 9100
ydsmp, 826, 130.2, 8, 49, 0, 57
yeabro, 1064, 55.0, 503, 452, 29, 984
yeadonboy, 1123, 34.6, 1963, 2474, 120, 4557
Yeddox, 1386, 159.2, 104, 71, 5, 180
yeellow, 1467, 36.5, 1297, 1032, 52, 2381
yelloswturm, 1304, 53.7, 1917, 1810, 208, 3935
YellowCard, 1043, 93.0, 16, 55, 1, 72
yellowviper, 1042, 29.9, 1322, 6350, 194, 7866
yeptis, 1336, 25.3, 2040, 3168, 175, 5383
yerbamate, 1135, 67.5, 739, 1251, 39, 2029
yermishin, 1611, 61.8, 1082, 236, 69, 1387
YesMaster, 1512, 186.9, 1648, 1413, 146, 3207
Yesu, 1135, 103.9, 915, 1926, 47, 2888
Yetispotter, 1905, 31.6, 856, 693, 119, 1668
yfan, 1569, 21.3, 14955, 18498, 1488, 34941
YHCL, 1395, 262.1, 2, 1, 0, 3
yiddish, 911, 239.5, 0, 3, 0, 3
Yilong, 1837, 48.4, 4017, 5061, 434, 9512
yirmibir, 1102, 63.7, 94, 117, 6, 217
Yizashi, 1035, 130.2, 55, 96, 0, 151
ykozak, 1516, 36.4, 4278, 5084, 447, 9809
Ykwily, 1487, 47.4, 1453, 1041, 80, 2574
ylgdc, 1527, 106.5, 82, 159, 5, 246
ylonacs, 1733, 45.0, 1991, 523, 58, 2572
Ymar, 1904, 19.7, 15714, 20347, 1247, 37308
yms, 1409, 38.1, 3477, 4234, 223, 7934
Ynotu, 1392, 35.9, 10397, 7492, 533, 18422
yobiatch, 1264, 22.3, 10450, 32113, 416, 42979
Yodafan, 1405, 283.1, 1, 1, 0, 2
yodog, 1540, 73.8, 4256, 2370, 341, 6967
yogeshkumar, 1429, 63.8, 357, 861, 24, 1242
yogirama, 1157, 43.8, 489, 551, 33, 1073
yogithebear, 1104, 126.3, 577, 429, 35, 1041
yogitim, 1164, 78.4, 128, 98, 6, 232
yogm, 1180, 44.5, 120, 132, 4, 256
yogx, 974, 80.6, 14, 101, 1, 116
YoJimbo, 1465, 153.3, 4755, 4024, 503, 9282
yokke, 1344, 88.9, 3399, 2665, 294, 6358
yomove, 967, 44.3, 1034, 1428, 57, 2519
Yonan, 1571, 40.5, 5149, 5355, 512, 11016
yoncho, 1129, 346.3, 0, 1, 0, 1
Yoramo, 1448, 36.1, 6680, 4895, 410, 11985
yorretniw, 1157, 30.7, 1830, 1506, 267, 3603
yoryi, 1083, 35.7, 1067, 1146, 114, 2327
yoshiK, 1241, 127.6, 1078, 1680, 51, 2809
Yoshimori, 1711, 30.4, 7511, 5084, 1013, 13608
Yoshioil, 1335, 29.5, 2022, 1925, 171, 4118
yosio, 1757, 90.9, 463, 488, 30, 981
YossyGruen, 860, 73.1, 25, 75, 1, 101
YouGottaLittleOne, 861, 128.4, 30, 155, 3, 188
younameit, 1431, 60.3, 1598, 1424, 124, 3146
younessian, 1515, 38.2, 393, 863, 78, 1334
youngbaxta, 1372, 51.0, 114, 112, 15, 241
YoungWarrior, 1398, 75.5, 31, 34, 2, 67
yourkingsassassin, 1355, 43.6, 3101, 2510, 173, 5784
yourmaster, 982, 29.4, 622, 1364, 44, 2030
youvsyourself, 1684, 37.5, 4244, 3196, 406, 7846
youyouyou, 832, 148.7, 0, 32, 0, 32
YouYue, 1049, 31.6, 706, 718, 22, 1446
Yovi, 1533, 55.9, 625, 788, 40, 1453
yoyodog, 1302, 31.5, 1122, 1169, 103, 2394
yoza, 1301, 82.3, 580, 717, 43, 1340
Yozhik, 1260, 69.4, 540, 629, 75, 1244
yrboy, 2202, 71.2, 837, 775, 30, 1642
YRock, 1283, 26.1, 286, 225, 16, 527
yrrej, 1931, 19.2, 10346, 4412, 759, 15517
ysnake, 1316, 29.4, 1495, 2266, 140, 3901
ytty, 1381, 26.7, 2888, 1663, 102, 4653
ytunde, 1650, 22.8, 9071, 4069, 185, 13325
yuanding, 1164, 184.1, 0, 8, 1, 9
yuiopqw, 1303, 50.8, 1731, 2928, 243, 4902
yuliana, 1166, 144.5, 4, 193, 2, 199
yummycrepe, 1591, 26.4, 11313, 6231, 643, 18187
yunger, 1381, 42.7, 6498, 7234, 886, 14618
YUPO, 1607, 27.7, 5979, 4341, 262, 10582
Yur, 1254, 28.5, 3214, 4134, 348, 7696
yurchie, 1431, 63.2, 3781, 4842, 353, 8976
yuri, 1800, 43.0, 9779, 7842, 1555, 19176
Yurii, 794, 113.7, 24, 49, 2, 75
yuriis, 1723, 47.2, 3341, 3173, 254, 6768
yuripn, 1640, 23.9, 11282, 9393, 941, 21616
YuYevon, 1600, 63.6, 694, 749, 128, 1571
yvesklein, 1414, 68.7, 1053, 1452, 233, 2738
Yvou, 1575, 50.5, 5781, 6312, 1164, 13257
yxorpsram, 1484, 33.8, 2887, 2459, 377, 5723
ZaaaAAAz, 1030, 35.4, 395, 979, 42, 1416
zaantino, 711, 88.3, 37, 474, 4, 515
zacdes, 1612, 33.7, 1016, 1141, 156, 2313
zacharycat, 1697, 28.9, 1960, 1842, 338, 4140
ZachCHS, 977, 35.6, 172, 402, 31, 605
ZachM, 1648, 197.1, 815, 671, 79, 1565
zackb, 1538, 21.1, 8604, 7353, 433, 16390
zackone, 778, 129.8, 108, 300, 5, 413
zaclefou, 1468, 30.3, 7686, 7294, 593, 15573
zadar, 1432, 42.6, 3358, 3037, 291, 6686
zadox, 1138, 25.5, 6970, 6396, 429, 13795
zaferkarakislak, 1029, 42.5, 230, 581, 26, 837
zahal, 1806, 40.8, 503, 541, 37, 1081
zahonyi, 1008, 105.3, 39, 102, 8, 149
Zaichense, 1132, 38.3, 1127, 1881, 135, 3143
zakharg, 974, 65.8, 12, 27, 0, 39
zakizaki, 1080, 200.6, 129, 245, 10, 384
ZAMBALARANUU, 1470, 42.4, 1209, 804, 83, 2096
Zambom, 1357, 61.9, 7238, 10155, 731, 18124
zamel, 1289, 43.3, 1420, 675, 59, 2154
zamolxis, 1948, 60.3, 263, 405, 39, 707
zamurai, 1386, 34.2, 3225, 6339, 321, 9885
zaneski, 1305, 41.5, 44, 45, 1, 90
Zantwijk, 1142, 41.2, 1590, 2279, 99, 3968
ZappaDappa, 1250, 105.4, 52, 87, 5, 144
ZAPPI, 2264, 205.3, 237, 75, 19, 331
zaragoza, 1336, 41.7, 4080, 4834, 590, 9504
zarand, 1131, 23.9, 928, 1227, 80, 2235
zaratoustra, 1264, 23.8, 7148, 10617, 535, 18300
zarbiezarbie, 966, 32.1, 456, 562, 46, 1064
zargissian, 1985, 78.1, 826, 696, 66, 1588
Zarion, 1326, 44.0, 1566, 1511, 106, 3183
zarkk, 993, 49.5, 973, 1086, 73, 2132
zarth, 1463, 46.3, 3316, 2368, 239, 5923
zavidsky, 1128, 46.3, 2157, 2124, 198, 4479
zaxmit, 1540, 143.1, 6, 18, 1, 25
zaxoo, 1071, 130.8, 749, 956, 77, 1782
Zayats, 2270, 29.5, 1309, 598, 159, 2066
zba, 1228, 65.8, 47, 44, 0, 91
zbert, 825, 111.2, 22, 90, 4, 116
zbrad, 1730, 40.6, 11354, 11903, 1062, 24319
zcanucks, 1475, 47.9, 3908, 3306, 213, 7427
zccmsm, 1281, 27.6, 5173, 8376, 473, 14022
Zeblin, 1692, 55.6, 1416, 632, 58, 2106
ZECAURUBU, 1533, 29.8, 3134, 3833, 284, 7251
Zeddyzeddy, 1330, 25.2, 204, 173, 14, 391
zedikiah, 1332, 21.9, 1584, 2339, 135, 4058
zedward, 1575, 25.6, 9265, 8352, 1074, 18691
Zefly, 1557, 43.2, 7475, 8145, 706, 16326
zeg, 867, 43.9, 194, 407, 11, 612
zegovernata, 1674, 43.5, 321, 242, 16, 579
ZEISIG, 1386, 54.8, 1338, 564, 41, 1943
Zelijostocko, 1281, 31.7, 886, 722, 68, 1676
zelpetr, 1875, 24.6, 17446, 15023, 1627, 34096
zenbenzen, 1567, 28.5, 3342, 5597, 182, 9121
Zenekk, 1475, 46.4, 2933, 2698, 425, 6056
ZenMusic, 1322, 72.8, 35, 36, 3, 74
zenospinoza, 1469, 22.5, 7846, 9832, 951, 18629
zentner, 1162, 48.0, 83, 113, 4, 200
zeparzet, 1227, 35.7, 1012, 968, 64, 2044
Zephirin, 1984, 82.7, 6995, 4689, 636, 12320
Zerael, 1357, 32.1, 2491, 2426, 186, 5103
zerdeja, 1098, 32.7, 523, 623, 40, 1186
zerofire, 1196, 71.8, 474, 457, 22, 953
ZeroTheHero, 1458, 38.4, 1006, 963, 78, 2047
zeroxerox, 862, 92.0, 38, 79, 2, 119
ZeroZ, 1329, 41.3, 4503, 3801, 421, 8725
zerzevou, 1055, 49.3, 240, 492, 26, 758
Zestin, 1717, 111.4, 1905, 986, 175, 3066
zeta, 1526, 35.9, 9301, 5860, 711, 15872
ZeTooN, 887, 159.5, 1, 10, 0, 11
zetsubou, 1747, 36.5, 1053, 850, 113, 2016
zevanveen, 1090, 48.9, 564, 830, 35, 1429
zEviscerator, 1028, 82.2, 868, 1461, 86, 2415
ZfromDtownCO, 868, 83.3, 75, 136, 4, 215
ZGORL, 2185, 45.5, 6699, 3289, 737, 10725
zhe, 1640, 27.2, 21380, 18564, 1384, 41328
Zhlobov, 1217, 46.8, 209, 686, 51, 946
zhonghao, 1593, 87.5, 449, 462, 38, 949
Zhuk, 1564, 27.5, 4627, 4080, 334, 9041
zidleon, 1511, 26.7, 329, 230, 11, 570
ziffylube, 1316, 27.8, 1135, 1362, 96, 2593
ziggip, 1583, 35.0, 441, 737, 112, 1290
ziglag, 899, 54.1, 1428, 2173, 52, 3653
zigzaweak, 1543, 28.5, 4715, 6140, 391, 11246
ziissh, 1108, 76.1, 48, 133, 5, 186
ZillaTrap, 1598, 40.4, 10017, 7403, 937, 18357
zimbabwean, 961, 105.0, 79, 82, 4, 165
Ziniovitch, 1219, 118.5, 1107, 1556, 91, 2754
zinoukako, 953, 22.6, 847, 1574, 58, 2479
ZioVito, 1400, 54.4, 798, 1533, 125, 2456
Ziro, 1063, 40.7, 106, 115, 7, 228
zirzissi, 1777, 65.7, 8166, 7894, 435, 16495
zithuile, 1426, 49.2, 140, 103, 13, 256
Zitronenpferdchen, 1347, 28.2, 1221, 954, 82, 2257
zitterbart, 1325, 54.9, 3089, 2782, 203, 6074
zjgcat, 1744, 32.0, 7901, 2937, 644, 11482
ZlatkoVasilkoski, 1374, 62.3, 1574, 1606, 142, 3322
zmike, 1538, 25.3, 8763, 7307, 758, 16828
ZnBangash, 1512, 29.1, 1611, 1457, 113, 3181
zobaire, 996, 57.9, 290, 744, 32, 1066
Zoegas, 1683, 55.3, 1774, 1253, 102, 3129
zofia, 1547, 38.8, 168, 212, 27, 407
zogalicious, 1134, 80.7, 2251, 2073, 137, 4461
zojila, 1168, 53.5, 2072, 1169, 83, 3324
Zolero, 1029, 53.9, 277, 239, 5, 521
zombechess, 1408, 180.5, 63, 53, 5, 121
ZonaGrad, 1356, 33.3, 1310, 1170, 115, 2595
ZoneBlindTal, 1505, 22.9, 702, 303, 30, 1035
Zoned, 1387, 32.0, 4576, 5502, 346, 10424
Zoobie, 1328, 32.8, 4168, 4973, 282, 9423
Zookumar, 1609, 38.1, 22274, 22955, 1826, 47055
Zoomy, 1594, 22.8, 21184, 24851, 2026, 48061
zootsuit, 1438, 44.7, 2259, 3704, 333, 6296
zord, 1797, 111.8, 3125, 3005, 254, 6384
Zornhau, 1097, 33.3, 704, 1159, 83, 1946
zororai, 994, 156.4, 48, 381, 6, 435
Zorow, 2001, 43.6, 15696, 17633, 1788, 35117
zorroamigo, 1525, 26.5, 191, 179, 4, 374
zorrochan, 1400, 88.4, 618, 429, 30, 1077
zorrotornado, 1138, 72.8, 86, 122, 3, 211
Zorrow, 1439, 49.4, 474, 393, 18, 885
zorzibaffo, 1808, 58.8, 650, 538, 70, 1258
zosiliski, 1005, 42.9, 113, 229, 11, 353
zoskia, 1409, 88.5, 1819, 1308, 89, 3216
Zouzounitsa, 936, 109.4, 15, 42, 3, 60
zqy, 1131, 45.0, 169, 521, 28, 718
Zraz, 1189, 113.5, 769, 849, 37, 1655
zrussop, 894, 143.8, 3, 9, 0, 12
zsn, 998, 68.4, 19, 31, 4, 54
zsoti, 1399, 35.7, 1130, 1922, 88, 3140
zsram, 1216, 35.7, 777, 847, 66, 1690
zssz, 1528, 29.9, 10187, 20570, 510, 31267
zti, 1565, 35.5, 2661, 1712, 380, 4753
zue, 1569, 74.6, 833, 905, 56, 1794
ZugZwangMVB, 1762, 27.4, 12718, 3564, 500, 16782
zuhochess, 1276, 67.8, 123, 101, 7, 231
Zulfia, 1203, 134.9, 1, 14, 1, 16
ZURBRUG, 960, 56.5, 708, 967, 60, 1735
Zut, 1326, 65.6, 1338, 1013, 117, 2468
ZutAlors, 860, 248.9, 0, 3, 0, 3
zutons, 1621, 137.8, 10, 5, 0, 15
zuzveshtok, 1012, 42.6, 704, 979, 20, 1703
zvibond, 1414, 103.4, 161, 260, 18, 439
zvir, 1577, 32.3, 3289, 2088, 251, 5628
zvola, 1461, 86.9, 3147, 2633, 239, 6019
zvolo, 1232, 43.7, 2680, 4270, 215, 7165
zwartspeler, 1782, 31.9, 7669, 6574, 939, 15182
zweitausendzehnw, 1358, 108.9, 373, 961, 47, 1381
zwess, 1142, 62.3, 15, 33, 0, 48
zwischy, 1167, 51.4, 2457, 3015, 138, 5610
zxtxf, 1398, 35.5, 3436, 2879, 221, 6536
zxvt, 1548, 178.3, 9, 2, 1, 12
ZXYW, 1397, 32.2, 3250, 5441, 250, 8941
Zygon, 1021, 94.7, 33, 51, 3, 87
zythra, 1101, 99.0, 679, 448, 32, 1159
Zzacharyrus, 1034, 35.9, 200, 674, 8, 882
ZZender, 1243, 244.1, 0, 4, 0, 4
zzrdvark, 1283, 49.3, 425, 431, 48, 904
zzRFCzz, 1783, 314.8, 2, 0, 0, 2
zzzooo, 1147, 103.0, 893, 935, 193, 2021
